"run","tick","Name","RealizedConsumption","DomesticConsumption","ImportedQuantity","MinimumConsumption","MaximumConsumption","Iso3Code","AverageConsumption"
1,1.0,"Pakistan",1094274,95725,998549,1049896,1749827,"PAK",1399862
1,1.0,"India",4291446,3130554,1160892,3612177,6020296,"IND",4816237
1,1.0,"Western Europe",1261790,0,1261790,1805272,3008787,"NLD",2407030
1,1.0,"China",3934772,619873,3314899,6760551,11267586,"CPR",9014069
1,1.0,"United States of America",1258965,0,1258965,1816783,3027972,"USA",2422378
1,1.0,"Northern Africa",3132169,0,3132169,796191,1326986,"EGY",1061589
1,1.0,"Russian Federation",4865536,271444,4594092,3834593,6390988,"RUS",5112791
1,1.0,"Western Africa",949653,0,949653,122456,204093,"NGA",163275
1,1.0,"South America",1132773,107916,1024857,1174207,1957012,"BRA",1565610
1,1.0,"Northern Europe",1775842,474799,1301043,1112810,1854683,"GBR",1483747
1,1.0,"Northern America",1332447,0,1332447,459172,765287,"CAN",612230
1,1.0,"Oceania",1352383,0,1352383,252018,420031,"NZL",336025
1,1.0,"Eastern Africa",904613,0,904613,108552,180921,"ETH",144737
1,1.0,"Middle Africa",694094,0,694094,43566,72610,"AGO",58088
1,1.0,"Eastern Europe",1195630,0,1195630,2795976,4659960,"POL",3727968
1,1.0,"Central Asia",1658100,351392,1306708,1013631,1689386,"UZB",1351509
1,1.0,"Southern Europe",1251865,0,1251865,215748,359581,"ITA",287665
1,1.0,"Central America",958291,0,958291,125121,208535,"MEX",166828
1,1.0,"Southern Asia",1510755,0,1510755,295667,492778,"IRN",394223
1,1.0,"Western Asia",1043825,0,1043825,151525,252542,"IRQ",202034
1,1.0,"Eastern Asia",2439250,0,2439250,582291,970485,"JPN",776388
1,1.0,"Southern Africa",677372,0,677372,38403,64005,"ZAF",51204
1,1.0,"South-Eastern Asia",1715311,0,1715311,358812,598021,"IDN",478417
1,1.0,"Caribbean",914168,0,914168,111500,185833,"CUB",148667
1,2.0,"Pakistan",1340521,1013177,327344,1049896,1749827,"PAK",1399862
1,2.0,"India",4844709,4543162,301547,3612177,6020296,"IND",4816237
1,2.0,"Western Europe",3120128,2746170,373958,1805272,3008787,"NLD",2407030
1,2.0,"China",8103823,6601783,1502040,6760551,11267586,"CPR",9014069
1,2.0,"United States of America",3315713,2933252,382461,1816783,3027972,"USA",2422378
1,2.0,"Northern Africa",1070401,0,1070401,796191,1326986,"EGY",1061589
1,2.0,"Russian Federation",4932500,2885328,2047172,3834593,6390988,"RUS",5112791
1,2.0,"Western Africa",203669,0,203669,122456,204093,"NGA",163275
1,2.0,"South America",1491917,1150433,341484,1174207,1957012,"BRA",1565610
1,2.0,"Northern Europe",1827838,1465348,362490,1112810,1854683,"GBR",1483747
1,2.0,"Northern America",1133599,790036,343563,459172,765287,"CAN",612230
1,2.0,"Oceania",739953,418192,321761,252018,420031,"NZL",336025
1,2.0,"Eastern Africa",186269,0,186269,108552,180921,"ETH",144737
1,2.0,"Middle Africa",105718,0,105718,43566,72610,"AGO",58088
1,2.0,"Eastern Europe",4486035,4139607,346428,2795976,4659960,"POL",3727968
1,2.0,"Central Asia",1715771,1351027,364744,1013631,1689386,"UZB",1351509
1,2.0,"Southern Europe",322221,0,322221,215748,359581,"ITA",287665
1,2.0,"Central America",207029,0,207029,125121,208535,"MEX",166828
1,2.0,"Southern Asia",424887,0,424887,295667,492778,"IRN",394223
1,2.0,"Western Asia",240432,0,240432,151525,252542,"IRQ",202034
1,2.0,"Eastern Asia",794769,0,794769,582291,970485,"JPN",776388
1,2.0,"Southern Africa",99469,0,99469,38403,64005,"ZAF",51204
1,2.0,"South-Eastern Asia",506118,0,506118,358812,598021,"IDN",478417
1,2.0,"Caribbean",189872,0,189872,111500,185833,"CUB",148667
1,3.0,"Pakistan",1352221,1024436,327785,1049896,1749827,"PAK",1399862
1,3.0,"India",4847109,4550388,296721,3612177,6020296,"IND",4816237
1,3.0,"Western Europe",3071397,2730245,341152,1805272,3008787,"NLD",2407030
1,3.0,"China",8342529,6804610,1537919,6760551,11267586,"CPR",9014069
1,3.0,"United States of America",3237684,2891218,346466,1816783,3027972,"USA",2422378
1,3.0,"Northern Africa",1084166,0,1084166,796191,1326986,"EGY",1061589
1,3.0,"Russian Federation",4975464,2902392,2073072,3834593,6390988,"RUS",5112791
1,3.0,"Western Africa",201884,0,201884,122456,204093,"NGA",163275
1,3.0,"South America",1505292,1163424,341868,1174207,1957012,"BRA",1565610
1,3.0,"Northern Europe",1813740,1469193,344547,1112810,1854683,"GBR",1483747
1,3.0,"Northern America",1060052,743478,316574,459172,765287,"CAN",612230
1,3.0,"Oceania",684126,389202,294924,252018,420031,"NZL",336025
1,3.0,"Eastern Africa",184054,0,184054,108552,180921,"ETH",144737
1,3.0,"Middle Africa",101757,0,101757,43566,72610,"AGO",58088
1,3.0,"Eastern Europe",4456488,4135898,320590,2795976,4659960,"POL",3727968
1,3.0,"Central Asia",1696649,1349841,346808,1013631,1689386,"UZB",1351509
1,3.0,"Southern Europe",322836,0,322836,215748,359581,"ITA",287665
1,3.0,"Central America",205159,0,205159,125121,208535,"MEX",166828
1,3.0,"Southern Asia",427819,0,427819,295667,492778,"IRN",394223
1,3.0,"Western Asia",239463,0,239463,151525,252542,"IRQ",202034
1,3.0,"Eastern Asia",805619,0,805619,582291,970485,"JPN",776388
1,3.0,"Southern Africa",95371,0,95371,38403,64005,"ZAF",51204
1,3.0,"South-Eastern Asia",510805,0,510805,358812,598021,"IDN",478417
1,3.0,"Caribbean",187639,0,187639,111500,185833,"CUB",148667
1,4.0,"Pakistan",1382351,1052705,329646,1049896,1749827,"PAK",1399862
1,4.0,"India",4923728,4630265,293463,3612177,6020296,"IND",4816237
1,4.0,"Western Europe",3027527,2717898,309629,1805272,3008787,"NLD",2407030
1,4.0,"China",8437593,6862765,1574828,6760551,11267586,"CPR",9014069
1,4.0,"United States of America",3203792,2892067,311725,1816783,3027972,"USA",2422378
1,4.0,"Northern Africa",1100109,0,1100109,796191,1326986,"EGY",1061589
1,4.0,"Russian Federation",5074731,2968310,2106421,3834593,6390988,"RUS",5112791
1,4.0,"Western Africa",200650,0,200650,122456,204093,"NGA",163275
1,4.0,"South America",1539530,1195839,343691,1174207,1957012,"BRA",1565610
1,4.0,"Northern Europe",1801173,1473612,327561,1112810,1854683,"GBR",1483747
1,4.0,"Northern America",998397,704309,294088,459172,765287,"CAN",612230
1,4.0,"Oceania",640681,368230,272451,252018,420031,"NZL",336025
1,4.0,"Eastern Africa",182372,0,182372,108552,180921,"ETH",144737
1,4.0,"Middle Africa",98177,0,98177,43566,72610,"AGO",58088
1,4.0,"Eastern Europe",4428939,4130021,298918,2795976,4659960,"POL",3727968
1,4.0,"Central Asia",1679830,1349630,330200,1013631,1689386,"UZB",1351509
1,4.0,"Southern Europe",324161,0,324161,215748,359581,"ITA",287665
1,4.0,"Central America",203836,0,203836,125121,208535,"MEX",166828
1,4.0,"Southern Asia",431702,0,431702,295667,492778,"IRN",394223
1,4.0,"Western Asia",239095,0,239095,151525,252542,"IRQ",202034
1,4.0,"Eastern Asia",817896,0,817896,582291,970485,"JPN",776388
1,4.0,"Southern Africa",91655,0,91655,38403,64005,"ZAF",51204
1,4.0,"South-Eastern Asia",516587,0,516587,358812,598021,"IDN",478417
1,4.0,"Caribbean",185912,0,185912,111500,185833,"CUB",148667
1,5.0,"Pakistan",1388534,1058698,329836,1049896,1749827,"PAK",1399862
1,5.0,"India",4915622,4626322,289300,3612177,6020296,"IND",4816237
1,5.0,"Western Europe",2984834,2705788,279046,1805272,3008787,"NLD",2407030
1,5.0,"China",8514562,6909950,1604612,6760551,11267586,"CPR",9014069
1,5.0,"United States of America",3133005,2857554,275451,1816783,3027972,"USA",2422378
1,5.0,"Northern Africa",1108335,0,1108335,796191,1326986,"EGY",1061589
1,5.0,"Russian Federation",5098971,2974039,2124932,3834593,6390988,"RUS",5112791
1,5.0,"Western Africa",198119,0,198119,122456,204093,"NGA",163275
1,5.0,"South America",1546801,1203009,343792,1174207,1957012,"BRA",1565610
1,5.0,"Northern Europe",1808130,1497776,310354,1112810,1854683,"GBR",1483747
1,5.0,"Northern America",943769,671364,272405,459172,765287,"CAN",612230
1,5.0,"Oceania",594482,343382,251100,252018,420031,"NZL",336025
1,5.0,"Eastern Africa",179541,0,179541,108552,180921,"ETH",144737
1,5.0,"Middle Africa",94207,0,94207,43566,72610,"AGO",58088
1,5.0,"Eastern Europe",4400030,4122189,277841,2795976,4659960,"POL",3727968
1,5.0,"Central Asia",1661948,1350176,311772,1013631,1689386,"UZB",1351509
1,5.0,"Southern Europe",323567,0,323567,215748,359581,"ITA",287665
1,5.0,"Central America",201291,0,201291,125121,208535,"MEX",166828
1,5.0,"Southern Asia",432241,0,432241,295667,492778,"IRN",394223
1,5.0,"Western Asia",237108,0,237108,151525,252542,"IRQ",202034
1,5.0,"Eastern Asia",823424,0,823424,582291,970485,"JPN",776388
1,5.0,"Southern Africa",87597,0,87597,38403,64005,"ZAF",51204
1,5.0,"South-Eastern Asia",518275,0,518275,358812,598021,"IDN",478417
1,5.0,"Caribbean",183147,0,183147,111500,185833,"CUB",148667
1,6.0,"Pakistan",1395663,1063082,332581,1049896,1749827,"PAK",1399862
1,6.0,"India",4983782,4696081,287701,3612177,6020296,"IND",4816237
1,6.0,"Western Europe",2947247,2692987,254260,1805272,3008787,"NLD",2407030
1,6.0,"China",8716394,7080403,1635991,6760551,11267586,"CPR",9014069
1,6.0,"United States of America",3071113,2828296,242817,1816783,3027972,"USA",2422378
1,6.0,"Northern Africa",1117117,0,1117117,796191,1326986,"EGY",1061589
1,6.0,"Russian Federation",5176334,3029993,2146341,3834593,6390988,"RUS",5112791
1,6.0,"Western Africa",196962,0,196962,122456,204093,"NGA",163275
1,6.0,"South America",1554875,1208460,346415,1174207,1957012,"BRA",1565610
1,6.0,"Northern Europe",1793008,1500923,292085,1112810,1854683,"GBR",1483747
1,6.0,"Northern America",898799,644011,254788,459172,765287,"CAN",612230
1,6.0,"Oceania",559918,325913,234005,252018,420031,"NZL",336025
1,6.0,"Eastern Africa",178138,0,178138,108552,180921,"ETH",144737
1,6.0,"Middle Africa",91490,0,91490,43566,72610,"AGO",58088
1,6.0,"Eastern Europe",4374127,4112950,261177,2795976,4659960,"POL",3727968
1,6.0,"Central Asia",1665444,1368561,296883,1013631,1689386,"UZB",1351509
1,6.0,"Southern Europe",323952,0,323952,215748,359581,"ITA",287665
1,6.0,"Central America",200110,0,200110,125121,208535,"MEX",166828
1,6.0,"Southern Asia",434091,0,434091,295667,492778,"IRN",394223
1,6.0,"Western Asia",236522,0,236522,151525,252542,"IRQ",202034
1,6.0,"Eastern Asia",829656,0,829656,582291,970485,"JPN",776388
1,6.0,"Southern Africa",84780,0,84780,38403,64005,"ZAF",51204
1,6.0,"South-Eastern Asia",521150,0,521150,358812,598021,"IDN",478417
1,6.0,"Caribbean",181690,0,181690,111500,185833,"CUB",148667
1,7.0,"Pakistan",1420887,1085193,335694,1049896,1749827,"PAK",1399862
1,7.0,"India",4968785,4683074,285711,3612177,6020296,"IND",4816237
1,7.0,"Western Europe",2911405,2679819,231586,1805272,3008787,"NLD",2407030
1,7.0,"China",8770338,7103340,1666998,6760551,11267586,"CPR",9014069
1,7.0,"United States of America",3014159,2800332,213827,1816783,3027972,"USA",2422378
1,7.0,"Northern Africa",1125596,0,1125596,796191,1326986,"EGY",1061589
1,7.0,"Russian Federation",5195273,3027051,2168222,3834593,6390988,"RUS",5112791
1,7.0,"Western Africa",195375,0,195375,122456,204093,"NGA",163275
1,7.0,"South America",1583708,1231235,352473,1174207,1957012,"BRA",1565610
1,7.0,"Northern Europe",1777809,1504905,272904,1112810,1854683,"GBR",1483747
1,7.0,"Northern America",859524,621296,238228,459172,765287,"CAN",612230
1,7.0,"Oceania",529494,311229,218265,252018,420031,"NZL",336025
1,7.0,"Eastern Africa",176231,0,176231,108552,180921,"ETH",144737
1,7.0,"Middle Africa",88480,0,88480,43566,72610,"AGO",58088
1,7.0,"Eastern Europe",4403425,4158527,244898,2795976,4659960,"POL",3727968
1,7.0,"Central Asia",1647397,1368856,278541,1013631,1689386,"UZB",1351509
1,7.0,"Southern Europe",323814,0,323814,215748,359581,"ITA",287665
1,7.0,"Central America",198491,0,198491,125121,208535,"MEX",166828
1,7.0,"Southern Asia",435376,0,435376,295667,492778,"IRN",394223
1,7.0,"Western Asia",235389,0,235389,151525,252542,"IRQ",202034
1,7.0,"Eastern Asia",835148,0,835148,582291,970485,"JPN",776388
1,7.0,"Southern Africa",81668,0,81668,38403,64005,"ZAF",51204
1,7.0,"South-Eastern Asia",523442,0,523442,358812,598021,"IDN",478417
1,7.0,"Caribbean",179832,0,179832,111500,185833,"CUB",148667
1,8.0,"Pakistan",1422902,1085196,337706,1049896,1749827,"PAK",1399862
1,8.0,"India",5028472,4744288,284184,3612177,6020296,"IND",4816237
1,8.0,"Western Europe",2878024,2666538,211486,1805272,3008787,"NLD",2407030
1,8.0,"China",8810589,7121136,1689453,6760551,11267586,"CPR",9014069
1,8.0,"United States of America",2962520,2773901,188619,1816783,3027972,"USA",2422378
1,8.0,"Northern Africa",1126483,0,1126483,796191,1326986,"EGY",1061589
1,8.0,"Russian Federation",5253531,3074599,2178932,3834593,6390988,"RUS",5112791
1,8.0,"Western Africa",193190,0,193190,122456,204093,"NGA",163275
1,8.0,"South America",1586175,1232177,353998,1174207,1957012,"BRA",1565610
1,8.0,"Northern Europe",1783305,1522379,260926,1112810,1854683,"GBR",1483747
1,8.0,"Northern America",819783,596354,223429,459172,765287,"CAN",612230
1,8.0,"Oceania",500449,296049,204400,252018,420031,"NZL",336025
1,8.0,"Eastern Africa",173927,0,173927,108552,180921,"ETH",144737
1,8.0,"Middle Africa",85597,0,85597,43566,72610,"AGO",58088
1,8.0,"Eastern Europe",4369177,4139084,230093,2795976,4659960,"POL",3727968
1,8.0,"Central Asia",1629889,1364342,265547,1013631,1689386,"UZB",1351509
1,8.0,"Southern Europe",322197,0,322197,215748,359581,"ITA",287665
1,8.0,"Central America",196282,0,196282,125121,208535,"MEX",166828
1,8.0,"Southern Asia",434270,0,434270,295667,492778,"IRN",394223
1,8.0,"Western Asia",233447,0,233447,151525,252542,"IRQ",202034
1,8.0,"Eastern Asia",834635,0,834635,582291,970485,"JPN",776388
1,8.0,"Southern Africa",78746,0,78746,38403,64005,"ZAF",51204
1,8.0,"South-Eastern Asia",522666,0,522666,358812,598021,"IDN",478417
1,8.0,"Caribbean",177518,0,177518,111500,185833,"CUB",148667
1,9.0,"Pakistan",1445241,1103380,341861,1049896,1749827,"PAK",1399862
1,9.0,"India",5007790,4723933,283857,3612177,6020296,"IND",4816237
1,9.0,"Western Europe",2847901,2653472,194429,1805272,3008787,"NLD",2407030
1,9.0,"China",8982322,7266304,1716018,6760551,11267586,"CPR",9014069
1,9.0,"United States of America",2916721,2749294,167427,1816783,3027972,"USA",2422378
1,9.0,"Northern Africa",1130698,0,1130698,796191,1326986,"EGY",1061589
1,9.0,"Russian Federation",5258580,3064583,2193997,3834593,6390988,"RUS",5112791
1,9.0,"Western Africa",192118,0,192118,122456,204093,"NGA",163275
1,9.0,"South America",1610073,1252219,357854,1174207,1957012,"BRA",1565610
1,9.0,"Northern Europe",1766502,1522558,243944,1112810,1854683,"GBR",1483747
1,9.0,"Northern America",792298,582191,210107,459172,765287,"CAN",612230
1,9.0,"Oceania",478720,286394,192326,252018,420031,"NZL",336025
1,9.0,"Eastern Africa",172701,0,172701,108552,180921,"ETH",144737
1,9.0,"Middle Africa",83539,0,83539,43566,72610,"AGO",58088
1,9.0,"Eastern Europe",4337687,4120083,217604,2795976,4659960,"POL",3727968
1,9.0,"Central Asia",1632050,1377590,254460,1013631,1689386,"UZB",1351509
1,9.0,"Southern Europe",321976,0,321976,215748,359581,"ITA",287665
1,9.0,"Central America",195186,0,195186,125121,208535,"MEX",166828
1,9.0,"Southern Asia",434777,0,434777,295667,492778,"IRN",394223
1,9.0,"Western Asia",232680,0,232680,151525,252542,"IRQ",202034
1,9.0,"Eastern Asia",837017,0,837017,582291,970485,"JPN",776388
1,9.0,"Southern Africa",76604,0,76604,38403,64005,"ZAF",51204
1,9.0,"South-Eastern Asia",523698,0,523698,358812,598021,"IDN",478417
1,9.0,"Caribbean",176274,0,176274,111500,185833,"CUB",148667
1,10.0,"Pakistan",1444249,1099838,344411,1049896,1749827,"PAK",1399862
1,10.0,"India",5061287,4778139,283148,3612177,6020296,"IND",4816237
1,10.0,"Western Europe",2819252,2640661,178591,1805272,3008787,"NLD",2407030
1,10.0,"China",8998558,7265004,1733554,6760551,11267586,"CPR",9014069
1,10.0,"United States of America",2843621,2694871,148750,1816783,3027972,"USA",2422378
1,10.0,"Northern Africa",1127952,0,1127952,796191,1326986,"EGY",1061589
1,10.0,"Russian Federation",5306058,3105893,2200165,3834593,6390988,"RUS",5112791
1,10.0,"Western Africa",190004,0,190004,122456,204093,"NGA",163275
1,10.0,"South America",1609231,1249343,359888,1174207,1957012,"BRA",1565610
1,10.0,"Northern Europe",1749991,1521647,228344,1112810,1854683,"GBR",1483747
1,10.0,"Northern America",762718,564879,197839,459172,765287,"CAN",612230
1,10.0,"Oceania",457188,275733,181455,252018,420031,"NZL",336025
1,10.0,"Eastern Africa",170536,0,170536,108552,180921,"ETH",144737
1,10.0,"Middle Africa",81082,0,81082,43566,72610,"AGO",58088
1,10.0,"Eastern Europe",4359835,4154546,205289,2795976,4659960,"POL",3727968
1,10.0,"Central Asia",1613683,1377349,236334,1013631,1689386,"UZB",1351509
1,10.0,"Southern Europe",319988,0,319988,215748,359581,"ITA",287665
1,10.0,"Central America",193035,0,193035,125121,208535,"MEX",166828
1,10.0,"Southern Asia",432850,0,432850,295667,492778,"IRN",394223
1,10.0,"Western Asia",230650,0,230650,151525,252542,"IRQ",202034
1,10.0,"Eastern Asia",833935,0,833935,582291,970485,"JPN",776388
1,10.0,"Southern Africa",74124,0,74124,38403,64005,"ZAF",51204
1,10.0,"South-Eastern Asia",521761,0,521761,358812,598021,"IDN",478417
1,10.0,"Caribbean",174088,0,174088,111500,185833,"CUB",148667
1,11.0,"Pakistan",1463234,1114698,348536,1049896,1749827,"PAK",1399862
1,11.0,"India",5035428,4752049,283379,3612177,6020296,"IND",4816237
1,11.0,"Western Europe",2793563,2628494,165069,1805272,3008787,"NLD",2407030
1,11.0,"China",9145527,7393116,1752411,6760551,11267586,"CPR",9014069
1,11.0,"United States of America",2812205,2679302,132903,1816783,3027972,"USA",2422378
1,11.0,"Northern Africa",1126420,0,1126420,796191,1326986,"EGY",1061589
1,11.0,"Russian Federation",5349597,3142817,2206780,3834593,6390988,"RUS",5112791
1,11.0,"Western Africa",188753,0,188753,122456,204093,"NGA",163275
1,11.0,"South America",1630918,1267183,363735,1174207,1957012,"BRA",1565610
1,11.0,"Northern Europe",1735154,1515371,219783,1112810,1854683,"GBR",1483747
1,11.0,"Northern America",737704,551016,186688,459172,765287,"CAN",612230
1,11.0,"Oceania",439032,267056,171976,252018,420031,"NZL",336025
1,11.0,"Eastern Africa",169238,0,169238,108552,180921,"ETH",144737
1,11.0,"Middle Africa",79431,0,79431,43566,72610,"AGO",58088
1,11.0,"Eastern Europe",4323093,4128540,194553,2795976,4659960,"POL",3727968
1,11.0,"Central Asia",1614490,1387668,226822,1013631,1689386,"UZB",1351509
1,11.0,"Southern Europe",318825,0,318825,215748,359581,"ITA",287665
1,11.0,"Central America",191772,0,191772,125121,208535,"MEX",166828
1,11.0,"Southern Asia",431649,0,431649,295667,492778,"IRN",394223
1,11.0,"Western Asia",229488,0,229488,151525,252542,"IRQ",202034
1,11.0,"Eastern Asia",831651,0,831651,582291,970485,"JPN",776388
1,11.0,"Southern Africa",72426,0,72426,38403,64005,"ZAF",51204
1,11.0,"South-Eastern Asia",520441,0,520441,358812,598021,"IDN",478417
1,11.0,"Caribbean",172783,0,172783,111500,185833,"CUB",148667
1,12.0,"Pakistan",1480097,1127333,352764,1049896,1749827,"PAK",1399862
1,12.0,"India",5085032,4800571,284461,3612177,6020296,"IND",4816237
1,12.0,"Western Europe",2770106,2616902,153204,1805272,3008787,"NLD",2407030
1,12.0,"China",9149335,7376554,1772781,6760551,11267586,"CPR",9014069
1,12.0,"United States of America",2783974,2664857,119117,1816783,3027972,"USA",2422378
1,12.0,"Northern Africa",1127916,0,1127916,796191,1326986,"EGY",1061589
1,12.0,"Russian Federation",5341264,3123855,2217409,3834593,6390988,"RUS",5112791
1,12.0,"Western Africa",187538,0,187538,122456,204093,"NGA",163275
1,12.0,"South America",1650278,1282763,367515,1174207,1957012,"BRA",1565610
1,12.0,"Northern Europe",1740673,1528487,212186,1112810,1854683,"GBR",1483747
1,12.0,"Northern America",722271,545969,176302,459172,765287,"CAN",612230
1,12.0,"Oceania",426391,262750,163641,252018,420031,"NZL",336025
1,12.0,"Eastern Africa",167828,0,167828,108552,180921,"ETH",144737
1,12.0,"Middle Africa",77512,0,77512,43566,72610,"AGO",58088
1,12.0,"Eastern Europe",4289428,4104308,185120,2795976,4659960,"POL",3727968
1,12.0,"Central Asia",1596393,1384746,211647,1013631,1689386,"UZB",1351509
1,12.0,"Southern Europe",318159,0,318159,215748,359581,"ITA",287665
1,12.0,"Central America",190544,0,190544,125121,208535,"MEX",166828
1,12.0,"Southern Asia",431521,0,431521,295667,492778,"IRN",394223
1,12.0,"Western Asia",228405,0,228405,151525,252542,"IRQ",202034
1,12.0,"Eastern Asia",831926,0,831926,582291,970485,"JPN",776388
1,12.0,"Southern Africa",70448,0,70448,38403,64005,"ZAF",51204
1,12.0,"South-Eastern Asia",520478,0,520478,358812,598021,"IDN",478417
1,12.0,"Caribbean",171435,0,171435,111500,185833,"CUB",148667
1,13.0,"Pakistan",1476005,1118844,357161,1049896,1749827,"PAK",1399862
1,13.0,"India",5055682,4769908,285774,3612177,6020296,"IND",4816237
1,13.0,"Western Europe",2748452,2605814,142638,1805272,3008787,"NLD",2407030
1,13.0,"China",9282650,7489502,1793148,6760551,11267586,"CPR",9014069
1,13.0,"United States of America",2758459,2651420,107039,1816783,3027972,"USA",2422378
1,13.0,"Northern Africa",1127039,0,1127039,796191,1326986,"EGY",1061589
1,13.0,"Russian Federation",5383628,3156300,2227328,3834593,6390988,"RUS",5112791
1,13.0,"Western Africa",186347,0,186347,122456,204093,"NGA",163275
1,13.0,"South America",1645854,1274308,371546,1174207,1957012,"BRA",1565610
1,13.0,"Northern Europe",1724645,1524576,200069,1112810,1854683,"GBR",1483747
1,13.0,"Northern America",703192,536702,166490,459172,765287,"CAN",612230
1,13.0,"Oceania",412831,256845,155986,252018,420031,"NZL",336025
1,13.0,"Eastern Africa",166713,0,166713,108552,180921,"ETH",144737
1,13.0,"Middle Africa",76050,0,76050,43566,72610,"AGO",58088
1,13.0,"Eastern Europe",4308268,4131841,176427,2795976,4659960,"POL",3727968
1,13.0,"Central Asia",1579927,1381397,198530,1013631,1689386,"UZB",1351509
1,13.0,"Southern Europe",317092,0,317092,215748,359581,"ITA",287665
1,13.0,"Central America",189353,0,189353,125121,208535,"MEX",166828
1,13.0,"Southern Asia",430405,0,430405,295667,492778,"IRN",394223
1,13.0,"Western Asia",227366,0,227366,151525,252542,"IRQ",202034
1,13.0,"Eastern Asia",829662,0,829662,582291,970485,"JPN",776388
1,13.0,"Southern Africa",68963,0,68963,38403,64005,"ZAF",51204
1,13.0,"South-Eastern Asia",519035,0,519035,358812,598021,"IDN",478417
1,13.0,"Caribbean",170222,0,170222,111500,185833,"CUB",148667
1,14.0,"Pakistan",1490442,1128811,361631,1049896,1749827,"PAK",1399862
1,14.0,"India",5101139,4813465,287674,3612177,6020296,"IND",4816237
1,14.0,"Western Europe",2728489,2595402,133087,1805272,3008787,"NLD",2407030
1,14.0,"China",9266830,7459629,1807201,6760551,11267586,"CPR",9014069
1,14.0,"United States of America",2735234,2641104,94130,1816783,3027972,"USA",2422378
1,14.0,"Northern Africa",1123711,0,1123711,796191,1326986,"EGY",1061589
1,14.0,"Russian Federation",5415675,3184566,2231109,3834593,6390988,"RUS",5112791
1,14.0,"Western Africa",184906,0,184906,122456,204093,"NGA",163275
1,14.0,"South America",1662465,1286924,375541,1174207,1957012,"BRA",1565610
1,14.0,"Northern Europe",1728312,1534987,193325,1112810,1854683,"GBR",1483747
1,14.0,"Northern America",686601,529661,156940,459172,765287,"CAN",612230
1,14.0,"Oceania",401335,252197,149138,252018,420031,"NZL",336025
1,14.0,"Eastern Africa",165192,0,165192,108552,180921,"ETH",144737
1,14.0,"Middle Africa",74466,0,74466,43566,72610,"AGO",58088
1,14.0,"Eastern Europe",4270790,4102652,168138,2795976,4659960,"POL",3727968
1,14.0,"Central Asia",1581207,1389929,191278,1013631,1689386,"UZB",1351509
1,14.0,"Southern Europe",315441,0,315441,215748,359581,"ITA",287665
1,14.0,"Central America",187902,0,187902,125121,208535,"MEX",166828
1,14.0,"Southern Asia",428428,0,428428,295667,492778,"IRN",394223
1,14.0,"Western Asia",225855,0,225855,151525,252542,"IRQ",202034
1,14.0,"Eastern Asia",825568,0,825568,582291,970485,"JPN",776388
1,14.0,"Southern Africa",67366,0,67366,38403,64005,"ZAF",51204
1,14.0,"South-Eastern Asia",516398,0,516398,358812,598021,"IDN",478417
1,14.0,"Caribbean",168780,0,168780,111500,185833,"CUB",148667
1,15.0,"Pakistan",1503749,1136779,366970,1049896,1749827,"PAK",1399862
1,15.0,"India",5069279,4779221,290058,3612177,6020296,"IND",4816237
1,15.0,"Western Europe",2710456,2585683,124773,1805272,3008787,"NLD",2407030
1,15.0,"China",9386742,7560083,1826659,6760551,11267586,"CPR",9014069
1,15.0,"United States of America",2714640,2631452,83188,1816783,3027972,"USA",2422378
1,15.0,"Northern Africa",1123267,0,1123267,796191,1326986,"EGY",1061589
1,15.0,"Russian Federation",5397710,3158597,2239113,3834593,6390988,"RUS",5112791
1,15.0,"Western Africa",184169,0,184169,122456,204093,"NGA",163275
1,15.0,"South America",1677810,1297278,380532,1174207,1957012,"BRA",1565610
1,15.0,"Northern Europe",1711728,1528910,182818,1112810,1854683,"GBR",1483747
1,15.0,"Northern America",672447,524545,147902,459172,765287,"CAN",612230
1,15.0,"Oceania",394061,251247,142814,252018,420031,"NZL",336025
1,15.0,"Eastern Africa",164438,0,164438,108552,180921,"ETH",144737
1,15.0,"Middle Africa",73330,0,73330,43566,72610,"AGO",58088
1,15.0,"Eastern Europe",4285330,4124521,160809,2795976,4659960,"POL",3727968
1,15.0,"Central Asia",1564641,1390977,173664,1013631,1689386,"UZB",1351509
1,15.0,"Southern Europe",314329,0,314329,215748,359581,"ITA",287665
1,15.0,"Central America",186847,0,186847,125121,208535,"MEX",166828
1,15.0,"Southern Asia",427459,0,427459,295667,492778,"IRN",394223
1,15.0,"Western Asia",225224,0,225224,151525,252542,"IRQ",202034
1,15.0,"Eastern Asia",823771,0,823771,582291,970485,"JPN",776388
1,15.0,"Southern Africa",66193,0,66193,38403,64005,"ZAF",51204
1,15.0,"South-Eastern Asia",515079,0,515079,358812,598021,"IDN",478417
1,15.0,"Caribbean",167683,0,167683,111500,185833,"CUB",148667
1,16.0,"Pakistan",1515971,1142856,373115,1049896,1749827,"PAK",1399862
1,16.0,"India",5112612,4818651,293961,3612177,6020296,"IND",4816237
1,16.0,"Western Europe",2724128,2606455,117673,1805272,3008787,"NLD",2407030
1,16.0,"China",9368425,7519219,1849206,6760551,11267586,"CPR",9014069
1,16.0,"United States of America",2696663,2626331,70332,1816783,3027972,"USA",2422378
1,16.0,"Northern Africa",1126926,0,1126926,796191,1326986,"EGY",1061589
1,16.0,"Russian Federation",5439269,3183786,2255483,3834593,6390988,"RUS",5112791
1,16.0,"Western Africa",183463,0,183463,122456,204093,"NGA",163275
1,16.0,"South America",1691834,1305413,386421,1174207,1957012,"BRA",1565610
1,16.0,"Northern Europe",1715434,1537493,177941,1112810,1854683,"GBR",1483747
1,16.0,"Northern America",671909,532850,139059,459172,765287,"CAN",612230
1,16.0,"Oceania",385602,248294,137308,252018,420031,"NZL",336025
1,16.0,"Eastern Africa",163579,0,163579,108552,180921,"ETH",144737
1,16.0,"Middle Africa",72156,0,72156,43566,72610,"AGO",58088
1,16.0,"Eastern Europe",4246925,4092347,154578,2795976,4659960,"POL",3727968
1,16.0,"Central Asia",1550193,1387195,162998,1013631,1689386,"UZB",1351509
1,16.0,"Southern Europe",315414,0,315414,215748,359581,"ITA",287665
1,16.0,"Central America",186963,0,186963,125121,208535,"MEX",166828
1,16.0,"Southern Asia",427823,0,427823,295667,492778,"IRN",394223
1,16.0,"Western Asia",224605,0,224605,151525,252542,"IRQ",202034
1,16.0,"Eastern Asia",825830,0,825830,582291,970485,"JPN",776388
1,16.0,"Southern Africa",64959,0,64959,38403,64005,"ZAF",51204
1,16.0,"South-Eastern Asia",515898,0,515898,358812,598021,"IDN",478417
1,16.0,"Caribbean",167653,0,167653,111500,185833,"CUB",148667
1,17.0,"Pakistan",1524862,1146985,377877,1049896,1749827,"PAK",1399862
1,17.0,"India",5148210,4851349,296861,3612177,6020296,"IND",4816237
1,17.0,"Western Europe",2674044,2575821,98223,1805272,3008787,"NLD",2407030
1,17.0,"China",9471950,7607925,1864025,6760551,11267586,"CPR",9014069
1,17.0,"United States of America",2680508,2621036,59472,1816783,3027972,"USA",2422378
1,17.0,"Northern Africa",1124432,0,1124432,796191,1326986,"EGY",1061589
1,17.0,"Russian Federation",5464177,3204536,2259641,3834593,6390988,"RUS",5112791
1,17.0,"Western Africa",182252,0,182252,122456,204093,"NGA",163275
1,17.0,"South America",1702208,1311359,390849,1174207,1957012,"BRA",1565610
1,17.0,"Northern Europe",1698163,1531849,166314,1112810,1854683,"GBR",1483747
1,17.0,"Northern America",670502,541127,129375,459172,765287,"CAN",612230
1,17.0,"Oceania",377684,246127,131557,252018,420031,"NZL",336025
1,17.0,"Eastern Africa",162625,0,162625,108552,180921,"ETH",144737
1,17.0,"Middle Africa",71211,0,71211,43566,72610,"AGO",58088
1,17.0,"Eastern Europe",4211964,4063384,148580,2795976,4659960,"POL",3727968
1,17.0,"Central Asia",1536672,1378881,157791,1013631,1689386,"UZB",1351509
1,17.0,"Southern Europe",314919,0,314919,215748,359581,"ITA",287665
1,17.0,"Central America",186715,0,186715,125121,208535,"MEX",166828
1,17.0,"Southern Asia",426487,0,426487,295667,492778,"IRN",394223
1,17.0,"Western Asia",223500,0,223500,151525,252542,"IRQ",202034
1,17.0,"Eastern Asia",825296,0,825296,582291,970485,"JPN",776388
1,17.0,"Southern Africa",64008,0,64008,38403,64005,"ZAF",51204
1,17.0,"South-Eastern Asia",514779,0,514779,358812,598021,"IDN",478417
1,17.0,"Caribbean",167378,0,167378,111500,185833,"CUB",148667
1,18.0,"Pakistan",1532812,1149621,383191,1049896,1749827,"PAK",1399862
1,18.0,"India",5109237,4808887,300350,3612177,6020296,"IND",4816237
1,18.0,"Western Europe",2690026,2599283,90743,1805272,3008787,"NLD",2407030
1,18.0,"China",9439255,7557909,1881346,6760551,11267586,"CPR",9014069
1,18.0,"United States of America",2665697,2615684,50013,1816783,3027972,"USA",2422378
1,18.0,"Northern Africa",1124488,0,1124488,796191,1326986,"EGY",1061589
1,18.0,"Russian Federation",5489178,3222219,2266959,3834593,6390988,"RUS",5112791
1,18.0,"Western Africa",182086,0,182086,122456,204093,"NGA",163275
1,18.0,"South America",1711534,1315585,395949,1174207,1957012,"BRA",1565610
1,18.0,"Northern Europe",1700722,1543919,156803,1112810,1854683,"GBR",1483747
1,18.0,"Northern America",657650,537589,120061,459172,765287,"CAN",612230
1,18.0,"Oceania",376103,249997,126106,252018,420031,"NZL",336025
1,18.0,"Eastern Africa",162353,0,162353,108552,180921,"ETH",144737
1,18.0,"Middle Africa",70390,0,70390,43566,72610,"AGO",58088
1,18.0,"Eastern Europe",4180728,4039935,140793,2795976,4659960,"POL",3727968
1,18.0,"Central Asia",1524623,1375861,148762,1013631,1689386,"UZB",1351509
1,18.0,"Southern Europe",313844,0,313844,215748,359581,"ITA",287665
1,18.0,"Central America",185830,0,185830,125121,208535,"MEX",166828
1,18.0,"Southern Asia",425180,0,425180,295667,492778,"IRN",394223
1,18.0,"Western Asia",223226,0,223226,151525,252542,"IRQ",202034
1,18.0,"Eastern Asia",822017,0,822017,582291,970485,"JPN",776388
1,18.0,"Southern Africa",63137,0,63137,38403,64005,"ZAF",51204
1,18.0,"South-Eastern Asia",512925,0,512925,358812,598021,"IDN",478417
1,18.0,"Caribbean",166451,0,166451,111500,185833,"CUB",148667
1,19.0,"Pakistan",1538478,1150771,387707,1049896,1749827,"PAK",1399862
1,19.0,"India",5143476,4839442,304034,3612177,6020296,"IND",4816237
1,19.0,"Western Europe",2644187,2568531,75656,1805272,3008787,"NLD",2407030
1,19.0,"China",9531861,7637309,1894552,6760551,11267586,"CPR",9014069
1,19.0,"United States of America",2625192,2582685,42507,1816783,3027972,"USA",2422378
1,19.0,"Northern Africa",1121009,0,1121009,796191,1326986,"EGY",1061589
1,19.0,"Russian Federation",5504105,3236698,2267407,3834593,6390988,"RUS",5112791
1,19.0,"Western Africa",181268,0,181268,122456,204093,"NGA",163275
1,19.0,"South America",1718181,1318053,400128,1174207,1957012,"BRA",1565610
1,19.0,"Northern Europe",1683637,1540077,143560,1112810,1854683,"GBR",1483747
1,19.0,"Northern America",663548,553434,110114,459172,765287,"CAN",612230
1,19.0,"Oceania",371595,251297,120298,252018,420031,"NZL",336025
1,19.0,"Eastern Africa",161717,0,161717,108552,180921,"ETH",144737
1,19.0,"Middle Africa",69706,0,69706,43566,72610,"AGO",58088
1,19.0,"Eastern Europe",4152500,4022855,129645,2795976,4659960,"POL",3727968
1,19.0,"Central Asia",1513504,1372935,140569,1013631,1689386,"UZB",1351509
1,19.0,"Southern Europe",314031,0,314031,215748,359581,"ITA",287665
1,19.0,"Central America",185768,0,185768,125121,208535,"MEX",166828
1,19.0,"Southern Asia",424614,0,424614,295667,492778,"IRN",394223
1,19.0,"Western Asia",222375,0,222375,151525,252542,"IRQ",202034
1,19.0,"Eastern Asia",823898,0,823898,582291,970485,"JPN",776388
1,19.0,"Southern Africa",62436,0,62436,38403,64005,"ZAF",51204
1,19.0,"South-Eastern Asia",513188,0,513188,358812,598021,"IDN",478417
1,19.0,"Caribbean",166401,0,166401,111500,185833,"CUB",148667
1,20.0,"Pakistan",1545567,1150735,394832,1049896,1749827,"PAK",1399862
1,20.0,"India",5173479,4864382,309097,3612177,6020296,"IND",4816237
1,20.0,"Western Europe",2662813,2599205,63608,1805272,3008787,"NLD",2407030
1,20.0,"China",9501304,7580443,1920861,6760551,11267586,"CPR",9014069
1,20.0,"United States of America",2645984,2609978,36006,1816783,3027972,"USA",2422378
1,20.0,"Northern Africa",1129431,0,1129431,796191,1326986,"EGY",1061589
1,20.0,"Russian Federation",5534382,3248810,2285572,3834593,6390988,"RUS",5112791
1,20.0,"Western Africa",181730,0,181730,122456,204093,"NGA",163275
1,20.0,"South America",1726370,1319165,407205,1174207,1957012,"BRA",1565610
1,20.0,"Northern Europe",1652454,1533080,119374,1112810,1854683,"GBR",1483747
1,20.0,"Northern America",663469,562598,100871,459172,765287,"CAN",612230
1,20.0,"Oceania",370892,255709,115183,252018,420031,"NZL",336025
1,20.0,"Eastern Africa",162049,0,162049,108552,180921,"ETH",144737
1,20.0,"Middle Africa",69187,0,69187,43566,72610,"AGO",58088
1,20.0,"Eastern Europe",4128146,4014352,113794,2795976,4659960,"POL",3727968
1,20.0,"Central Asia",1488685,1365238,123447,1013631,1689386,"UZB",1351509
1,20.0,"Southern Europe",315193,0,315193,215748,359581,"ITA",287665
1,20.0,"Central America",186366,0,186366,125121,208535,"MEX",166828
1,20.0,"Southern Asia",425772,0,425772,295667,492778,"IRN",394223
1,20.0,"Western Asia",223054,0,223054,151525,252542,"IRQ",202034
1,20.0,"Eastern Asia",828169,0,828169,582291,970485,"JPN",776388
1,20.0,"Southern Africa",61854,0,61854,38403,64005,"ZAF",51204
1,20.0,"South-Eastern Asia",515429,0,515429,358812,598021,"IDN",478417
1,20.0,"Caribbean",166811,0,166811,111500,185833,"CUB",148667
1,21.0,"Pakistan",1566442,1166251,400191,1049896,1749827,"PAK",1399862
1,21.0,"India",5197430,4883881,313549,3612177,6020296,"IND",4816237
1,21.0,"Western Europe",2648300,2595361,52939,1805272,3008787,"NLD",2407030
1,21.0,"China",9588501,7650890,1937611,6760551,11267586,"CPR",9014069
1,21.0,"United States of America",2607575,2577013,30562,1816783,3027972,"USA",2422378
1,21.0,"Northern Africa",1126924,0,1126924,796191,1326986,"EGY",1061589
1,21.0,"Russian Federation",5544800,3257041,2287759,3834593,6390988,"RUS",5112791
1,21.0,"Western Africa",181833,0,181833,122456,204093,"NGA",163275
1,21.0,"South America",1730814,1318558,412256,1174207,1957012,"BRA",1565610
1,21.0,"Northern Europe",1659596,1545855,113741,1112810,1854683,"GBR",1483747
1,21.0,"Northern America",662297,571609,90688,459172,765287,"CAN",612230
1,21.0,"Oceania",372281,262841,109440,252018,420031,"NZL",336025
1,21.0,"Eastern Africa",162382,0,162382,108552,180921,"ETH",144737
1,21.0,"Middle Africa",68985,0,68985,43566,72610,"AGO",58088
1,21.0,"Eastern Europe",4105783,4000000,105783,2795976,4659960,"POL",3727968
1,21.0,"Central Asia",1482974,1361860,121114,1013631,1689386,"UZB",1351509
1,21.0,"Southern Europe",314700,0,314700,215748,359581,"ITA",287665
1,21.0,"Central America",185923,0,185923,125121,208535,"MEX",166828
1,21.0,"Southern Asia",425521,0,425521,295667,492778,"IRN",394223
1,21.0,"Western Asia",223325,0,223325,151525,252542,"IRQ",202034
1,21.0,"Eastern Asia",828191,0,828191,582291,970485,"JPN",776388
1,21.0,"Southern Africa",61592,0,61592,38403,64005,"ZAF",51204
1,21.0,"South-Eastern Asia",515455,0,515455,358812,598021,"IDN",478417
1,21.0,"Caribbean",166432,0,166432,111500,185833,"CUB",148667
1,22.0,"Pakistan",1566417,1161909,404508,1049896,1749827,"PAK",1399862
1,22.0,"India",5149787,4831925,317862,3612177,6020296,"IND",4816237
1,22.0,"Western Europe",2635356,2591286,44070,1805272,3008787,"NLD",2407030
1,22.0,"China",9664049,7710857,1953192,6760551,11267586,"CPR",9014069
1,22.0,"United States of America",2629054,2603265,25789,1816783,3027972,"USA",2422378
1,22.0,"Northern Africa",1127567,0,1127567,796191,1326986,"EGY",1061589
1,22.0,"Russian Federation",5554674,3263113,2291561,3834593,6390988,"RUS",5112791
1,22.0,"Western Africa",180858,0,180858,122456,204093,"NGA",163275
1,22.0,"South America",1734337,1316735,417602,1174207,1957012,"BRA",1565610
1,22.0,"Northern Europe",1647591,1547994,99597,1112810,1854683,"GBR",1483747
1,22.0,"Northern America",655466,573716,81750,459172,765287,"CAN",612230
1,22.0,"Oceania",365337,261616,103721,252018,420031,"NZL",336025
1,22.0,"Eastern Africa",161233,0,161233,108552,180921,"ETH",144737
1,22.0,"Middle Africa",68249,0,68249,43566,72610,"AGO",58088
1,22.0,"Eastern Europe",4085726,3992450,93276,2795976,4659960,"POL",3727968
1,22.0,"Central Asia",1477686,1358501,119185,1013631,1689386,"UZB",1351509
1,22.0,"Southern Europe",313472,0,313472,215748,359581,"ITA",287665
1,22.0,"Central America",185607,0,185607,125121,208535,"MEX",166828
1,22.0,"Southern Asia",423790,0,423790,295667,492778,"IRN",394223
1,22.0,"Western Asia",222107,0,222107,151525,252542,"IRQ",202034
1,22.0,"Eastern Asia",825569,0,825569,582291,970485,"JPN",776388
1,22.0,"Southern Africa",60868,0,60868,38403,64005,"ZAF",51204
1,22.0,"South-Eastern Asia",512761,0,512761,358812,598021,"IDN",478417
1,22.0,"Caribbean",166052,0,166052,111500,185833,"CUB",148667
1,23.0,"Pakistan",1564784,1156885,407899,1049896,1749827,"PAK",1399862
1,23.0,"India",5174064,4851798,322266,3612177,6020296,"IND",4816237
1,23.0,"Western Europe",2623670,2587083,36587,1805272,3008787,"NLD",2407030
1,23.0,"China",9600512,7638619,1961893,6760551,11267586,"CPR",9014069
1,23.0,"United States of America",2592429,2570641,21788,1816783,3027972,"USA",2422378
1,23.0,"Northern Africa",1123605,0,1123605,796191,1326986,"EGY",1061589
1,23.0,"Russian Federation",5555204,3269914,2285290,3834593,6390988,"RUS",5112791
1,23.0,"Western Africa",180281,0,180281,122456,204093,"NGA",163275
1,23.0,"South America",1735476,1313758,421718,1174207,1957012,"BRA",1565610
1,23.0,"Northern Europe",1636953,1544183,92770,1112810,1854683,"GBR",1483747
1,23.0,"Northern America",660989,587162,73827,459172,765287,"CAN",612230
1,23.0,"Oceania",364255,266622,97633,252018,420031,"NZL",336025
1,23.0,"Eastern Africa",160612,0,160612,108552,180921,"ETH",144737
1,23.0,"Middle Africa",67644,0,67644,43566,72610,"AGO",58088
1,23.0,"Eastern Europe",4025092,3937300,87792,2795976,4659960,"POL",3727968
1,23.0,"Central Asia",1472233,1357949,114284,1013631,1689386,"UZB",1351509
1,23.0,"Southern Europe",312878,0,312878,215748,359581,"ITA",287665
1,23.0,"Central America",185067,0,185067,125121,208535,"MEX",166828
1,23.0,"Southern Asia",422923,0,422923,295667,492778,"IRN",394223
1,23.0,"Western Asia",221333,0,221333,151525,252542,"IRQ",202034
1,23.0,"Eastern Asia",826093,0,826093,582291,970485,"JPN",776388
1,23.0,"Southern Africa",60283,0,60283,38403,64005,"ZAF",51204
1,23.0,"South-Eastern Asia",512612,0,512612,358812,598021,"IDN",478417
1,23.0,"Caribbean",165584,0,165584,111500,185833,"CUB",148667
1,24.0,"Pakistan",1579131,1167535,411596,1049896,1749827,"PAK",1399862
1,24.0,"India",5193947,4867118,326829,3612177,6020296,"IND",4816237
1,24.0,"Western Europe",2586196,2555730,30466,1805272,3008787,"NLD",2407030
1,24.0,"China",9667376,7693990,1973386,6760551,11267586,"CPR",9014069
1,24.0,"United States of America",2588436,2569994,18442,1816783,3027972,"USA",2422378
1,24.0,"Northern Africa",1119472,0,1119472,796191,1326986,"EGY",1061589
1,24.0,"Russian Federation",5554900,3275111,2279789,3834593,6390988,"RUS",5112791
1,24.0,"Western Africa",180113,0,180113,122456,204093,"NGA",163275
1,24.0,"South America",1754683,1328615,426068,1174207,1957012,"BRA",1565610
1,24.0,"Northern Europe",1627204,1545484,81720,1112810,1854683,"GBR",1483747
1,24.0,"Northern America",653504,586267,67237,459172,765287,"CAN",612230
1,24.0,"Oceania",366269,274497,91772,252018,420031,"NZL",336025
1,24.0,"Eastern Africa",160736,0,160736,108552,180921,"ETH",144737
1,24.0,"Middle Africa",67509,0,67509,43566,72610,"AGO",58088
1,24.0,"Eastern Europe",4016828,3931751,85077,2795976,4659960,"POL",3727968
1,24.0,"Central Asia",1467665,1355058,112607,1013631,1689386,"UZB",1351509
1,24.0,"Southern Europe",310910,0,310910,215748,359581,"ITA",287665
1,24.0,"Central America",184392,0,184392,125121,208535,"MEX",166828
1,24.0,"Southern Asia",421753,0,421753,295667,492778,"IRN",394223
1,24.0,"Western Asia",221387,0,221387,151525,252542,"IRQ",202034
1,24.0,"Eastern Asia",824272,0,824272,582291,970485,"JPN",776388
1,24.0,"Southern Africa",60175,0,60175,38403,64005,"ZAF",51204
1,24.0,"South-Eastern Asia",511518,0,511518,358812,598021,"IDN",478417
1,24.0,"Caribbean",164943,0,164943,111500,185833,"CUB",148667
1,25.0,"Pakistan",1575823,1159924,415899,1049896,1749827,"PAK",1399862
1,25.0,"India",5210538,4878344,332194,3612177,6020296,"IND",4816237
1,25.0,"Western Europe",2608826,2583303,25523,1805272,3008787,"NLD",2407030
1,25.0,"China",9732189,7740455,1991734,6760551,11267586,"CPR",9014069
1,25.0,"United States of America",2584505,2568865,15640,1816783,3027972,"USA",2422378
1,25.0,"Northern Africa",1124543,0,1124543,796191,1326986,"EGY",1061589
1,25.0,"Russian Federation",5564048,3278813,2285235,3834593,6390988,"RUS",5112791
1,25.0,"Western Africa",179620,0,179620,122456,204093,"NGA",163275
1,25.0,"South America",1753210,1322035,431175,1174207,1957012,"BRA",1565610
1,25.0,"Northern Europe",1603081,1535640,67441,1112810,1854683,"GBR",1483747
1,25.0,"Northern America",659458,597403,62055,459172,765287,"CAN",612230
1,25.0,"Oceania",359784,273737,86047,252018,420031,"NZL",336025
1,25.0,"Eastern Africa",159834,0,159834,108552,180921,"ETH",144737
1,25.0,"Middle Africa",66953,0,66953,43566,72610,"AGO",58088
1,25.0,"Eastern Europe",4009525,3928023,81502,2795976,4659960,"POL",3727968
1,25.0,"Central Asia",1463487,1354620,108867,1013631,1689386,"UZB",1351509
1,25.0,"Southern Europe",311751,0,311751,215748,359581,"ITA",287665
1,25.0,"Central America",184729,0,184729,125121,208535,"MEX",166828
1,25.0,"Southern Asia",421668,0,421668,295667,492778,"IRN",394223
1,25.0,"Western Asia",220623,0,220623,151525,252542,"IRQ",202034
1,25.0,"Eastern Asia",826270,0,826270,582291,970485,"JPN",776388
1,25.0,"Southern Africa",59555,0,59555,38403,64005,"ZAF",51204
1,25.0,"South-Eastern Asia",511468,0,511468,358812,598021,"IDN",478417
1,25.0,"Caribbean",165204,0,165204,111500,185833,"CUB",148667
1,26.0,"Pakistan",1586764,1167415,419349,1049896,1749827,"PAK",1399862
1,26.0,"India",5222764,4885724,337040,3612177,6020296,"IND",4816237
1,26.0,"Western Europe",2573059,2551794,21265,1805272,3008787,"NLD",2407030
1,26.0,"China",9780419,7777843,2002576,6760551,11267586,"CPR",9014069
1,26.0,"United States of America",2580622,2567365,13257,1816783,3027972,"USA",2422378
1,26.0,"Northern Africa",1121373,0,1121373,796191,1326986,"EGY",1061589
1,26.0,"Russian Federation",5563212,3280106,2283106,3834593,6390988,"RUS",5112791
1,26.0,"Western Africa",179565,0,179565,122456,204093,"NGA",163275
1,26.0,"South America",1767996,1332739,435257,1174207,1957012,"BRA",1565610
1,26.0,"Northern Europe",1598834,1533829,65005,1112810,1854683,"GBR",1483747
1,26.0,"Northern America",657863,600488,57375,459172,765287,"CAN",612230
1,26.0,"Oceania",362459,282190,80269,252018,420031,"NZL",336025
1,26.0,"Eastern Africa",160071,0,160071,108552,180921,"ETH",144737
1,26.0,"Middle Africa",66892,0,66892,43566,72610,"AGO",58088
1,26.0,"Eastern Europe",4001824,3922338,79486,2795976,4659960,"POL",3727968
1,26.0,"Central Asia",1459450,1354403,105047,1013631,1689386,"UZB",1351509
1,26.0,"Southern Europe",310520,0,310520,215748,359581,"ITA",287665
1,26.0,"Central America",184407,0,184407,125121,208535,"MEX",166828
1,26.0,"Southern Asia",421306,0,421306,295667,492778,"IRN",394223
1,26.0,"Western Asia",220757,0,220757,151525,252542,"IRQ",202034
1,26.0,"Eastern Asia",827357,0,827357,582291,970485,"JPN",776388
1,26.0,"Southern Africa",59507,0,59507,38403,64005,"ZAF",51204
1,26.0,"South-Eastern Asia",512213,0,512213,358812,598021,"IDN",478417
1,26.0,"Caribbean",164905,0,164905,111500,185833,"CUB",148667
1,27.0,"Pakistan",1594351,1174222,420129,1049896,1749827,"PAK",1399862
1,27.0,"India",5231452,4889861,341591,3612177,6020296,"IND",4816237
1,27.0,"Western Europe",2569730,2552098,17632,1805272,3008787,"NLD",2407030
1,27.0,"China",9700959,7689973,2010986,6760551,11267586,"CPR",9014069
1,27.0,"United States of America",2576709,2565570,11139,1816783,3027972,"USA",2422378
1,27.0,"Northern Africa",1119975,0,1119975,796191,1326986,"EGY",1061589
1,27.0,"Russian Federation",5559355,3279979,2279376,3834593,6390988,"RUS",5112791
1,27.0,"Western Africa",179112,0,179112,122456,204093,"NGA",163275
1,27.0,"South America",1761172,1323081,438091,1174207,1957012,"BRA",1565610
1,27.0,"Northern Europe",1594986,1532053,62933,1112810,1854683,"GBR",1483747
1,27.0,"Northern America",650342,596859,53483,459172,765287,"CAN",612230
1,27.0,"Oceania",361655,287446,74209,252018,420031,"NZL",336025
1,27.0,"Eastern Africa",159725,0,159725,108552,180921,"ETH",144737
1,27.0,"Middle Africa",66508,0,66508,43566,72610,"AGO",58088
1,27.0,"Eastern Europe",3994563,3916777,77786,2795976,4659960,"POL",3727968
1,27.0,"Central Asia",1455721,1352081,103640,1013631,1689386,"UZB",1351509
1,27.0,"Southern Europe",308916,0,308916,215748,359581,"ITA",287665
1,27.0,"Central America",183578,0,183578,125121,208535,"MEX",166828
1,27.0,"Southern Asia",419683,0,419683,295667,492778,"IRN",394223
1,27.0,"Western Asia",220035,0,220035,151525,252542,"IRQ",202034
1,27.0,"Eastern Asia",823572,0,823572,582291,970485,"JPN",776388
1,27.0,"Southern Africa",59096,0,59096,38403,64005,"ZAF",51204
1,27.0,"South-Eastern Asia",509875,0,509875,358812,598021,"IDN",478417
1,27.0,"Caribbean",164099,0,164099,111500,185833,"CUB",148667
1,28.0,"Pakistan",1600094,1178964,421130,1049896,1749827,"PAK",1399862
1,28.0,"India",5237733,4891190,346543,3612177,6020296,"IND",4816237
1,28.0,"Western Europe",2566469,2551766,14703,1805272,3008787,"NLD",2407030
1,28.0,"China",9753009,7726571,2026438,6760551,11267586,"CPR",9014069
1,28.0,"United States of America",2572987,2563546,9441,1816783,3027972,"USA",2422378
1,28.0,"Northern Africa",1121100,0,1121100,796191,1326986,"EGY",1061589
1,28.0,"Russian Federation",5603548,3322262,2281286,3834593,6390988,"RUS",5112791
1,28.0,"Western Africa",178781,0,178781,122456,204093,"NGA",163275
1,28.0,"South America",1772754,1330653,442101,1174207,1957012,"BRA",1565610
1,28.0,"Northern Europe",1591522,1531576,59946,1112810,1854683,"GBR",1483747
1,28.0,"Northern America",656070,605634,50436,459172,765287,"CAN",612230
1,28.0,"Oceania",358163,289917,68246,252018,420031,"NZL",336025
1,28.0,"Eastern Africa",159244,0,159244,108552,180921,"ETH",144737
1,28.0,"Middle Africa",66328,0,66328,43566,72610,"AGO",58088
1,28.0,"Eastern Europe",3987711,3912734,74977,2795976,4659960,"POL",3727968
1,28.0,"Central Asia",1438257,1337711,100546,1013631,1689386,"UZB",1351509
1,28.0,"Southern Europe",309322,0,309322,215748,359581,"ITA",287665
1,28.0,"Central America",183824,0,183824,125121,208535,"MEX",166828
1,28.0,"Southern Asia",418912,0,418912,295667,492778,"IRN",394223
1,28.0,"Western Asia",219325,0,219325,151525,252542,"IRQ",202034
1,28.0,"Eastern Asia",825987,0,825987,582291,970485,"JPN",776388
1,28.0,"Southern Africa",58874,0,58874,38403,64005,"ZAF",51204
1,28.0,"South-Eastern Asia",510337,0,510337,358812,598021,"IDN",478417
1,28.0,"Caribbean",164366,0,164366,111500,185833,"CUB",148667
1,29.0,"Pakistan",1588183,1167288,420895,1049896,1749827,"PAK",1399862
1,29.0,"India",5241243,4889998,351245,3612177,6020296,"IND",4816237
1,29.0,"Western Europe",2537448,2525235,12213,1805272,3008787,"NLD",2407030
1,29.0,"China",9790674,7755158,2035516,6760551,11267586,"CPR",9014069
1,29.0,"United States of America",2569327,2561362,7965,1816783,3027972,"USA",2422378
1,29.0,"Northern Africa",1117182,0,1117182,796191,1326986,"EGY",1061589
1,29.0,"Russian Federation",5589579,3315089,2274490,3834593,6390988,"RUS",5112791
1,29.0,"Western Africa",178061,0,178061,122456,204093,"NGA",163275
1,29.0,"South America",1780046,1335738,444308,1174207,1957012,"BRA",1565610
1,29.0,"Northern Europe",1587961,1529693,58268,1112810,1854683,"GBR",1483747
1,29.0,"Northern America",654458,606790,47668,459172,765287,"CAN",612230
1,29.0,"Oceania",358016,295739,62277,252018,420031,"NZL",336025
1,29.0,"Eastern Africa",158712,0,158712,108552,180921,"ETH",144737
1,29.0,"Middle Africa",65997,0,65997,43566,72610,"AGO",58088
1,29.0,"Eastern Europe",3980731,3907236,73495,2795976,4659960,"POL",3727968
1,29.0,"Central Asia",1451519,1351549,99970,1013631,1689386,"UZB",1351509
1,29.0,"Southern Europe",307763,0,307763,215748,359581,"ITA",287665
1,29.0,"Central America",183295,0,183295,125121,208535,"MEX",166828
1,29.0,"Southern Asia",418261,0,418261,295667,492778,"IRN",394223
1,29.0,"Western Asia",218613,0,218613,151525,252542,"IRQ",202034
1,29.0,"Eastern Asia",825542,0,825542,582291,970485,"JPN",776388
1,29.0,"Southern Africa",58617,0,58617,38403,64005,"ZAF",51204
1,29.0,"South-Eastern Asia",509920,0,509920,358812,598021,"IDN",478417
1,29.0,"Caribbean",163884,0,163884,111500,185833,"CUB",148667
1,30.0,"Pakistan",1591993,1170406,421587,1049896,1749827,"PAK",1399862
1,30.0,"India",5242619,4886692,355927,3612177,6020296,"IND",4816237
1,30.0,"Western Europe",2539217,2527946,11271,1805272,3008787,"NLD",2407030
1,30.0,"China",9822981,7777158,2045823,6760551,11267586,"CPR",9014069
1,30.0,"United States of America",2565764,2559055,6709,1816783,3027972,"USA",2422378
1,30.0,"Northern Africa",1117246,0,1117246,796191,1326986,"EGY",1061589
1,30.0,"Russian Federation",5578955,3307781,2271174,3834593,6390988,"RUS",5112791
1,30.0,"Western Africa",177891,0,177891,122456,204093,"NGA",163275
1,30.0,"South America",1784951,1338812,446139,1174207,1957012,"BRA",1565610
1,30.0,"Northern Europe",1584891,1532732,52159,1112810,1854683,"GBR",1483747
1,30.0,"Northern America",652973,607589,45384,459172,765287,"CAN",612230
1,30.0,"Oceania",357663,301569,56094,252018,420031,"NZL",336025
1,30.0,"Eastern Africa",158406,0,158406,108552,180921,"ETH",144737
1,30.0,"Middle Africa",65834,0,65834,43566,72610,"AGO",58088
1,30.0,"Eastern Europe",3974370,3901949,72421,2795976,4659960,"POL",3727968
1,30.0,"Central Asia",1434241,1340618,93623,1013631,1689386,"UZB",1351509
1,30.0,"Southern Europe",307044,0,307044,215748,359581,"ITA",287665
1,30.0,"Central America",182823,0,182823,125121,208535,"MEX",166828
1,30.0,"Southern Asia",417157,0,417157,295667,492778,"IRN",394223
1,30.0,"Western Asia",218050,0,218050,151525,252542,"IRQ",202034
1,30.0,"Eastern Asia",824807,0,824807,582291,970485,"JPN",776388
1,30.0,"Southern Africa",58427,0,58427,38403,64005,"ZAF",51204
1,30.0,"South-Eastern Asia",509364,0,509364,358812,598021,"IDN",478417
1,30.0,"Caribbean",163508,0,163508,111500,185833,"CUB",148667
1,31.0,"Pakistan",1593407,1171995,421412,1049896,1749827,"PAK",1399862
1,31.0,"India",5241873,4881485,360388,3612177,6020296,"IND",4816237
1,31.0,"Western Europe",2540133,2529677,10456,1805272,3008787,"NLD",2407030
1,31.0,"China",9846307,7792962,2053345,6760551,11267586,"CPR",9014069
1,31.0,"United States of America",2562318,2556666,5652,1816783,3027972,"USA",2422378
1,31.0,"Northern Africa",1116920,0,1116920,796191,1326986,"EGY",1061589
1,31.0,"Russian Federation",5566598,3300000,2266598,3834593,6390988,"RUS",5112791
1,31.0,"Western Africa",177210,0,177210,122456,204093,"NGA",163275
1,31.0,"South America",1787115,1340129,446986,1174207,1957012,"BRA",1565610
1,31.0,"Northern Europe",1566678,1519582,47096,1112810,1854683,"GBR",1483747
1,31.0,"Northern America",651565,608109,43456,459172,765287,"CAN",612230
1,31.0,"Oceania",354332,304487,49845,252018,420031,"NZL",336025
1,31.0,"Eastern Africa",157537,0,157537,108552,180921,"ETH",144737
1,31.0,"Middle Africa",65440,0,65440,43566,72610,"AGO",58088
1,31.0,"Eastern Europe",3968216,3896737,71479,2795976,4659960,"POL",3727968
1,31.0,"Central Asia",1433741,1340503,93238,1013631,1689386,"UZB",1351509
1,31.0,"Southern Europe",306234,0,306234,215748,359581,"ITA",287665
1,31.0,"Central America",182201,0,182201,125121,208535,"MEX",166828
1,31.0,"Southern Asia",416067,0,416067,295667,492778,"IRN",394223
1,31.0,"Western Asia",217019,0,217019,151525,252542,"IRQ",202034
1,31.0,"Eastern Asia",822914,0,822914,582291,970485,"JPN",776388
1,31.0,"Southern Africa",58022,0,58022,38403,64005,"ZAF",51204
1,31.0,"South-Eastern Asia",507630,0,507630,358812,598021,"IDN",478417
1,31.0,"Caribbean",163045,0,163045,111500,185833,"CUB",148667
1,32.0,"Pakistan",1592638,1172388,420250,1049896,1749827,"PAK",1399862
1,32.0,"India",5239414,4874776,364638,3612177,6020296,"IND",4816237
1,32.0,"Western Europe",2540230,2530647,9583,1805272,3008787,"NLD",2407030
1,32.0,"China",9861055,7803379,2057676,6760551,11267586,"CPR",9014069
1,32.0,"United States of America",2534780,2530207,4573,1816783,3027972,"USA",2422378
1,32.0,"Northern Africa",1114015,0,1114015,796191,1326986,"EGY",1061589
1,32.0,"Russian Federation",5591810,3333048,2258762,3834593,6390988,"RUS",5112791
1,32.0,"Western Africa",176583,0,176583,122456,204093,"NGA",163275
1,32.0,"South America",1786596,1340058,446538,1174207,1957012,"BRA",1565610
1,32.0,"Northern Europe",1566730,1520519,46211,1112810,1854683,"GBR",1483747
1,32.0,"Northern America",649944,608402,41542,459172,765287,"CAN",612230
1,32.0,"Oceania",354205,310873,43332,252018,420031,"NZL",336025
1,32.0,"Eastern Africa",157111,0,157111,108552,180921,"ETH",144737
1,32.0,"Middle Africa",65334,0,65334,43566,72610,"AGO",58088
1,32.0,"Eastern Europe",3962031,3891875,70156,2795976,4659960,"POL",3727968
1,32.0,"Central Asia",1432714,1341727,90987,1013631,1689386,"UZB",1351509
1,32.0,"Southern Europe",305186,0,305186,215748,359581,"ITA",287665
1,32.0,"Central America",180911,0,180911,125121,208535,"MEX",166828
1,32.0,"Southern Asia",415596,0,415596,295667,492778,"IRN",394223
1,32.0,"Western Asia",216279,0,216279,151525,252542,"IRQ",202034
1,32.0,"Eastern Asia",819361,0,819361,582291,970485,"JPN",776388
1,32.0,"Southern Africa",57910,0,57910,38403,64005,"ZAF",51204
1,32.0,"South-Eastern Asia",506321,0,506321,358812,598021,"IDN",478417
1,32.0,"Caribbean",162039,0,162039,111500,185833,"CUB",148667
1,33.0,"Pakistan",1605213,1185198,420015,1049896,1749827,"PAK",1399862
1,33.0,"India",5295179,4925264,369915,3612177,6020296,"IND",4816237
1,33.0,"Western Europe",2539893,2531559,8334,1805272,3008787,"NLD",2407030
1,33.0,"China",9877324,7809329,2067995,6760551,11267586,"CPR",9014069
1,33.0,"United States of America",2560459,2556593,3866,1816783,3027972,"USA",2422378
1,33.0,"Northern Africa",1116363,0,1116363,796191,1326986,"EGY",1061589
1,33.0,"Russian Federation",5577712,3321030,2256682,3834593,6390988,"RUS",5112791
1,33.0,"Western Africa",176400,0,176400,122456,204093,"NGA",163275
1,33.0,"South America",1786097,1338994,447103,1174207,1957012,"BRA",1565610
1,33.0,"Northern Europe",1566805,1521085,45720,1112810,1854683,"GBR",1483747
1,33.0,"Northern America",643271,609553,33718,459172,765287,"CAN",612230
1,33.0,"Oceania",354364,317281,37083,252018,420031,"NZL",336025
1,33.0,"Eastern Africa",156866,0,156866,108552,180921,"ETH",144737
1,33.0,"Middle Africa",65190,0,65190,43566,72610,"AGO",58088
1,33.0,"Eastern Europe",3956235,3892329,63906,2795976,4659960,"POL",3727968
1,33.0,"Central Asia",1432091,1342561,89530,1013631,1689386,"UZB",1351509
1,33.0,"Southern Europe",304724,0,304724,215748,359581,"ITA",287665
1,33.0,"Central America",180757,0,180757,125121,208535,"MEX",166828
1,33.0,"Southern Asia",414888,0,414888,295667,492778,"IRN",394223
1,33.0,"Western Asia",215932,0,215932,151525,252542,"IRQ",202034
1,33.0,"Eastern Asia",817802,0,817802,582291,970485,"JPN",776388
1,33.0,"Southern Africa",57774,0,57774,38403,64005,"ZAF",51204
1,33.0,"South-Eastern Asia",504805,0,504805,358812,598021,"IDN",478417
1,33.0,"Caribbean",161869,0,161869,111500,185833,"CUB",148667
1,34.0,"Pakistan",1599741,1182140,417601,1049896,1749827,"PAK",1399862
1,34.0,"India",5280458,4906824,373634,3612177,6020296,"IND",4816237
1,34.0,"Western Europe",2539091,2531748,7343,1805272,3008787,"NLD",2407030
1,34.0,"China",9884706,7810437,2074269,6760551,11267586,"CPR",9014069
1,34.0,"United States of America",2556431,2553197,3234,1816783,3027972,"USA",2422378
1,34.0,"Northern Africa",1116238,0,1116238,796191,1326986,"EGY",1061589
1,34.0,"Russian Federation",5599994,3348715,2251279,3834593,6390988,"RUS",5112791
1,34.0,"Western Africa",175688,0,175688,122456,204093,"NGA",163275
1,34.0,"South America",1783241,1336853,446388,1174207,1957012,"BRA",1565610
1,34.0,"Northern Europe",1566421,1521171,45250,1112810,1854683,"GBR",1483747
1,34.0,"Northern America",643239,610557,32682,459172,765287,"CAN",612230
1,34.0,"Oceania",351171,320613,30558,252018,420031,"NZL",336025
1,34.0,"Eastern Africa",155964,0,155964,108552,180921,"ETH",144737
1,34.0,"Middle Africa",64899,0,64899,43566,72610,"AGO",58088
1,34.0,"Eastern Europe",3950755,3888929,61826,2795976,4659960,"POL",3727968
1,34.0,"Central Asia",1431008,1342854,88154,1013631,1689386,"UZB",1351509
1,34.0,"Southern Europe",304496,0,304496,215748,359581,"ITA",287665
1,34.0,"Central America",180167,0,180167,125121,208535,"MEX",166828
1,34.0,"Southern Asia",414267,0,414267,295667,492778,"IRN",394223
1,34.0,"Western Asia",215134,0,215134,151525,252542,"IRQ",202034
1,34.0,"Eastern Asia",816470,0,816470,582291,970485,"JPN",776388
1,34.0,"Southern Africa",57419,0,57419,38403,64005,"ZAF",51204
1,34.0,"South-Eastern Asia",503366,0,503366,358812,598021,"IDN",478417
1,34.0,"Caribbean",161338,0,161338,111500,185833,"CUB",148667
1,35.0,"Pakistan",1594585,1178834,415751,1049896,1749827,"PAK",1399862
1,35.0,"India",5267149,4888839,378310,3612177,6020296,"IND",4816237
1,35.0,"Western Europe",2537941,2531414,6527,1805272,3008787,"NLD",2407030
1,35.0,"China",9890937,7807750,2083187,6760551,11267586,"CPR",9014069
1,35.0,"United States of America",2552705,2549988,2717,1816783,3027972,"USA",2422378
1,35.0,"Northern Africa",1116148,0,1116148,796191,1326986,"EGY",1061589
1,35.0,"Russian Federation",5580149,3332793,2247356,3834593,6390988,"RUS",5112791
1,35.0,"Western Africa",175604,0,175604,122456,204093,"NGA",163275
1,35.0,"South America",1780031,1334047,445984,1174207,1957012,"BRA",1565610
1,35.0,"Northern Europe",1565786,1520931,44855,1112810,1854683,"GBR",1483747
1,35.0,"Northern America",643163,611241,31922,459172,765287,"CAN",612230
1,35.0,"Oceania",354536,330019,24517,252018,420031,"NZL",336025
1,35.0,"Eastern Africa",156084,0,156084,108552,180921,"ETH",144737
1,35.0,"Middle Africa",64879,0,64879,43566,72610,"AGO",58088
1,35.0,"Eastern Europe",3945480,3885372,60108,2795976,4659960,"POL",3727968
1,35.0,"Central Asia",1443020,1355911,87109,1013631,1689386,"UZB",1351509
1,35.0,"Southern Europe",304289,0,304289,215748,359581,"ITA",287665
1,35.0,"Central America",179645,0,179645,125121,208535,"MEX",166828
1,35.0,"Southern Asia",415268,0,415268,295667,492778,"IRN",394223
1,35.0,"Western Asia",215025,0,215025,151525,252542,"IRQ",202034
1,35.0,"Eastern Asia",817993,0,817993,582291,970485,"JPN",776388
1,35.0,"Southern Africa",57435,0,57435,38403,64005,"ZAF",51204
1,35.0,"South-Eastern Asia",504872,0,504872,358812,598021,"IDN",478417
1,35.0,"Caribbean",160845,0,160845,111500,185833,"CUB",148667
1,36.0,"Pakistan",1588517,1175244,413273,1049896,1749827,"PAK",1399862
1,36.0,"India",5309416,4926886,382530,3612177,6020296,"IND",4816237
1,36.0,"Western Europe",2536433,2530662,5771,1805272,3008787,"NLD",2407030
1,36.0,"China",9892516,7801371,2091145,6760551,11267586,"CPR",9014069
1,36.0,"United States of America",2549046,2546943,2103,1816783,3027972,"USA",2422378
1,36.0,"Northern Africa",1116399,0,1116399,796191,1326986,"EGY",1061589
1,36.0,"Russian Federation",5599450,3355963,2243487,3834593,6390988,"RUS",5112791
1,36.0,"Western Africa",175054,0,175054,122456,204093,"NGA",163275
1,36.0,"South America",1789737,1344859,444878,1174207,1957012,"BRA",1565610
1,36.0,"Northern Europe",1564821,1520418,44403,1112810,1854683,"GBR",1483747
1,36.0,"Northern America",648442,617313,31129,459172,765287,"CAN",612230
1,36.0,"Oceania",351096,331440,19656,252018,420031,"NZL",336025
1,36.0,"Eastern Africa",155202,0,155202,108552,180921,"ETH",144737
1,36.0,"Middle Africa",64623,0,64623,43566,72610,"AGO",58088
1,36.0,"Eastern Europe",3940432,3881712,58720,2795976,4659960,"POL",3727968
1,36.0,"Central Asia",1425849,1344816,81033,1013631,1689386,"UZB",1351509
1,36.0,"Southern Europe",304739,0,304739,215748,359581,"ITA",287665
1,36.0,"Central America",179502,0,179502,125121,208535,"MEX",166828
1,36.0,"Southern Asia",414496,0,414496,295667,492778,"IRN",394223
1,36.0,"Western Asia",214472,0,214472,151525,252542,"IRQ",202034
1,36.0,"Eastern Asia",819481,0,819481,582291,970485,"JPN",776388
1,36.0,"Southern Africa",57115,0,57115,38403,64005,"ZAF",51204
1,36.0,"South-Eastern Asia",504776,0,504776,358812,598021,"IDN",478417
1,36.0,"Caribbean",160647,0,160647,111500,185833,"CUB",148667
1,37.0,"Pakistan",1595048,1183671,411377,1049896,1749827,"PAK",1399862
1,37.0,"India",5287182,4900361,386821,3612177,6020296,"IND",4816237
1,37.0,"Western Europe",2558391,2553135,5256,1805272,3008787,"NLD",2407030
1,37.0,"China",9893247,7791739,2101508,6760551,11267586,"CPR",9014069
1,37.0,"United States of America",2545720,2544051,1669,1816783,3027972,"USA",2422378
1,37.0,"Northern Africa",1118692,0,1118692,796191,1326986,"EGY",1061589
1,37.0,"Russian Federation",5577135,3337096,2240039,3834593,6390988,"RUS",5112791
1,37.0,"Western Africa",175347,0,175347,122456,204093,"NGA",163275
1,37.0,"South America",1782088,1339136,442952,1174207,1957012,"BRA",1565610
1,37.0,"Northern Europe",1578489,1534066,44423,1112810,1854683,"GBR",1483747
1,37.0,"Northern America",641393,610883,30510,459172,765287,"CAN",612230
1,37.0,"Oceania",357513,341791,15722,252018,420031,"NZL",336025
1,37.0,"Eastern Africa",155766,0,155766,108552,180921,"ETH",144737
1,37.0,"Middle Africa",64799,0,64799,43566,72610,"AGO",58088
1,37.0,"Eastern Europe",3935731,3877317,58414,2795976,4659960,"POL",3727968
1,37.0,"Central Asia",1425178,1344626,80552,1013631,1689386,"UZB",1351509
1,37.0,"Southern Europe",304217,0,304217,215748,359581,"ITA",287665
1,37.0,"Central America",178693,0,178693,125121,208535,"MEX",166828
1,37.0,"Southern Asia",414812,0,414812,295667,492778,"IRN",394223
1,37.0,"Western Asia",214588,0,214588,151525,252542,"IRQ",202034
1,37.0,"Eastern Asia",817442,0,817442,582291,970485,"JPN",776388
1,37.0,"Southern Africa",57378,0,57378,38403,64005,"ZAF",51204
1,37.0,"South-Eastern Asia",505152,0,505152,358812,598021,"IDN",478417
1,37.0,"Caribbean",159869,0,159869,111500,185833,"CUB",148667
1,38.0,"Pakistan",1585392,1178339,407053,1049896,1749827,"PAK",1399862
1,38.0,"India",5319590,4929392,390198,3612177,6020296,"IND",4816237
1,38.0,"Western Europe",2527946,2523791,4155,1805272,3008787,"NLD",2407030
1,38.0,"China",9886296,7778981,2107315,6760551,11267586,"CPR",9014069
1,38.0,"United States of America",2542536,2541298,1238,1816783,3027972,"USA",2422378
1,38.0,"Northern Africa",1114965,0,1114965,796191,1326986,"EGY",1061589
1,38.0,"Russian Federation",5590090,3356355,2233735,3834593,6390988,"RUS",5112791
1,38.0,"Western Africa",174139,0,174139,122456,204093,"NGA",163275
1,38.0,"South America",1786887,1346947,439940,1174207,1957012,"BRA",1565610
1,38.0,"Northern Europe",1574116,1531514,42602,1112810,1854683,"GBR",1483747
1,38.0,"Northern America",652285,622221,30064,459172,765287,"CAN",612230
1,38.0,"Oceania",350127,337675,12452,252018,420031,"NZL",336025
1,38.0,"Eastern Africa",154149,0,154149,108552,180921,"ETH",144737
1,38.0,"Middle Africa",64191,0,64191,43566,72610,"AGO",58088
1,38.0,"Eastern Europe",3930645,3873494,57151,2795976,4659960,"POL",3727968
1,38.0,"Central Asia",1424366,1343758,80608,1013631,1689386,"UZB",1351509
1,38.0,"Southern Europe",304387,0,304387,215748,359581,"ITA",287665
1,38.0,"Central America",178776,0,178776,125121,208535,"MEX",166828
1,38.0,"Southern Asia",414432,0,414432,295667,492778,"IRN",394223
1,38.0,"Western Asia",213816,0,213816,151525,252542,"IRQ",202034
1,38.0,"Eastern Asia",820622,0,820622,582291,970485,"JPN",776388
1,38.0,"Southern Africa",56709,0,56709,38403,64005,"ZAF",51204
1,38.0,"South-Eastern Asia",504931,0,504931,358812,598021,"IDN",478417
1,38.0,"Caribbean",159878,0,159878,111500,185833,"CUB",148667
1,39.0,"Pakistan",1588393,1185097,403296,1049896,1749827,"PAK",1399862
1,39.0,"India",5290440,4896979,393461,3612177,6020296,"IND",4816237
1,39.0,"Western Europe",2550173,2546265,3908,1805272,3008787,"NLD",2407030
1,39.0,"China",9878433,7764025,2114408,6760551,11267586,"CPR",9014069
1,39.0,"United States of America",2539809,2538673,1136,1816783,3027972,"USA",2422378
1,39.0,"Northern Africa",1116504,0,1116504,796191,1326986,"EGY",1061589
1,39.0,"Russian Federation",5561435,3335563,2225872,3834593,6390988,"RUS",5112791
1,39.0,"Western Africa",174088,0,174088,122456,204093,"NGA",163275
1,39.0,"South America",1775454,1342573,432881,1174207,1957012,"BRA",1565610
1,39.0,"Northern Europe",1570404,1531644,38760,1112810,1854683,"GBR",1483747
1,39.0,"Northern America",638636,614911,23725,459172,765287,"CAN",612230
1,39.0,"Oceania",356584,346678,9906,252018,420031,"NZL",336025
1,39.0,"Eastern Africa",154689,0,154689,108552,180921,"ETH",144737
1,39.0,"Middle Africa",64303,0,64303,43566,72610,"AGO",58088
1,39.0,"Eastern Europe",3926388,3869007,57381,2795976,4659960,"POL",3727968
1,39.0,"Central Asia",1435908,1355732,80176,1013631,1689386,"UZB",1351509
1,39.0,"Southern Europe",303040,0,303040,215748,359581,"ITA",287665
1,39.0,"Central America",177569,0,177569,125121,208535,"MEX",166828
1,39.0,"Southern Asia",414512,0,414512,295667,492778,"IRN",394223
1,39.0,"Western Asia",213674,0,213674,151525,252542,"IRQ",202034
1,39.0,"Eastern Asia",814661,0,814661,582291,970485,"JPN",776388
1,39.0,"Southern Africa",56958,0,56958,38403,64005,"ZAF",51204
1,39.0,"South-Eastern Asia",503589,0,503589,358812,598021,"IDN",478417
1,39.0,"Caribbean",158617,0,158617,111500,185833,"CUB",148667
1,40.0,"Pakistan",1577259,1179314,397945,1049896,1749827,"PAK",1399862
1,40.0,"India",5315948,4919583,396365,3612177,6020296,"IND",4816237
1,40.0,"Western Europe",2521019,2517767,3252,1805272,3008787,"NLD",2407030
1,40.0,"China",9867996,7747058,2120938,6760551,11267586,"CPR",9014069
1,40.0,"United States of America",2537036,2536161,875,1816783,3027972,"USA",2422378
1,40.0,"Northern Africa",1112748,0,1112748,796191,1326986,"EGY",1061589
1,40.0,"Russian Federation",5572690,3352514,2220176,3834593,6390988,"RUS",5112791
1,40.0,"Western Africa",173235,0,173235,122456,204093,"NGA",163275
1,40.0,"South America",1764648,1338374,426274,1174207,1957012,"BRA",1565610
1,40.0,"Northern Europe",1567070,1529656,37414,1112810,1854683,"GBR",1483747
1,40.0,"Northern America",649728,626279,23449,459172,765287,"CAN",612230
1,40.0,"Oceania",352309,344536,7773,252018,420031,"NZL",336025
1,40.0,"Eastern Africa",153684,0,153684,108552,180921,"ETH",144737
1,40.0,"Middle Africa",63828,0,63828,43566,72610,"AGO",58088
1,40.0,"Eastern Europe",3921718,3865320,56398,2795976,4659960,"POL",3727968
1,40.0,"Central Asia",1419443,1341599,77844,1013631,1689386,"UZB",1351509
1,40.0,"Southern Europe",303228,0,303228,215748,359581,"ITA",287665
1,40.0,"Central America",177632,0,177632,125121,208535,"MEX",166828
1,40.0,"Southern Asia",413551,0,413551,295667,492778,"IRN",394223
1,40.0,"Western Asia",213273,0,213273,151525,252542,"IRQ",202034
1,40.0,"Eastern Asia",819670,0,819670,582291,970485,"JPN",776388
1,40.0,"Southern Africa",56486,0,56486,38403,64005,"ZAF",51204
1,40.0,"South-Eastern Asia",504810,0,504810,358812,598021,"IDN",478417
1,40.0,"Caribbean",158725,0,158725,111500,185833,"CUB",148667
1,41.0,"Pakistan",1569479,1174645,394834,1049896,1749827,"PAK",1399862
1,41.0,"India",5284508,4883596,400912,3612177,6020296,"IND",4816237
1,41.0,"Western Europe",2543289,2540195,3094,1805272,3008787,"NLD",2407030
1,41.0,"China",9964002,7825843,2138159,6760551,11267586,"CPR",9014069
1,41.0,"United States of America",2556352,2555720,632,1816783,3027972,"USA",2422378
1,41.0,"Northern Africa",1120769,0,1120769,796191,1326986,"EGY",1061589
1,41.0,"Russian Federation",5554731,3330916,2223815,3834593,6390988,"RUS",5112791
1,41.0,"Western Africa",173832,0,173832,122456,204093,"NGA",163275
1,41.0,"South America",1769584,1347142,422442,1174207,1957012,"BRA",1565610
1,41.0,"Northern Europe",1564329,1529780,34549,1112810,1854683,"GBR",1483747
1,41.0,"Northern America",641952,623501,18451,459172,765287,"CAN",612230
1,41.0,"Oceania",355100,348908,6192,252018,420031,"NZL",336025
1,41.0,"Eastern Africa",154414,0,154414,108552,180921,"ETH",144737
1,41.0,"Middle Africa",63934,0,63934,43566,72610,"AGO",58088
1,41.0,"Eastern Europe",3952916,3896158,56758,2795976,4659960,"POL",3727968
1,41.0,"Central Asia",1431724,1353411,78313,1013631,1689386,"UZB",1351509
1,41.0,"Southern Europe",303815,0,303815,215748,359581,"ITA",287665
1,41.0,"Central America",177881,0,177881,125121,208535,"MEX",166828
1,41.0,"Southern Asia",415729,0,415729,295667,492778,"IRN",394223
1,41.0,"Western Asia",214306,0,214306,151525,252542,"IRQ",202034
1,41.0,"Eastern Asia",817838,0,817838,582291,970485,"JPN",776388
1,41.0,"Southern Africa",56565,0,56565,38403,64005,"ZAF",51204
1,41.0,"South-Eastern Asia",504529,0,504529,358812,598021,"IDN",478417
1,41.0,"Caribbean",158869,0,158869,111500,185833,"CUB",148667
1,42.0,"Pakistan",1560375,1173739,386636,1049896,1749827,"PAK",1399862
1,42.0,"India",5305664,4901187,404477,3612177,6020296,"IND",4816237
1,42.0,"Western Europe",2537381,2534658,2723,1805272,3008787,"NLD",2407030
1,42.0,"China",9935730,7790896,2144834,6760551,11267586,"CPR",9014069
1,42.0,"United States of America",2548913,2548370,543,1816783,3027972,"USA",2422378
1,42.0,"Northern Africa",1119181,0,1119181,796191,1326986,"EGY",1061589
1,42.0,"Russian Federation",5566224,3344593,2221631,3834593,6390988,"RUS",5112791
1,42.0,"Western Africa",173620,0,173620,122456,204093,"NGA",163275
1,42.0,"South America",1757312,1347439,409873,1174207,1957012,"BRA",1565610
1,42.0,"Northern Europe",1561678,1527188,34490,1112810,1854683,"GBR",1483747
1,42.0,"Northern America",652076,633612,18464,459172,765287,"CAN",612230
1,42.0,"Oceania",351014,346207,4807,252018,420031,"NZL",336025
1,42.0,"Eastern Africa",153557,0,153557,108552,180921,"ETH",144737
1,42.0,"Middle Africa",63585,0,63585,43566,72610,"AGO",58088
1,42.0,"Eastern Europe",3941082,3885135,55947,2795976,4659960,"POL",3727968
1,42.0,"Central Asia",1428188,1350166,78022,1013631,1689386,"UZB",1351509
1,42.0,"Southern Europe",304637,0,304637,215748,359581,"ITA",287665
1,42.0,"Central America",177894,0,177894,125121,208535,"MEX",166828
1,42.0,"Southern Asia",415896,0,415896,295667,492778,"IRN",394223
1,42.0,"Western Asia",214084,0,214084,151525,252542,"IRQ",202034
1,42.0,"Eastern Asia",821213,0,821213,582291,970485,"JPN",776388
1,42.0,"Southern Africa",56123,0,56123,38403,64005,"ZAF",51204
1,42.0,"South-Eastern Asia",504775,0,504775,358812,598021,"IDN",478417
1,42.0,"Caribbean",158924,0,158924,111500,185833,"CUB",148667
1,43.0,"Pakistan",1530566,1172617,357949,1049896,1749827,"PAK",1399862
1,43.0,"India",5320026,4912014,408012,3612177,6020296,"IND",4816237
1,43.0,"Western Europe",2554540,2551924,2616,1805272,3008787,"NLD",2407030
1,43.0,"China",9911318,7756295,2155023,6760551,11267586,"CPR",9014069
1,43.0,"United States of America",2563921,2563632,289,1816783,3027972,"USA",2422378
1,43.0,"Northern Africa",1121713,0,1121713,796191,1326986,"EGY",1061589
1,43.0,"Russian Federation",5574418,3354932,2219486,3834593,6390988,"RUS",5112791
1,43.0,"Western Africa",173694,0,173694,122456,204093,"NGA",163275
1,43.0,"South America",1721246,1344326,376920,1174207,1957012,"BRA",1565610
1,43.0,"Northern Europe",1573110,1538422,34688,1112810,1854683,"GBR",1483747
1,43.0,"Northern America",638148,623747,14401,459172,765287,"CAN",612230
1,43.0,"Oceania",359992,356102,3890,252018,420031,"NZL",336025
1,43.0,"Eastern Africa",154400,0,154400,108552,180921,"ETH",144737
1,43.0,"Middle Africa",63674,0,63674,43566,72610,"AGO",58088
1,43.0,"Eastern Europe",3931168,3875072,56096,2795976,4659960,"POL",3727968
1,43.0,"Central Asia",1425511,1347249,78262,1013631,1689386,"UZB",1351509
1,43.0,"Southern Europe",303240,0,303240,215748,359581,"ITA",287665
1,43.0,"Central America",177551,0,177551,125121,208535,"MEX",166828
1,43.0,"Southern Asia",414712,0,414712,295667,492778,"IRN",394223
1,43.0,"Western Asia",213624,0,213624,151525,252542,"IRQ",202034
1,43.0,"Eastern Asia",818083,0,818083,582291,970485,"JPN",776388
1,43.0,"Southern Africa",56492,0,56492,38403,64005,"ZAF",51204
1,43.0,"South-Eastern Asia",506465,0,506465,358812,598021,"IDN",478417
1,43.0,"Caribbean",158453,0,158453,111500,185833,"CUB",148667
1,44.0,"Pakistan",1529149,1172891,356258,1049896,1749827,"PAK",1399862
1,44.0,"India",5327870,4917005,410865,3612177,6020296,"IND",4816237
1,44.0,"Western Europe",2522984,2520553,2431,1805272,3008787,"NLD",2407030
1,44.0,"China",9979832,7814312,2165520,6760551,11267586,"CPR",9014069
1,44.0,"United States of America",2553512,2553263,249,1816783,3027972,"USA",2422378
1,44.0,"Northern Africa",1118714,0,1118714,796191,1326986,"EGY",1061589
1,44.0,"Russian Federation",5578757,3362252,2216505,3834593,6390988,"RUS",5112791
1,44.0,"Western Africa",173359,0,173359,122456,204093,"NGA",163275
1,44.0,"South America",1718396,1343630,374766,1174207,1957012,"BRA",1565610
1,44.0,"Northern Europe",1567805,1534070,33735,1112810,1854683,"GBR",1483747
1,44.0,"Northern America",653903,639397,14506,459172,765287,"CAN",612230
1,44.0,"Oceania",351710,348726,2984,252018,420031,"NZL",336025
1,44.0,"Eastern Africa",153457,0,153457,108552,180921,"ETH",144737
1,44.0,"Middle Africa",63126,0,63126,43566,72610,"AGO",58088
1,44.0,"Eastern Europe",3955878,3900383,55495,2795976,4659960,"POL",3727968
1,44.0,"Central Asia",1434892,1356559,78333,1013631,1689386,"UZB",1351509
1,44.0,"Southern Europe",304333,0,304333,215748,359581,"ITA",287665
1,44.0,"Central America",177878,0,177878,125121,208535,"MEX",166828
1,44.0,"Southern Asia",416921,0,416921,295667,492778,"IRN",394223
1,44.0,"Western Asia",214324,0,214324,151525,252542,"IRQ",202034
1,44.0,"Eastern Asia",823063,0,823063,582291,970485,"JPN",776388
1,44.0,"Southern Africa",55746,0,55746,38403,64005,"ZAF",51204
1,44.0,"South-Eastern Asia",505334,0,505334,358812,598021,"IDN",478417
1,44.0,"Caribbean",158721,0,158721,111500,185833,"CUB",148667
1,45.0,"Pakistan",1515274,1176096,339178,1049896,1749827,"PAK",1399862
1,45.0,"India",5330355,4917221,413134,3612177,6020296,"IND",4816237
1,45.0,"Western Europe",2563648,2561045,2603,1805272,3008787,"NLD",2407030
1,45.0,"China",9938285,7766317,2171968,6760551,11267586,"CPR",9014069
1,45.0,"United States of America",2544931,2544719,212,1816783,3027972,"USA",2422378
1,45.0,"Northern Africa",1121849,0,1121849,796191,1326986,"EGY",1061589
1,45.0,"Russian Federation",5576388,3366935,2209453,3834593,6390988,"RUS",5112791
1,45.0,"Western Africa",173129,0,173129,122456,204093,"NGA",163275
1,45.0,"South America",1713981,1346167,367814,1174207,1957012,"BRA",1565610
1,45.0,"Northern Europe",1576828,1545176,31652,1112810,1854683,"GBR",1483747
1,45.0,"Northern America",639189,628171,11018,459172,765287,"CAN",612230
1,45.0,"Oceania",359983,357755,2228,252018,420031,"NZL",336025
1,45.0,"Eastern Africa",154185,0,154185,108552,180921,"ETH",144737
1,45.0,"Middle Africa",63278,0,63278,43566,72610,"AGO",58088
1,45.0,"Eastern Europe",3940922,3891886,49036,2795976,4659960,"POL",3727968
1,45.0,"Central Asia",1429813,1354064,75749,1013631,1689386,"UZB",1351509
1,45.0,"Southern Europe",303677,0,303677,215748,359581,"ITA",287665
1,45.0,"Central America",176466,0,176466,125121,208535,"MEX",166828
1,45.0,"Southern Asia",415716,0,415716,295667,492778,"IRN",394223
1,45.0,"Western Asia",213487,0,213487,151525,252542,"IRQ",202034
1,45.0,"Eastern Asia",816967,0,816967,582291,970485,"JPN",776388
1,45.0,"Southern Africa",56161,0,56161,38403,64005,"ZAF",51204
1,45.0,"South-Eastern Asia",506446,0,506446,358812,598021,"IDN",478417
1,45.0,"Caribbean",157634,0,157634,111500,185833,"CUB",148667
1,46.0,"Pakistan",1516432,1177603,338829,1049896,1749827,"PAK",1399862
1,46.0,"India",5329636,4913584,416052,3612177,6020296,"IND",4816237
1,46.0,"Western Europe",2572324,2570278,2046,1805272,3008787,"NLD",2407030
1,46.0,"China",9996866,7809950,2186916,6760551,11267586,"CPR",9014069
1,46.0,"United States of America",2558563,2558386,177,1816783,3027972,"USA",2422378
1,46.0,"Northern Africa",1124749,0,1124749,796191,1326986,"EGY",1061589
1,46.0,"Russian Federation",5549626,3337494,2212132,3834593,6390988,"RUS",5112791
1,46.0,"Western Africa",173952,0,173952,122456,204093,"NGA",163275
1,46.0,"South America",1699770,1347448,352322,1174207,1957012,"BRA",1565610
1,46.0,"Northern Europe",1570108,1539174,30934,1112810,1854683,"GBR",1483747
1,46.0,"Northern America",654122,643048,11074,459172,765287,"CAN",612230
1,46.0,"Oceania",351489,349934,1555,252018,420031,"NZL",336025
1,46.0,"Eastern Africa",153311,0,153311,108552,180921,"ETH",144737
1,46.0,"Middle Africa",62902,0,62902,43566,72610,"AGO",58088
1,46.0,"Eastern Europe",3928360,3879345,49015,2795976,4659960,"POL",3727968
1,46.0,"Central Asia",1437625,1361546,76079,1013631,1689386,"UZB",1351509
1,46.0,"Southern Europe",305957,0,305957,215748,359581,"ITA",287665
1,46.0,"Central America",177983,0,177983,125121,208535,"MEX",166828
1,46.0,"Southern Asia",417484,0,417484,295667,492778,"IRN",394223
1,46.0,"Western Asia",213933,0,213933,151525,252542,"IRQ",202034
1,46.0,"Eastern Asia",823780,0,823780,582291,970485,"JPN",776388
1,46.0,"Southern Africa",55425,0,55425,38403,64005,"ZAF",51204
1,46.0,"South-Eastern Asia",505167,0,505167,358812,598021,"IDN",478417
1,46.0,"Caribbean",158770,0,158770,111500,185833,"CUB",148667
1,47.0,"Pakistan",1515233,1179812,335421,1049896,1749827,"PAK",1399862
1,47.0,"India",5324212,4906532,417680,3612177,6020296,"IND",4816237
1,47.0,"Western Europe",2556596,2554899,1697,1805272,3008787,"NLD",2407030
1,47.0,"China",9943400,7751747,2191653,6760551,11267586,"CPR",9014069
1,47.0,"United States of America",2568077,2567926,151,1816783,3027972,"USA",2422378
1,47.0,"Northern Africa",1124915,0,1124915,796191,1326986,"EGY",1061589
1,47.0,"Russian Federation",5548379,3341645,2206734,3834593,6390988,"RUS",5112791
1,47.0,"Western Africa",173172,0,173172,122456,204093,"NGA",163275
1,47.0,"South America",1685502,1349973,335529,1174207,1957012,"BRA",1565610
1,47.0,"Northern Europe",1577402,1546175,31227,1112810,1854683,"GBR",1483747
1,47.0,"Northern America",639337,630904,8433,459172,765287,"CAN",612230
1,47.0,"Oceania",356767,355463,1304,252018,420031,"NZL",336025
1,47.0,"Eastern Africa",153832,0,153832,108552,180921,"ETH",144737
1,47.0,"Middle Africa",62725,0,62725,43566,72610,"AGO",58088
1,47.0,"Eastern Europe",3950242,3900849,49393,2795976,4659960,"POL",3727968
1,47.0,"Central Asia",1431378,1355280,76098,1013631,1689386,"UZB",1351509
1,47.0,"Southern Europe",303927,0,303927,215748,359581,"ITA",287665
1,47.0,"Central America",177348,0,177348,125121,208535,"MEX",166828
1,47.0,"Southern Asia",416088,0,416088,295667,492778,"IRN",394223
1,47.0,"Western Asia",213651,0,213651,151525,252542,"IRQ",202034
1,47.0,"Eastern Asia",817839,0,817839,582291,970485,"JPN",776388
1,47.0,"Southern Africa",55579,0,55579,38403,64005,"ZAF",51204
1,47.0,"South-Eastern Asia",505078,0,505078,358812,598021,"IDN",478417
1,47.0,"Caribbean",158143,0,158143,111500,185833,"CUB",148667
1,48.0,"Pakistan",1493710,1173392,320318,1049896,1749827,"PAK",1399862
1,48.0,"India",5317156,4897100,420056,3612177,6020296,"IND",4816237
1,48.0,"Western Europe",2543848,2542289,1559,1805272,3008787,"NLD",2407030
1,48.0,"China",9988475,7783687,2204788,6760551,11267586,"CPR",9014069
1,48.0,"United States of America",2554080,2553953,127,1816783,3027972,"USA",2422378
1,48.0,"Northern Africa",1123686,0,1123686,796191,1326986,"EGY",1061589
1,48.0,"Russian Federation",5553060,3343968,2209092,3834593,6390988,"RUS",5112791
1,48.0,"Western Africa",173625,0,173625,122456,204093,"NGA",163275
1,48.0,"South America",1688873,1352381,336492,1174207,1957012,"BRA",1565610
1,48.0,"Northern Europe",1582329,1551717,30612,1112810,1854683,"GBR",1483747
1,48.0,"Northern America",658728,650066,8662,459172,765287,"CAN",612230
1,48.0,"Oceania",348991,348144,847,252018,420031,"NZL",336025
1,48.0,"Eastern Africa",153134,0,153134,108552,180921,"ETH",144737
1,48.0,"Middle Africa",62360,0,62360,43566,72610,"AGO",58088
1,48.0,"Eastern Europe",3965492,3916389,49103,2795976,4659960,"POL",3727968
1,48.0,"Central Asia",1437578,1361431,76147,1013631,1689386,"UZB",1351509
1,48.0,"Southern Europe",305979,0,305979,215748,359581,"ITA",287665
1,48.0,"Central America",177815,0,177815,125121,208535,"MEX",166828
1,48.0,"Southern Asia",418888,0,418888,295667,492778,"IRN",394223
1,48.0,"Western Asia",215000,0,215000,151525,252542,"IRQ",202034
1,48.0,"Eastern Asia",824969,0,824969,582291,970485,"JPN",776388
1,48.0,"Southern Africa",54820,0,54820,38403,64005,"ZAF",51204
1,48.0,"South-Eastern Asia",503848,0,503848,358812,598021,"IDN",478417
1,48.0,"Caribbean",158543,0,158543,111500,185833,"CUB",148667
1,49.0,"Pakistan",1496436,1177001,319435,1049896,1749827,"PAK",1399862
1,49.0,"India",5306429,4885581,420848,3612177,6020296,"IND",4816237
1,49.0,"Western Europe",2554246,2552584,1662,1805272,3008787,"NLD",2407030
1,49.0,"China",10011829,7803181,2208648,6760551,11267586,"CPR",9014069
1,49.0,"United States of America",2562845,2562739,106,1816783,3027972,"USA",2422378
1,49.0,"Northern Africa",1123596,0,1123596,796191,1326986,"EGY",1061589
1,49.0,"Russian Federation",5545220,3343641,2201579,3834593,6390988,"RUS",5112791
1,49.0,"Western Africa",173139,0,173139,122456,204093,"NGA",163275
1,49.0,"South America",1676452,1343451,333001,1174207,1957012,"BRA",1565610
1,49.0,"Northern Europe",1572842,1544246,28596,1112810,1854683,"GBR",1483747
1,49.0,"Northern America",642726,636125,6601,459172,765287,"CAN",612230
1,49.0,"Oceania",357317,356667,650,252018,420031,"NZL",336025
1,49.0,"Eastern Africa",153630,0,153630,108552,180921,"ETH",144737
1,49.0,"Middle Africa",62509,0,62509,43566,72610,"AGO",58088
1,49.0,"Eastern Europe",3944053,3894852,49201,2795976,4659960,"POL",3727968
1,49.0,"Central Asia",1430363,1354418,75945,1013631,1689386,"UZB",1351509
1,49.0,"Southern Europe",303942,0,303942,215748,359581,"ITA",287665
1,49.0,"Central America",177007,0,177007,125121,208535,"MEX",166828
1,49.0,"Southern Asia",416118,0,416118,295667,492778,"IRN",394223
1,49.0,"Western Asia",213478,0,213478,151525,252542,"IRQ",202034
1,49.0,"Eastern Asia",819691,0,819691,582291,970485,"JPN",776388
1,49.0,"Southern Africa",55282,0,55282,38403,64005,"ZAF",51204
1,49.0,"South-Eastern Asia",506225,0,506225,358812,598021,"IDN",478417
1,49.0,"Caribbean",157796,0,157796,111500,185833,"CUB",148667
1,50.0,"Pakistan",1498766,1179564,319202,1049896,1749827,"PAK",1399862
1,50.0,"India",5295345,4872919,422426,3612177,6020296,"IND",4816237
1,50.0,"Western Europe",2520077,2518736,1341,1805272,3008787,"NLD",2407030
1,50.0,"China",10028546,7813149,2215397,6760551,11267586,"CPR",9014069
1,50.0,"United States of America",2568393,2568393,0,1816783,3027972,"USA",2422378
1,50.0,"Northern Africa",1120052,0,1120052,796191,1326986,"EGY",1061589
1,50.0,"Russian Federation",5542823,3342430,2200393,3834593,6390988,"RUS",5112791
1,50.0,"Western Africa",173386,0,173386,122456,204093,"NGA",163275
1,50.0,"South America",1680331,1346230,334101,1174207,1957012,"BRA",1565610
1,50.0,"Northern Europe",1577692,1549099,28593,1112810,1854683,"GBR",1483747
1,50.0,"Northern America",655531,648777,6754,459172,765287,"CAN",612230
1,50.0,"Oceania",349319,349010,309,252018,420031,"NZL",336025
1,50.0,"Eastern Africa",152744,0,152744,108552,180921,"ETH",144737
1,50.0,"Middle Africa",62125,0,62125,43566,72610,"AGO",58088
1,50.0,"Eastern Europe",3957660,3908773,48887,2795976,4659960,"POL",3727968
1,50.0,"Central Asia",1435894,1359331,76563,1013631,1689386,"UZB",1351509
1,50.0,"Southern Europe",304602,0,304602,215748,359581,"ITA",287665
1,50.0,"Central America",177803,0,177803,125121,208535,"MEX",166828
1,50.0,"Southern Asia",418119,0,418119,295667,492778,"IRN",394223
1,50.0,"Western Asia",214296,0,214296,151525,252542,"IRQ",202034
1,50.0,"Eastern Asia",824342,0,824342,582291,970485,"JPN",776388
1,50.0,"Southern Africa",54627,0,54627,38403,64005,"ZAF",51204
1,50.0,"South-Eastern Asia",502832,0,502832,358812,598021,"IDN",478417
1,50.0,"Caribbean",158666,0,158666,111500,185833,"CUB",148667
1,51.0,"Pakistan",1478781,1176106,302675,1049896,1749827,"PAK",1399862
1,51.0,"India",5324568,4901293,423275,3612177,6020296,"IND",4816237
1,51.0,"Western Europe",2574893,2572990,1903,1805272,3008787,"NLD",2407030
1,51.0,"China",10032889,7814269,2218620,6760551,11267586,"CPR",9014069
1,51.0,"United States of America",2552256,2552156,100,1816783,3027972,"USA",2422378
1,51.0,"Northern Africa",1125930,0,1125930,796191,1326986,"EGY",1061589
1,51.0,"Russian Federation",5533358,3339527,2193831,3834593,6390988,"RUS",5112791
1,51.0,"Western Africa",173006,0,173006,122456,204093,"NGA",163275
1,51.0,"South America",1680115,1348349,331766,1174207,1957012,"BRA",1565610
1,51.0,"Northern Europe",1568409,1541212,27197,1112810,1854683,"GBR",1483747
1,51.0,"Northern America",640090,635032,5058,459172,765287,"CAN",612230
1,51.0,"Oceania",357246,357014,232,252018,420031,"NZL",336025
1,51.0,"Eastern Africa",153285,0,153285,108552,180921,"ETH",144737
1,51.0,"Middle Africa",62227,0,62227,43566,72610,"AGO",58088
1,51.0,"Eastern Europe",3935992,3892387,43605,2795976,4659960,"POL",3727968
1,51.0,"Central Asia",1439151,1364657,74494,1013631,1689386,"UZB",1351509
1,51.0,"Southern Europe",304264,0,304264,215748,359581,"ITA",287665
1,51.0,"Central America",175837,0,175837,125121,208535,"MEX",166828
1,51.0,"Southern Asia",416645,0,416645,295667,492778,"IRN",394223
1,51.0,"Western Asia",212892,0,212892,151525,252542,"IRQ",202034
1,51.0,"Eastern Asia",816704,0,816704,582291,970485,"JPN",776388
1,51.0,"Southern Africa",55023,0,55023,38403,64005,"ZAF",51204
1,51.0,"South-Eastern Asia",505268,0,505268,358812,598021,"IDN",478417
1,51.0,"Caribbean",156904,0,156904,111500,185833,"CUB",148667
1,52.0,"Pakistan",1484828,1179821,305007,1049896,1749827,"PAK",1399862
1,52.0,"India",5301635,4878017,423618,3612177,6020296,"IND",4816237
1,52.0,"Western Europe",2534846,2533402,1444,1805272,3008787,"NLD",2407030
1,52.0,"China",10032622,7808276,2224346,6760551,11267586,"CPR",9014069
1,52.0,"United States of America",2539403,2539403,0,1816783,3027972,"USA",2422378
1,52.0,"Northern Africa",1121445,0,1121445,796191,1326986,"EGY",1061589
1,52.0,"Russian Federation",5529292,3336006,2193286,3834593,6390988,"RUS",5112791
1,52.0,"Western Africa",173041,0,173041,122456,204093,"NGA",163275
1,52.0,"South America",1668908,1347945,320963,1174207,1957012,"BRA",1565610
1,52.0,"Northern Europe",1573018,1545941,27077,1112810,1854683,"GBR",1483747
1,52.0,"Northern America",657673,652502,5171,459172,765287,"CAN",612230
1,52.0,"Oceania",349393,349217,176,252018,420031,"NZL",336025
1,52.0,"Eastern Africa",152809,0,152809,108552,180921,"ETH",144737
1,52.0,"Middle Africa",61838,0,61838,43566,72610,"AGO",58088
1,52.0,"Eastern Europe",3979231,3935986,43245,2795976,4659960,"POL",3727968
1,52.0,"Central Asia",1441408,1366897,74511,1013631,1689386,"UZB",1351509
1,52.0,"Southern Europe",305811,0,305811,215748,359581,"ITA",287665
1,52.0,"Central America",175855,0,175855,125121,208535,"MEX",166828
1,52.0,"Southern Asia",420144,0,420144,295667,492778,"IRN",394223
1,52.0,"Western Asia",215240,0,215240,151525,252542,"IRQ",202034
1,52.0,"Eastern Asia",822776,0,822776,582291,970485,"JPN",776388
1,52.0,"Southern Africa",54427,0,54427,38403,64005,"ZAF",51204
1,52.0,"South-Eastern Asia",502034,0,502034,358812,598021,"IDN",478417
1,52.0,"Caribbean",156987,0,156987,111500,185833,"CUB",148667
1,53.0,"Pakistan",1479055,1173662,305393,1049896,1749827,"PAK",1399862
1,53.0,"India",5320739,4896416,424323,3612177,6020296,"IND",4816237
1,53.0,"Western Europe",2563245,2561883,1362,1805272,3008787,"NLD",2407030
1,53.0,"China",10028153,7795860,2232293,6760551,11267586,"CPR",9014069
1,53.0,"United States of America",2586330,2586191,139,1816783,3027972,"USA",2422378
1,53.0,"Northern Africa",1128462,0,1128462,796191,1326986,"EGY",1061589
1,53.0,"Russian Federation",5553098,3359424,2193674,3834593,6390988,"RUS",5112791
1,53.0,"Western Africa",173335,0,173335,122456,204093,"NGA",163275
1,53.0,"South America",1671761,1349960,321801,1174207,1957012,"BRA",1565610
1,53.0,"Northern Europe",1576333,1550043,26290,1112810,1854683,"GBR",1483747
1,53.0,"Northern America",636912,632878,4034,459172,765287,"CAN",612230
1,53.0,"Oceania",357071,356839,232,252018,420031,"NZL",336025
1,53.0,"Eastern Africa",153345,0,153345,108552,180921,"ETH",144737
1,53.0,"Middle Africa",62070,0,62070,43566,72610,"AGO",58088
1,53.0,"Eastern Europe",3949778,3916411,33367,2795976,4659960,"POL",3727968
1,53.0,"Central Asia",1432065,1358856,73209,1013631,1689386,"UZB",1351509
1,53.0,"Southern Europe",303637,0,303637,215748,359581,"ITA",287665
1,53.0,"Central America",177610,0,177610,125121,208535,"MEX",166828
1,53.0,"Southern Asia",416263,0,416263,295667,492778,"IRN",394223
1,53.0,"Western Asia",213014,0,213014,151525,252542,"IRQ",202034
1,53.0,"Eastern Asia",817646,0,817646,582291,970485,"JPN",776388
1,53.0,"Southern Africa",54796,0,54796,38403,64005,"ZAF",51204
1,53.0,"South-Eastern Asia",504983,0,504983,358812,598021,"IDN",478417
1,53.0,"Caribbean",158037,0,158037,111500,185833,"CUB",148667
1,54.0,"Pakistan",1483730,1176020,307710,1049896,1749827,"PAK",1399862
1,54.0,"India",5290735,4866662,424073,3612177,6020296,"IND",4816237
1,54.0,"Western Europe",2563837,2562493,1344,1805272,3008787,"NLD",2407030
1,54.0,"China",10017006,7777486,2239520,6760551,11267586,"CPR",9014069
1,54.0,"United States of America",2544441,2544334,107,1816783,3027972,"USA",2422378
1,54.0,"Northern Africa",1125979,0,1125979,796191,1326986,"EGY",1061589
1,54.0,"Russian Federation",5541054,3349037,2192017,3834593,6390988,"RUS",5112791
1,54.0,"Western Africa",173642,0,173642,122456,204093,"NGA",163275
1,54.0,"South America",1673698,1351129,322569,1174207,1957012,"BRA",1565610
1,54.0,"Northern Europe",1577641,1551859,25782,1112810,1854683,"GBR",1483747
1,54.0,"Northern America",659140,654848,4292,459172,765287,"CAN",612230
1,54.0,"Oceania",354347,354347,0,252018,420031,"NZL",336025
1,54.0,"Eastern Africa",153488,0,153488,108552,180921,"ETH",144737
1,54.0,"Middle Africa",62022,0,62022,43566,72610,"AGO",58088
1,54.0,"Eastern Europe",3955974,3922810,33164,2795976,4659960,"POL",3727968
1,54.0,"Central Asia",1434574,1361631,72943,1013631,1689386,"UZB",1351509
1,54.0,"Southern Europe",306965,0,306965,215748,359581,"ITA",287665
1,54.0,"Central America",176083,0,176083,125121,208535,"MEX",166828
1,54.0,"Southern Asia",419915,0,419915,295667,492778,"IRN",394223
1,54.0,"Western Asia",214924,0,214924,151525,252542,"IRQ",202034
1,54.0,"Eastern Asia",826875,0,826875,582291,970485,"JPN",776388
1,54.0,"Southern Africa",54687,0,54687,38403,64005,"ZAF",51204
1,54.0,"South-Eastern Asia",506698,0,506698,358812,598021,"IDN",478417
1,54.0,"Caribbean",157189,0,157189,111500,185833,"CUB",148667
1,55.0,"Pakistan",1485855,1177012,308843,1049896,1749827,"PAK",1399862
1,55.0,"India",5301496,4878559,422937,3612177,6020296,"IND",4816237
1,55.0,"Western Europe",2563081,2561847,1234,1805272,3008787,"NLD",2407030
1,55.0,"China",9993316,7754428,2238888,6760551,11267586,"CPR",9014069
1,55.0,"United States of America",2550120,2549949,171,1816783,3027972,"USA",2422378
1,55.0,"Northern Africa",1125010,0,1125010,796191,1326986,"EGY",1061589
1,55.0,"Russian Federation",5518907,3338273,2180634,3834593,6390988,"RUS",5112791
1,55.0,"Western Africa",172462,0,172462,122456,204093,"NGA",163275
1,55.0,"South America",1672619,1351276,321343,1174207,1957012,"BRA",1565610
1,55.0,"Northern Europe",1578328,1552407,25921,1112810,1854683,"GBR",1483747
1,55.0,"Northern America",637740,634562,3178,459172,765287,"CAN",612230
1,55.0,"Oceania",360478,360276,202,252018,420031,"NZL",336025
1,55.0,"Eastern Africa",153641,0,153641,108552,180921,"ETH",144737
1,55.0,"Middle Africa",61744,0,61744,43566,72610,"AGO",58088
1,55.0,"Eastern Europe",3959185,3926025,33160,2795976,4659960,"POL",3727968
1,55.0,"Central Asia",1436045,1362652,73393,1013631,1689386,"UZB",1351509
1,55.0,"Southern Europe",303570,0,303570,215748,359581,"ITA",287665
1,55.0,"Central America",175580,0,175580,125121,208535,"MEX",166828
1,55.0,"Southern Asia",417181,0,417181,295667,492778,"IRN",394223
1,55.0,"Western Asia",213315,0,213315,151525,252542,"IRQ",202034
1,55.0,"Eastern Asia",815996,0,815996,582291,970485,"JPN",776388
1,55.0,"Southern Africa",54757,0,54757,38403,64005,"ZAF",51204
1,55.0,"South-Eastern Asia",508024,0,508024,358812,598021,"IDN",478417
1,55.0,"Caribbean",156248,0,156248,111500,185833,"CUB",148667
1,56.0,"Pakistan",1488545,1177237,311308,1049896,1749827,"PAK",1399862
1,56.0,"India",5305911,4884669,421242,3612177,6020296,"IND",4816237
1,56.0,"Western Europe",2542589,2541659,930,1805272,3008787,"NLD",2407030
1,56.0,"China",10049776,7801550,2248226,6760551,11267586,"CPR",9014069
1,56.0,"United States of America",2553393,2553262,131,1816783,3027972,"USA",2422378
1,56.0,"Northern Africa",1123106,0,1123106,796191,1326986,"EGY",1061589
1,56.0,"Russian Federation",5512070,3328728,2183342,3834593,6390988,"RUS",5112791
1,56.0,"Western Africa",173359,0,173359,122456,204093,"NGA",163275
1,56.0,"South America",1674635,1350994,323641,1174207,1957012,"BRA",1565610
1,56.0,"Northern Europe",1577990,1552538,25452,1112810,1854683,"GBR",1483747
1,56.0,"Northern America",658917,655590,3327,459172,765287,"CAN",612230
1,56.0,"Oceania",351470,351470,0,252018,420031,"NZL",336025
1,56.0,"Eastern Africa",153123,0,153123,108552,180921,"ETH",144737
1,56.0,"Middle Africa",61716,0,61716,43566,72610,"AGO",58088
1,56.0,"Eastern Europe",3959889,3926806,33083,2795976,4659960,"POL",3727968
1,56.0,"Central Asia",1436795,1363322,73473,1013631,1689386,"UZB",1351509
1,56.0,"Southern Europe",305832,0,305832,215748,359581,"ITA",287665
1,56.0,"Central America",176470,0,176470,125121,208535,"MEX",166828
1,56.0,"Southern Asia",419525,0,419525,295667,492778,"IRN",394223
1,56.0,"Western Asia",214917,0,214917,151525,252542,"IRQ",202034
1,56.0,"Eastern Asia",826381,0,826381,582291,970485,"JPN",776388
1,56.0,"Southern Africa",54202,0,54202,38403,64005,"ZAF",51204
1,56.0,"South-Eastern Asia",503491,0,503491,358812,598021,"IDN",478417
1,56.0,"Caribbean",157488,0,157488,111500,185833,"CUB",148667
1,57.0,"Pakistan",1489238,1176338,312900,1049896,1749827,"PAK",1399862
1,57.0,"India",5303404,4884969,418435,3612177,6020296,"IND",4816237
1,57.0,"Western Europe",2545260,2544267,993,1805272,3008787,"NLD",2407030
1,57.0,"China",10009027,7759196,2249831,6760551,11267586,"CPR",9014069
1,57.0,"United States of America",2572778,2572586,192,1816783,3027972,"USA",2422378
1,57.0,"Northern Africa",1124579,0,1124579,796191,1326986,"EGY",1061589
1,57.0,"Russian Federation",5524291,3344325,2179966,3834593,6390988,"RUS",5112791
1,57.0,"Western Africa",172933,0,172933,122456,204093,"NGA",163275
1,57.0,"South America",1673208,1349662,323546,1174207,1957012,"BRA",1565610
1,57.0,"Northern Europe",1577251,1552449,24802,1112810,1854683,"GBR",1483747
1,57.0,"Northern America",642017,639558,2459,459172,765287,"CAN",612230
1,57.0,"Oceania",357729,357729,0,252018,420031,"NZL",336025
1,57.0,"Eastern Africa",153505,0,153505,108552,180921,"ETH",144737
1,57.0,"Middle Africa",61576,0,61576,43566,72610,"AGO",58088
1,57.0,"Eastern Europe",3958824,3925618,33206,2795976,4659960,"POL",3727968
1,57.0,"Central Asia",1436806,1363209,73597,1013631,1689386,"UZB",1351509
1,57.0,"Southern Europe",303475,0,303475,215748,359581,"ITA",287665
1,57.0,"Central America",177084,0,177084,125121,208535,"MEX",166828
1,57.0,"Southern Asia",417387,0,417387,295667,492778,"IRN",394223
1,57.0,"Western Asia",213788,0,213788,151525,252542,"IRQ",202034
1,57.0,"Eastern Asia",820139,0,820139,582291,970485,"JPN",776388
1,57.0,"Southern Africa",54533,0,54533,38403,64005,"ZAF",51204
1,57.0,"South-Eastern Asia",507009,0,507009,358812,598021,"IDN",478417
1,57.0,"Caribbean",157540,0,157540,111500,185833,"CUB",148667
1,58.0,"Pakistan",1488778,1174745,314033,1049896,1749827,"PAK",1399862
1,58.0,"India",5296316,4881409,414907,3612177,6020296,"IND",4816237
1,58.0,"Western Europe",2564498,2563497,1001,1805272,3008787,"NLD",2407030
1,58.0,"China",10040433,7786368,2254065,6760551,11267586,"CPR",9014069
1,58.0,"United States of America",2550045,2549900,145,1816783,3027972,"USA",2422378
1,58.0,"Northern Africa",1123875,0,1123875,796191,1326986,"EGY",1061589
1,58.0,"Russian Federation",5506749,3329909,2176840,3834593,6390988,"RUS",5112791
1,58.0,"Western Africa",173336,0,173336,122456,204093,"NGA",163275
1,58.0,"South America",1672291,1347965,324326,1174207,1957012,"BRA",1565610
1,58.0,"Northern Europe",1575602,1551685,23917,1112810,1854683,"GBR",1483747
1,58.0,"Northern America",652025,649443,2582,459172,765287,"CAN",612230
1,58.0,"Oceania",359560,359560,0,252018,420031,"NZL",336025
1,58.0,"Eastern Africa",153383,0,153383,108552,180921,"ETH",144737
1,58.0,"Middle Africa",61845,0,61845,43566,72610,"AGO",58088
1,58.0,"Eastern Europe",3927925,3894826,33099,2795976,4659960,"POL",3727968
1,58.0,"Central Asia",1435683,1362487,73196,1013631,1689386,"UZB",1351509
1,58.0,"Southern Europe",305748,0,305748,215748,359581,"ITA",287665
1,58.0,"Central America",175966,0,175966,125121,208535,"MEX",166828
1,58.0,"Southern Asia",417554,0,417554,295667,492778,"IRN",394223
1,58.0,"Western Asia",213320,0,213320,151525,252542,"IRQ",202034
1,58.0,"Eastern Asia",824981,0,824981,582291,970485,"JPN",776388
1,58.0,"Southern Africa",54740,0,54740,38403,64005,"ZAF",51204
1,58.0,"South-Eastern Asia",510206,0,510206,358812,598021,"IDN",478417
1,58.0,"Caribbean",156985,0,156985,111500,185833,"CUB",148667
1,59.0,"Pakistan",1488859,1172567,316292,1049896,1749827,"PAK",1399862
1,59.0,"India",5250728,4847404,403324,3612177,6020296,"IND",4816237
1,59.0,"Western Europe",2559028,2558100,928,1805272,3008787,"NLD",2407030
1,59.0,"China",10054548,7799041,2255507,6760551,11267586,"CPR",9014069
1,59.0,"United States of America",2550362,2550220,142,1816783,3027972,"USA",2422378
1,59.0,"Northern Africa",1126650,0,1126650,796191,1326986,"EGY",1061589
1,59.0,"Russian Federation",5515554,3341346,2174208,3834593,6390988,"RUS",5112791
1,59.0,"Western Africa",172645,0,172645,122456,204093,"NGA",163275
1,59.0,"South America",1658677,1342242,316435,1174207,1957012,"BRA",1565610
1,59.0,"Northern Europe",1573983,1549987,23996,1112810,1854683,"GBR",1483747
1,59.0,"Northern America",641230,639351,1879,459172,765287,"CAN",612230
1,59.0,"Oceania",358180,358180,0,252018,420031,"NZL",336025
1,59.0,"Eastern Africa",153731,0,153731,108552,180921,"ETH",144737
1,59.0,"Middle Africa",61466,0,61466,43566,72610,"AGO",58088
1,59.0,"Eastern Europe",3987734,3953921,33813,2795976,4659960,"POL",3727968
1,59.0,"Central Asia",1435317,1361440,73877,1013631,1689386,"UZB",1351509
1,59.0,"Southern Europe",304604,0,304604,215748,359581,"ITA",287665
1,59.0,"Central America",175729,0,175729,125121,208535,"MEX",166828
1,59.0,"Southern Asia",418867,0,418867,295667,492778,"IRN",394223
1,59.0,"Western Asia",214731,0,214731,151525,252542,"IRQ",202034
1,59.0,"Eastern Asia",816986,0,816986,582291,970485,"JPN",776388
1,59.0,"Southern Africa",54334,0,54334,38403,64005,"ZAF",51204
1,59.0,"South-Eastern Asia",507212,0,507212,358812,598021,"IDN",478417
1,59.0,"Caribbean",156458,0,156458,111500,185833,"CUB",148667
1,60.0,"Pakistan",1496871,1178169,318702,1049896,1749827,"PAK",1399862
1,60.0,"India",5248481,4853276,395205,3612177,6020296,"IND",4816237
1,60.0,"Western Europe",2553865,2553187,678,1805272,3008787,"NLD",2407030
1,60.0,"China",10058206,7799890,2258316,6760551,11267586,"CPR",9014069
1,60.0,"United States of America",2584019,2583912,107,1816783,3027972,"USA",2422378
1,60.0,"Northern Africa",1124542,0,1124542,796191,1326986,"EGY",1061589
1,60.0,"Russian Federation",5499577,3325231,2174346,3834593,6390988,"RUS",5112791
1,60.0,"Western Africa",173704,0,173704,122456,204093,"NGA",163275
1,60.0,"South America",1671024,1350039,320985,1174207,1957012,"BRA",1565610
1,60.0,"Northern Europe",1583088,1558838,24250,1112810,1854683,"GBR",1483747
1,60.0,"Northern America",650772,648864,1908,459172,765287,"CAN",612230
1,60.0,"Oceania",357008,357008,0,252018,420031,"NZL",336025
1,60.0,"Eastern Africa",152858,0,152858,108552,180921,"ETH",144737
1,60.0,"Middle Africa",61646,0,61646,43566,72610,"AGO",58088
1,60.0,"Eastern Europe",3918853,3890062,28791,2795976,4659960,"POL",3727968
1,60.0,"Central Asia",1443460,1368890,74570,1013631,1689386,"UZB",1351509
1,60.0,"Southern Europe",305115,0,305115,215748,359581,"ITA",287665
1,60.0,"Central America",178028,0,178028,125121,208535,"MEX",166828
1,60.0,"Southern Asia",417411,0,417411,295667,492778,"IRN",394223
1,60.0,"Western Asia",212773,0,212773,151525,252542,"IRQ",202034
1,60.0,"Eastern Asia",826501,0,826501,582291,970485,"JPN",776388
1,60.0,"Southern Africa",54317,0,54317,38403,64005,"ZAF",51204
1,60.0,"South-Eastern Asia",508011,0,508011,358812,598021,"IDN",478417
1,60.0,"Caribbean",158493,0,158493,111500,185833,"CUB",148667
1,61.0,"Pakistan",1493730,1173265,320465,1049896,1749827,"PAK",1399862
1,61.0,"India",5207276,4863103,344173,3612177,6020296,"IND",4816237
1,61.0,"Western Europe",2566391,2565508,883,1805272,3008787,"NLD",2407030
1,61.0,"China",10049788,7790594,2259194,6760551,11267586,"CPR",9014069
1,61.0,"United States of America",2572169,2572169,0,1816783,3027972,"USA",2422378
1,61.0,"Northern Africa",1131414,0,1131414,796191,1326986,"EGY",1061589
1,61.0,"Russian Federation",5506259,3332727,2173532,3834593,6390988,"RUS",5112791
1,61.0,"Western Africa",172734,0,172734,122456,204093,"NGA",163275
1,61.0,"South America",1656303,1341417,314886,1174207,1957012,"BRA",1565610
1,61.0,"Northern Europe",1588347,1564622,23725,1112810,1854683,"GBR",1483747
1,61.0,"Northern America",631472,629574,1898,459172,765287,"CAN",612230
1,61.0,"Oceania",360762,360762,0,252018,420031,"NZL",336025
1,61.0,"Eastern Africa",154032,0,154032,108552,180921,"ETH",144737
1,61.0,"Middle Africa",61475,0,61475,43566,72610,"AGO",58088
1,61.0,"Eastern Europe",4003272,3973412,29860,2795976,4659960,"POL",3727968
1,61.0,"Central Asia",1439125,1371290,67835,1013631,1689386,"UZB",1351509
1,61.0,"Southern Europe",303289,0,303289,215748,359581,"ITA",287665
1,61.0,"Central America",176921,0,176921,125121,208535,"MEX",166828
1,61.0,"Southern Asia",418229,0,418229,295667,492778,"IRN",394223
1,61.0,"Western Asia",214299,0,214299,151525,252542,"IRQ",202034
1,61.0,"Eastern Asia",812698,0,812698,582291,970485,"JPN",776388
1,61.0,"Southern Africa",54397,0,54397,38403,64005,"ZAF",51204
1,61.0,"South-Eastern Asia",508767,0,508767,358812,598021,"IDN",478417
1,61.0,"Caribbean",157220,0,157220,111500,185833,"CUB",148667
1,62.0,"Pakistan",1498870,1178292,320578,1049896,1749827,"PAK",1399862
1,62.0,"India",5174618,4845985,328633,3612177,6020296,"IND",4816237
1,62.0,"Western Europe",2573844,2572988,856,1805272,3008787,"NLD",2407030
1,62.0,"China",10035786,7773363,2262423,6760551,11267586,"CPR",9014069
1,62.0,"United States of America",2546206,2546006,200,1816783,3027972,"USA",2422378
1,62.0,"Northern Africa",1130005,0,1130005,796191,1326986,"EGY",1061589
1,62.0,"Russian Federation",5513958,3337362,2176596,3834593,6390988,"RUS",5112791
1,62.0,"Western Africa",173787,0,173787,122456,204093,"NGA",163275
1,62.0,"South America",1667766,1347634,320132,1174207,1957012,"BRA",1565610
1,62.0,"Northern Europe",1591080,1568377,22703,1112810,1854683,"GBR",1483747
1,62.0,"Northern America",660064,657580,2484,459172,765287,"CAN",612230
1,62.0,"Oceania",353762,353762,0,252018,420031,"NZL",336025
1,62.0,"Eastern Africa",154117,0,154117,108552,180921,"ETH",144737
1,62.0,"Middle Africa",61672,0,61672,43566,72610,"AGO",58088
1,62.0,"Eastern Europe",3980567,3951062,29505,2795976,4659960,"POL",3727968
1,62.0,"Central Asia",1435176,1367958,67218,1013631,1689386,"UZB",1351509
1,62.0,"Southern Europe",308187,0,308187,215748,359581,"ITA",287665
1,62.0,"Central America",175727,0,175727,125121,208535,"MEX",166828
1,62.0,"Southern Asia",421873,0,421873,295667,492778,"IRN",394223
1,62.0,"Western Asia",216128,0,216128,151525,252542,"IRQ",202034
1,62.0,"Eastern Asia",828172,0,828172,582291,970485,"JPN",776388
1,62.0,"Southern Africa",54131,0,54131,38403,64005,"ZAF",51204
1,62.0,"South-Eastern Asia",505346,0,505346,358812,598021,"IDN",478417
1,62.0,"Caribbean",156857,0,156857,111500,185833,"CUB",148667
1,63.0,"Pakistan",1502717,1179809,322908,1049896,1749827,"PAK",1399862
1,63.0,"India",5182836,4853730,329106,3612177,6020296,"IND",4816237
1,63.0,"Western Europe",2560384,2559673,711,1805272,3008787,"NLD",2407030
1,63.0,"China",10015440,7749390,2266050,6760551,11267586,"CPR",9014069
1,63.0,"United States of America",2592412,2592266,146,1816783,3027972,"USA",2422378
1,63.0,"Northern Africa",1131663,0,1131663,796191,1326986,"EGY",1061589
1,63.0,"Russian Federation",5515478,3338030,2177448,3834593,6390988,"RUS",5112791
1,63.0,"Western Africa",174036,0,174036,122456,204093,"NGA",163275
1,63.0,"South America",1664779,1341662,323117,1174207,1957012,"BRA",1565610
1,63.0,"Northern Europe",1581661,1564955,16706,1112810,1854683,"GBR",1483747
1,63.0,"Northern America",646222,644432,1790,459172,765287,"CAN",612230
1,63.0,"Oceania",355659,355659,0,252018,420031,"NZL",336025
1,63.0,"Eastern Africa",154008,0,154008,108552,180921,"ETH",144737
1,63.0,"Middle Africa",61748,0,61748,43566,72610,"AGO",58088
1,63.0,"Eastern Europe",3988291,3962214,26077,2795976,4659960,"POL",3727968
1,63.0,"Central Asia",1450513,1381818,68695,1013631,1689386,"UZB",1351509
1,63.0,"Southern Europe",305506,0,305506,215748,359581,"ITA",287665
1,63.0,"Central America",178447,0,178447,125121,208535,"MEX",166828
1,63.0,"Southern Asia",420587,0,420587,295667,492778,"IRN",394223
1,63.0,"Western Asia",215314,0,215314,151525,252542,"IRQ",202034
1,63.0,"Eastern Asia",824028,0,824028,582291,970485,"JPN",776388
1,63.0,"Southern Africa",54261,0,54261,38403,64005,"ZAF",51204
1,63.0,"South-Eastern Asia",506049,0,506049,358812,598021,"IDN",478417
1,63.0,"Caribbean",158835,0,158835,111500,185833,"CUB",148667
1,64.0,"Pakistan",1503204,1179524,323680,1049896,1749827,"PAK",1399862
1,64.0,"India",5183547,4855514,328033,3612177,6020296,"IND",4816237
1,64.0,"Western Europe",2566160,2565441,719,1805272,3008787,"NLD",2407030
1,64.0,"China",10047215,7779141,2268074,6760551,11267586,"CPR",9014069
1,64.0,"United States of America",2558015,2557907,108,1816783,3027972,"USA",2422378
1,64.0,"Northern Africa",1128814,0,1128814,796191,1326986,"EGY",1061589
1,64.0,"Russian Federation",5512097,3335447,2176650,3834593,6390988,"RUS",5112791
1,64.0,"Western Africa",174220,0,174220,122456,204093,"NGA",163275
1,64.0,"South America",1671266,1343982,327284,1174207,1957012,"BRA",1565610
1,64.0,"Northern Europe",1574033,1557946,16087,1112810,1854683,"GBR",1483747
1,64.0,"Northern America",664938,662859,2079,459172,765287,"CAN",612230
1,64.0,"Oceania",356897,356797,100,252018,420031,"NZL",336025
1,64.0,"Eastern Africa",154305,0,154305,108552,180921,"ETH",144737
1,64.0,"Middle Africa",62024,0,62024,43566,72610,"AGO",58088
1,64.0,"Eastern Europe",3965384,3939460,25924,2795976,4659960,"POL",3727968
1,64.0,"Central Asia",1441377,1373229,68148,1013631,1689386,"UZB",1351509
1,64.0,"Southern Europe",308666,0,308666,215748,359581,"ITA",287665
1,64.0,"Central America",176561,0,176561,125121,208535,"MEX",166828
1,64.0,"Southern Asia",421999,0,421999,295667,492778,"IRN",394223
1,64.0,"Western Asia",216059,0,216059,151525,252542,"IRQ",202034
1,64.0,"Eastern Asia",833602,0,833602,582291,970485,"JPN",776388
1,64.0,"Southern Africa",54515,0,54515,38403,64005,"ZAF",51204
1,64.0,"South-Eastern Asia",509299,0,509299,358812,598021,"IDN",478417
1,64.0,"Caribbean",157666,0,157666,111500,185833,"CUB",148667
1,65.0,"Pakistan",1503100,1178411,324689,1049896,1749827,"PAK",1399862
1,65.0,"India",5180589,4856011,324578,3612177,6020296,"IND",4816237
1,65.0,"Western Europe",2552273,2551466,807,1805272,3008787,"NLD",2407030
1,65.0,"China",10053393,7790841,2262552,6760551,11267586,"CPR",9014069
1,65.0,"United States of America",2596499,2596244,255,1816783,3027972,"USA",2422378
1,65.0,"Northern Africa",1129183,0,1129183,796191,1326986,"EGY",1061589
1,65.0,"Russian Federation",5501052,3330699,2170353,3834593,6390988,"RUS",5112791
1,65.0,"Western Africa",173706,0,173706,122456,204093,"NGA",163275
1,65.0,"South America",1673794,1344045,329749,1174207,1957012,"BRA",1565610
1,65.0,"Northern Europe",1578139,1561874,16265,1112810,1854683,"GBR",1483747
1,65.0,"Northern America",640998,639533,1465,459172,765287,"CAN",612230
1,65.0,"Oceania",357372,357372,0,252018,420031,"NZL",336025
1,65.0,"Eastern Africa",153604,0,153604,108552,180921,"ETH",144737
1,65.0,"Middle Africa",61718,0,61718,43566,72610,"AGO",58088
1,65.0,"Eastern Europe",3972414,3946460,25954,2795976,4659960,"POL",3727968
1,65.0,"Central Asia",1452708,1383422,69286,1013631,1689386,"UZB",1351509
1,65.0,"Southern Europe",304058,0,304058,215748,359581,"ITA",287665
1,65.0,"Central America",178491,0,178491,125121,208535,"MEX",166828
1,65.0,"Southern Asia",418545,0,418545,295667,492778,"IRN",394223
1,65.0,"Western Asia",214272,0,214272,151525,252542,"IRQ",202034
1,65.0,"Eastern Asia",821230,0,821230,582291,970485,"JPN",776388
1,65.0,"Southern Africa",54335,0,54335,38403,64005,"ZAF",51204
1,65.0,"South-Eastern Asia",507562,0,507562,358812,598021,"IDN",478417
1,65.0,"Caribbean",158809,0,158809,111500,185833,"CUB",148667
1,66.0,"Pakistan",1501898,1176491,325407,1049896,1749827,"PAK",1399862
1,66.0,"India",5142714,4835755,306959,3612177,6020296,"IND",4816237
1,66.0,"Western Europe",2573248,2572268,980,1805272,3008787,"NLD",2407030
1,66.0,"China",10050179,7789296,2260883,6760551,11267586,"CPR",9014069
1,66.0,"United States of America",2542880,2542696,184,1816783,3027972,"USA",2422378
1,66.0,"Northern Africa",1129589,0,1129589,796191,1326986,"EGY",1061589
1,66.0,"Russian Federation",5498296,3325097,2173199,3834593,6390988,"RUS",5112791
1,66.0,"Western Africa",174150,0,174150,122456,204093,"NGA",163275
1,66.0,"South America",1676126,1342670,333456,1174207,1957012,"BRA",1565610
1,66.0,"Northern Europe",1579613,1563764,15849,1112810,1854683,"GBR",1483747
1,66.0,"Northern America",667764,665846,1918,459172,765287,"CAN",612230
1,66.0,"Oceania",353160,353160,0,252018,420031,"NZL",336025
1,66.0,"Eastern Africa",154525,0,154525,108552,180921,"ETH",144737
1,66.0,"Middle Africa",61912,0,61912,43566,72610,"AGO",58088
1,66.0,"Eastern Europe",3974627,3948709,25918,2795976,4659960,"POL",3727968
1,66.0,"Central Asia",1449690,1383772,65918,1013631,1689386,"UZB",1351509
1,66.0,"Southern Europe",309505,0,309505,215748,359581,"ITA",287665
1,66.0,"Central America",175700,0,175700,125121,208535,"MEX",166828
1,66.0,"Southern Asia",423515,0,423515,295667,492778,"IRN",394223
1,66.0,"Western Asia",216816,0,216816,151525,252542,"IRQ",202034
1,66.0,"Eastern Asia",832433,0,832433,582291,970485,"JPN",776388
1,66.0,"Southern Africa",54169,0,54169,38403,64005,"ZAF",51204
1,66.0,"South-Eastern Asia",504648,0,504648,358812,598021,"IDN",478417
1,66.0,"Caribbean",156888,0,156888,111500,185833,"CUB",148667
1,67.0,"Pakistan",1500549,1175246,325303,1049896,1749827,"PAK",1399862
1,67.0,"India",5145297,4837770,307527,3612177,6020296,"IND",4816237
1,67.0,"Western Europe",2554259,2553168,1091,1805272,3008787,"NLD",2407030
1,67.0,"China",10031969,7776485,2255484,6760551,11267586,"CPR",9014069
1,67.0,"United States of America",2597238,2596747,491,1816783,3027972,"USA",2422378
1,67.0,"Northern Africa",1129207,0,1129207,796191,1326986,"EGY",1061589
1,67.0,"Russian Federation",5510669,3339322,2171347,3834593,6390988,"RUS",5112791
1,67.0,"Western Africa",173814,0,173814,122456,204093,"NGA",163275
1,67.0,"South America",1684257,1348488,335769,1174207,1957012,"BRA",1565610
1,67.0,"Northern Europe",1579864,1567987,11877,1112810,1854683,"GBR",1483747
1,67.0,"Northern America",642560,641220,1340,459172,765287,"CAN",612230
1,67.0,"Oceania",363383,362933,450,252018,420031,"NZL",336025
1,67.0,"Eastern Africa",154064,0,154064,108552,180921,"ETH",144737
1,67.0,"Middle Africa",62055,0,62055,43566,72610,"AGO",58088
1,67.0,"Eastern Europe",3973397,3949891,23506,2795976,4659960,"POL",3727968
1,67.0,"Central Asia",1438428,1383616,54812,1013631,1689386,"UZB",1351509
1,67.0,"Southern Europe",304533,0,304533,215748,359581,"ITA",287665
1,67.0,"Central America",178556,0,178556,125121,208535,"MEX",166828
1,67.0,"Southern Asia",418777,0,418777,295667,492778,"IRN",394223
1,67.0,"Western Asia",214521,0,214521,151525,252542,"IRQ",202034
1,67.0,"Eastern Asia",823861,0,823861,582291,970485,"JPN",776388
1,67.0,"Southern Africa",55124,0,55124,38403,64005,"ZAF",51204
1,67.0,"South-Eastern Asia",514605,0,514605,358812,598021,"IDN",478417
1,67.0,"Caribbean",158959,0,158959,111500,185833,"CUB",148667
1,68.0,"Pakistan",1506006,1179181,326825,1049896,1749827,"PAK",1399862
1,68.0,"India",5143061,4835579,307482,3612177,6020296,"IND",4816237
1,68.0,"Western Europe",2586002,2584776,1226,1805272,3008787,"NLD",2407030
1,68.0,"China",10009843,7755593,2254250,6760551,11267586,"CPR",9014069
1,68.0,"United States of America",2571268,2570923,345,1816783,3027972,"USA",2422378
1,68.0,"Northern Africa",1134504,0,1134504,796191,1326986,"EGY",1061589
1,68.0,"Russian Federation",5500955,3327015,2173940,3834593,6390988,"RUS",5112791
1,68.0,"Western Africa",175038,0,175038,122456,204093,"NGA",163275
1,68.0,"South America",1682425,1342752,339673,1174207,1957012,"BRA",1565610
1,68.0,"Northern Europe",1578880,1567039,11841,1112810,1854683,"GBR",1483747
1,68.0,"Northern America",663272,661608,1664,459172,765287,"CAN",612230
1,68.0,"Oceania",352532,352358,174,252018,420031,"NZL",336025
1,68.0,"Eastern Africa",154877,0,154877,108552,180921,"ETH",144737
1,68.0,"Middle Africa",62186,0,62186,43566,72610,"AGO",58088
1,68.0,"Eastern Europe",3969914,3946357,23557,2795976,4659960,"POL",3727968
1,68.0,"Central Asia",1438427,1383559,54868,1013631,1689386,"UZB",1351509
1,68.0,"Southern Europe",309877,0,309877,215748,359581,"ITA",287665
1,68.0,"Central America",177390,0,177390,125121,208535,"MEX",166828
1,68.0,"Southern Asia",422843,0,422843,295667,492778,"IRN",394223
1,68.0,"Western Asia",216131,0,216131,151525,252542,"IRQ",202034
1,68.0,"Eastern Asia",832650,0,832650,582291,970485,"JPN",776388
1,68.0,"Southern Africa",54083,0,54083,38403,64005,"ZAF",51204
1,68.0,"South-Eastern Asia",503335,0,503335,358812,598021,"IDN",478417
1,68.0,"Caribbean",158298,0,158298,111500,185833,"CUB",148667
1,69.0,"Pakistan",1500942,1178600,322342,1049896,1749827,"PAK",1399862
1,69.0,"India",5138440,4830068,308372,3612177,6020296,"IND",4816237
1,69.0,"Western Europe",2559579,2558373,1206,1805272,3008787,"NLD",2407030
1,69.0,"China",10024671,7781210,2243461,6760551,11267586,"CPR",9014069
1,69.0,"United States of America",2581723,2581227,496,1816783,3027972,"USA",2422378
1,69.0,"Northern Africa",1131604,0,1131604,796191,1326986,"EGY",1061589
1,69.0,"Russian Federation",5501471,3333618,2167853,3834593,6390988,"RUS",5112791
1,69.0,"Western Africa",173277,0,173277,122456,204093,"NGA",163275
1,69.0,"South America",1684164,1344369,339795,1174207,1957012,"BRA",1565610
1,69.0,"Northern Europe",1586539,1573883,12656,1112810,1854683,"GBR",1483747
1,69.0,"Northern America",639187,638064,1123,459172,765287,"CAN",612230
1,69.0,"Oceania",359817,359483,334,252018,420031,"NZL",336025
1,69.0,"Eastern Africa",154502,0,154502,108552,180921,"ETH",144737
1,69.0,"Middle Africa",61716,0,61716,43566,72610,"AGO",58088
1,69.0,"Eastern Europe",4011282,3986897,24385,2795976,4659960,"POL",3727968
1,69.0,"Central Asia",1454116,1397890,56226,1013631,1689386,"UZB",1351509
1,69.0,"Southern Europe",304729,0,304729,215748,359581,"ITA",287665
1,69.0,"Central America",177461,0,177461,125121,208535,"MEX",166828
1,69.0,"Southern Asia",420842,0,420842,295667,492778,"IRN",394223
1,69.0,"Western Asia",215604,0,215604,151525,252542,"IRQ",202034
1,69.0,"Eastern Asia",818961,0,818961,582291,970485,"JPN",776388
1,69.0,"Southern Africa",54618,0,54618,38403,64005,"ZAF",51204
1,69.0,"South-Eastern Asia",510468,0,510468,358812,598021,"IDN",478417
1,69.0,"Caribbean",158047,0,158047,111500,185833,"CUB",148667
1,70.0,"Pakistan",1496490,1173185,323305,1049896,1749827,"PAK",1399862
1,70.0,"India",5160017,4849909,310108,3612177,6020296,"IND",4816237
1,70.0,"Western Europe",2584679,2583363,1316,1805272,3008787,"NLD",2407030
1,70.0,"China",10025004,7788787,2236217,6760551,11267586,"CPR",9014069
1,70.0,"United States of America",2557766,2557417,349,1816783,3027972,"USA",2422378
1,70.0,"Northern Africa",1131188,0,1131188,796191,1326986,"EGY",1061589
1,70.0,"Russian Federation",5507473,3336702,2170771,3834593,6390988,"RUS",5112791
1,70.0,"Western Africa",174955,0,174955,122456,204093,"NGA",163275
1,70.0,"South America",1696431,1352513,343918,1174207,1957012,"BRA",1565610
1,70.0,"Northern Europe",1580991,1568905,12086,1112810,1854683,"GBR",1483747
1,70.0,"Northern America",670379,668918,1461,459172,765287,"CAN",612230
1,70.0,"Oceania",354144,353911,233,252018,420031,"NZL",336025
1,70.0,"Eastern Africa",154405,0,154405,108552,180921,"ETH",144737
1,70.0,"Middle Africa",62249,0,62249,43566,72610,"AGO",58088
1,70.0,"Eastern Europe",3943449,3924636,18813,2795976,4659960,"POL",3727968
1,70.0,"Central Asia",1446392,1392741,53651,1013631,1689386,"UZB",1351509
1,70.0,"Southern Europe",310410,0,310410,215748,359581,"ITA",287665
1,70.0,"Central America",176610,0,176610,125121,208535,"MEX",166828
1,70.0,"Southern Asia",422332,0,422332,295667,492778,"IRN",394223
1,70.0,"Western Asia",215771,0,215771,151525,252542,"IRQ",202034
1,70.0,"Eastern Asia",835788,0,835788,582291,970485,"JPN",776388
1,70.0,"Southern Africa",54355,0,54355,38403,64005,"ZAF",51204
1,70.0,"South-Eastern Asia",505568,0,505568,358812,598021,"IDN",478417
1,70.0,"Caribbean",157791,0,157791,111500,185833,"CUB",148667
1,71.0,"Pakistan",1499626,1176345,323281,1049896,1749827,"PAK",1399862
1,71.0,"India",5142562,4831579,310983,3612177,6020296,"IND",4816237
1,71.0,"Western Europe",2569519,2568069,1450,1805272,3008787,"NLD",2407030
1,71.0,"China",10004781,7781673,2223108,6760551,11267586,"CPR",9014069
1,71.0,"United States of America",2568857,2568094,763,1816783,3027972,"USA",2422378
1,71.0,"Northern Africa",1132642,0,1132642,796191,1326986,"EGY",1061589
1,71.0,"Russian Federation",5481095,3318511,2162584,3834593,6390988,"RUS",5112791
1,71.0,"Western Africa",173257,0,173257,122456,204093,"NGA",163275
1,71.0,"South America",1682537,1346905,335632,1174207,1957012,"BRA",1565610
1,71.0,"Northern Europe",1585850,1573045,12805,1112810,1854683,"GBR",1483747
1,71.0,"Northern America",643306,642341,965,459172,765287,"CAN",612230
1,71.0,"Oceania",364201,363635,566,252018,420031,"NZL",336025
1,71.0,"Eastern Africa",154757,0,154757,108552,180921,"ETH",144737
1,71.0,"Middle Africa",61800,0,61800,43566,72610,"AGO",58088
1,71.0,"Eastern Europe",4008471,3988261,20210,2795976,4659960,"POL",3727968
1,71.0,"Central Asia",1440705,1393131,47574,1013631,1689386,"UZB",1351509
1,71.0,"Southern Europe",305681,0,305681,215748,359581,"ITA",287665
1,71.0,"Central America",176851,0,176851,125121,208535,"MEX",166828
1,71.0,"Southern Asia",420791,0,420791,295667,492778,"IRN",394223
1,71.0,"Western Asia",215985,0,215985,151525,252542,"IRQ",202034
1,71.0,"Eastern Asia",821129,0,821129,582291,970485,"JPN",776388
1,71.0,"Southern Africa",55170,0,55170,38403,64005,"ZAF",51204
1,71.0,"South-Eastern Asia",516599,0,516599,358812,598021,"IDN",478417
1,71.0,"Caribbean",157566,0,157566,111500,185833,"CUB",148667
1,72.0,"Pakistan",1501435,1175793,325642,1049896,1749827,"PAK",1399862
1,72.0,"India",5155103,4841201,313902,3612177,6020296,"IND",4816237
1,72.0,"Western Europe",2571654,2570353,1301,1805272,3008787,"NLD",2407030
1,72.0,"China",9979713,7765159,2214554,6760551,11267586,"CPR",9014069
1,72.0,"United States of America",2601681,2601174,507,1816783,3027972,"USA",2422378
1,72.0,"Northern Africa",1132956,0,1132956,796191,1326986,"EGY",1061589
1,72.0,"Russian Federation",5487429,3318420,2169009,3834593,6390988,"RUS",5112791
1,72.0,"Western Africa",175035,0,175035,122456,204093,"NGA",163275
1,72.0,"South America",1692184,1352339,339845,1174207,1957012,"BRA",1565610
1,72.0,"Northern Europe",1587132,1574101,13031,1112810,1854683,"GBR",1483747
1,72.0,"Northern America",653514,652871,643,459172,765287,"CAN",612230
1,72.0,"Oceania",356544,356171,373,252018,420031,"NZL",336025
1,72.0,"Eastern Africa",154068,0,154068,108552,180921,"ETH",144737
1,72.0,"Middle Africa",62189,0,62189,43566,72610,"AGO",58088
1,72.0,"Eastern Europe",3958814,3941071,17743,2795976,4659960,"POL",3727968
1,72.0,"Central Asia",1451582,1402768,48814,1013631,1689386,"UZB",1351509
1,72.0,"Southern Europe",307524,0,307524,215748,359581,"ITA",287665
1,72.0,"Central America",179151,0,179151,125121,208535,"MEX",166828
1,72.0,"Southern Asia",420079,0,420079,295667,492778,"IRN",394223
1,72.0,"Western Asia",214802,0,214802,151525,252542,"IRQ",202034
1,72.0,"Eastern Asia",830416,0,830416,582291,970485,"JPN",776388
1,72.0,"Southern Africa",54474,0,54474,38403,64005,"ZAF",51204
1,72.0,"South-Eastern Asia",507833,0,507833,358812,598021,"IDN",478417
1,72.0,"Caribbean",159625,0,159625,111500,185833,"CUB",148667
1,73.0,"Pakistan",1500732,1173481,327251,1049896,1749827,"PAK",1399862
1,73.0,"India",5158358,4842143,316215,3612177,6020296,"IND",4816237
1,73.0,"Western Europe",2570493,2568955,1538,1805272,3008787,"NLD",2407030
1,73.0,"China",9988427,7785645,2202782,6760551,11267586,"CPR",9014069
1,73.0,"United States of America",2578818,2578498,320,1816783,3027972,"USA",2422378
1,73.0,"Northern Africa",1135367,0,1135367,796191,1326986,"EGY",1061589
1,73.0,"Russian Federation",5499539,3332015,2167524,3834593,6390988,"RUS",5112791
1,73.0,"Western Africa",173183,0,173183,122456,204093,"NGA",163275
1,73.0,"South America",1684363,1350795,333568,1174207,1957012,"BRA",1565610
1,73.0,"Northern Europe",1586131,1572717,13414,1112810,1854683,"GBR",1483747
1,73.0,"Northern America",639069,638552,517,459172,765287,"CAN",612230
1,73.0,"Oceania",361038,360699,339,252018,420031,"NZL",336025
1,73.0,"Eastern Africa",154822,0,154822,108552,180921,"ETH",144737
1,73.0,"Middle Africa",61768,0,61768,43566,72610,"AGO",58088
1,73.0,"Eastern Europe",4031081,4012136,18945,2795976,4659960,"POL",3727968
1,73.0,"Central Asia",1449025,1404923,44102,1013631,1689386,"UZB",1351509
1,73.0,"Southern Europe",304893,0,304893,215748,359581,"ITA",287665
1,73.0,"Central America",177431,0,177431,125121,208535,"MEX",166828
1,73.0,"Southern Asia",421244,0,421244,295667,492778,"IRN",394223
1,73.0,"Western Asia",216271,0,216271,151525,252542,"IRQ",202034
1,73.0,"Eastern Asia",818608,0,818608,582291,970485,"JPN",776388
1,73.0,"Southern Africa",54629,0,54629,38403,64005,"ZAF",51204
1,73.0,"South-Eastern Asia",512243,0,512243,358812,598021,"IDN",478417
1,73.0,"Caribbean",158037,0,158037,111500,185833,"CUB",148667
1,74.0,"Pakistan",1506126,1176308,329818,1049896,1749827,"PAK",1399862
1,74.0,"India",5155723,4837036,318687,3612177,6020296,"IND",4816237
1,74.0,"Western Europe",2567383,2566189,1194,1805272,3008787,"NLD",2407030
1,74.0,"China",9979006,7787849,2191157,6760551,11267586,"CPR",9014069
1,74.0,"United States of America",2588651,2588433,218,1816783,3027972,"USA",2422378
1,74.0,"Northern Africa",1132970,0,1132970,796191,1326986,"EGY",1061589
1,74.0,"Russian Federation",5493464,3321014,2172450,3834593,6390988,"RUS",5112791
1,74.0,"Western Africa",175671,0,175671,122456,204093,"NGA",163275
1,74.0,"South America",1692642,1354545,338097,1174207,1957012,"BRA",1565610
1,74.0,"Northern Europe",1584124,1571109,13015,1112810,1854683,"GBR",1483747
1,74.0,"Northern America",669727,668834,893,459172,765287,"CAN",612230
1,74.0,"Oceania",348404,348246,158,252018,420031,"NZL",336025
1,74.0,"Eastern Africa",154873,0,154873,108552,180921,"ETH",144737
1,74.0,"Middle Africa",62360,0,62360,43566,72610,"AGO",58088
1,74.0,"Eastern Europe",3966607,3954432,12175,2795976,4659960,"POL",3727968
1,74.0,"Central Asia",1446105,1402641,43464,1013631,1689386,"UZB",1351509
1,74.0,"Southern Europe",310425,0,310425,215748,359581,"ITA",287665
1,74.0,"Central America",178597,0,178597,125121,208535,"MEX",166828
1,74.0,"Southern Asia",423463,0,423463,295667,492778,"IRN",394223
1,74.0,"Western Asia",216575,0,216575,151525,252542,"IRQ",202034
1,74.0,"Eastern Asia",837080,0,837080,582291,970485,"JPN",776388
1,74.0,"Southern Africa",53704,0,53704,38403,64005,"ZAF",51204
1,74.0,"South-Eastern Asia",497445,0,497445,358812,598021,"IDN",478417
1,74.0,"Caribbean",159254,0,159254,111500,185833,"CUB",148667
1,75.0,"Pakistan",1500701,1173531,327170,1049896,1749827,"PAK",1399862
1,75.0,"India",5149851,4838178,311673,3612177,6020296,"IND",4816237
1,75.0,"Western Europe",2589367,2587368,1999,1805272,3008787,"NLD",2407030
1,75.0,"China",9958216,7776788,2181428,6760551,11267586,"CPR",9014069
1,75.0,"United States of America",2566180,2565593,587,1816783,3027972,"USA",2422378
1,75.0,"Northern Africa",1138040,0,1138040,796191,1326986,"EGY",1061589
1,75.0,"Russian Federation",5442879,3323893,2118986,3834593,6390988,"RUS",5112791
1,75.0,"Western Africa",172887,0,172887,122456,204093,"NGA",163275
1,75.0,"South America",1680328,1353969,326359,1174207,1957012,"BRA",1565610
1,75.0,"Northern Europe",1589233,1575423,13810,1112810,1854683,"GBR",1483747
1,75.0,"Northern America",638518,637920,598,459172,765287,"CAN",612230
1,75.0,"Oceania",386293,384843,1450,252018,420031,"NZL",336025
1,75.0,"Eastern Africa",155086,0,155086,108552,180921,"ETH",144737
1,75.0,"Middle Africa",61757,0,61757,43566,72610,"AGO",58088
1,75.0,"Eastern Europe",4025255,4011905,13350,2795976,4659960,"POL",3727968
1,75.0,"Central Asia",1443666,1399346,44320,1013631,1689386,"UZB",1351509
1,75.0,"Southern Europe",305263,0,305263,215748,359581,"ITA",287665
1,75.0,"Central America",176645,0,176645,125121,208535,"MEX",166828
1,75.0,"Southern Asia",420755,0,420755,295667,492778,"IRN",394223
1,75.0,"Western Asia",216072,0,216072,151525,252542,"IRQ",202034
1,75.0,"Eastern Asia",821440,0,821440,582291,970485,"JPN",776388
1,75.0,"Southern Africa",57585,0,57585,38403,64005,"ZAF",51204
1,75.0,"South-Eastern Asia",545204,0,545204,358812,598021,"IDN",478417
1,75.0,"Caribbean",157267,0,157267,111500,185833,"CUB",148667
1,76.0,"Pakistan",1504941,1172936,332005,1049896,1749827,"PAK",1399862
1,76.0,"India",5167085,4850132,316953,3612177,6020296,"IND",4816237
1,76.0,"Western Europe",2586528,2585044,1484,1805272,3008787,"NLD",2407030
1,76.0,"China",9927289,7781177,2146112,6760551,11267586,"CPR",9014069
1,76.0,"United States of America",2588078,2587618,460,1816783,3027972,"USA",2422378
1,76.0,"Northern Africa",1138992,0,1138992,796191,1326986,"EGY",1061589
1,76.0,"Russian Federation",5495041,3351086,2143955,3834593,6390988,"RUS",5112791
1,76.0,"Western Africa",176507,0,176507,122456,204093,"NGA",163275
1,76.0,"South America",1689010,1355488,333522,1174207,1957012,"BRA",1565610
1,76.0,"Northern Europe",1590877,1576884,13993,1112810,1854683,"GBR",1483747
1,76.0,"Northern America",676651,675616,1035,459172,765287,"CAN",612230
1,76.0,"Oceania",349209,348296,913,252018,420031,"NZL",336025
1,76.0,"Eastern Africa",156096,0,156096,108552,180921,"ETH",144737
1,76.0,"Middle Africa",62669,0,62669,43566,72610,"AGO",58088
1,76.0,"Eastern Europe",3995796,3984104,11692,2795976,4659960,"POL",3727968
1,76.0,"Central Asia",1447321,1402030,45291,1013631,1689386,"UZB",1351509
1,76.0,"Southern Europe",312781,0,312781,215748,359581,"ITA",287665
1,76.0,"Central America",178602,0,178602,125121,208535,"MEX",166828
1,76.0,"Southern Asia",426724,0,426724,295667,492778,"IRN",394223
1,76.0,"Western Asia",218410,0,218410,151525,252542,"IRQ",202034
1,76.0,"Eastern Asia",841812,0,841812,582291,970485,"JPN",776388
1,76.0,"Southern Africa",53973,0,53973,38403,64005,"ZAF",51204
1,76.0,"South-Eastern Asia",499310,0,499310,358812,598021,"IDN",478417
1,76.0,"Caribbean",159339,0,159339,111500,185833,"CUB",148667
1,77.0,"Pakistan",1508626,1177739,330887,1049896,1749827,"PAK",1399862
1,77.0,"India",5195646,4874467,321179,3612177,6020296,"IND",4816237
1,77.0,"Western Europe",2581313,2579447,1866,1805272,3008787,"NLD",2407030
1,77.0,"China",9843294,7763365,2079929,6760551,11267586,"CPR",9014069
1,77.0,"United States of America",2610244,2609367,877,1816783,3027972,"USA",2422378
1,77.0,"Northern Africa",1138159,0,1138159,796191,1326986,"EGY",1061589
1,77.0,"Russian Federation",5502244,3362061,2140183,3834593,6390988,"RUS",5112791
1,77.0,"Western Africa",174052,0,174052,122456,204093,"NGA",163275
1,77.0,"South America",1682839,1352624,330215,1174207,1957012,"BRA",1565610
1,77.0,"Northern Europe",1597530,1582399,15131,1112810,1854683,"GBR",1483747
1,77.0,"Northern America",635700,635117,583,459172,765287,"CAN",612230
1,77.0,"Oceania",371667,370344,1323,252018,420031,"NZL",336025
1,77.0,"Eastern Africa",154198,0,154198,108552,180921,"ETH",144737
1,77.0,"Middle Africa",61927,0,61927,43566,72610,"AGO",58088
1,77.0,"Eastern Europe",3993211,3980760,12451,2795976,4659960,"POL",3727968
1,77.0,"Central Asia",1454757,1407419,47338,1013631,1689386,"UZB",1351509
1,77.0,"Southern Europe",304651,0,304651,215748,359581,"ITA",287665
1,77.0,"Central America",179549,0,179549,125121,208535,"MEX",166828
1,77.0,"Southern Asia",418936,0,418936,295667,492778,"IRN",394223
1,77.0,"Western Asia",214877,0,214877,151525,252542,"IRQ",202034
1,77.0,"Eastern Asia",822808,0,822808,582291,970485,"JPN",776388
1,77.0,"Southern Africa",55892,0,55892,38403,64005,"ZAF",51204
1,77.0,"South-Eastern Asia",526871,0,526871,358812,598021,"IDN",478417
1,77.0,"Caribbean",159793,0,159793,111500,185833,"CUB",148667
1,78.0,"Pakistan",1505076,1174184,330892,1049896,1749827,"PAK",1399862
1,78.0,"India",5205539,4881682,323857,3612177,6020296,"IND",4816237
1,78.0,"Western Europe",2574850,2573319,1531,1805272,3008787,"NLD",2407030
1,78.0,"China",9815583,7755864,2059719,6760551,11267586,"CPR",9014069
1,78.0,"United States of America",2571437,2570781,656,1816783,3027972,"USA",2422378
1,78.0,"Northern Africa",1135525,0,1135525,796191,1326986,"EGY",1061589
1,78.0,"Russian Federation",5528506,3382993,2145513,3834593,6390988,"RUS",5112791
1,78.0,"Western Africa",174944,0,174944,122456,204093,"NGA",163275
1,78.0,"South America",1687571,1355119,332452,1174207,1957012,"BRA",1565610
1,78.0,"Northern Europe",1591484,1576825,14659,1112810,1854683,"GBR",1483747
1,78.0,"Northern America",668750,667503,1247,459172,765287,"CAN",612230
1,78.0,"Oceania",345770,344950,820,252018,420031,"NZL",336025
1,78.0,"Eastern Africa",155612,0,155612,108552,180921,"ETH",144737
1,78.0,"Middle Africa",62239,0,62239,43566,72610,"AGO",58088
1,78.0,"Eastern Europe",4004746,3992318,12428,2795976,4659960,"POL",3727968
1,78.0,"Central Asia",1456700,1409720,46980,1013631,1689386,"UZB",1351509
1,78.0,"Southern Europe",310174,0,310174,215748,359581,"ITA",287665
1,78.0,"Central America",177454,0,177454,125121,208535,"MEX",166828
1,78.0,"Southern Asia",425160,0,425160,295667,492778,"IRN",394223
1,78.0,"Western Asia",217808,0,217808,151525,252542,"IRQ",202034
1,78.0,"Eastern Asia",834443,0,834443,582291,970485,"JPN",776388
1,78.0,"Southern Africa",53458,0,53458,38403,64005,"ZAF",51204
1,78.0,"South-Eastern Asia",494899,0,494899,358812,598021,"IDN",478417
1,78.0,"Caribbean",158479,0,158479,111500,185833,"CUB",148667
1,79.0,"Pakistan",1506211,1174994,331217,1049896,1749827,"PAK",1399862
1,79.0,"India",5205012,4880666,324346,3612177,6020296,"IND",4816237
1,79.0,"Western Europe",2579569,2577695,1874,1805272,3008787,"NLD",2407030
1,79.0,"China",9829674,7772941,2056733,6760551,11267586,"CPR",9014069
1,79.0,"United States of America",2616134,2615088,1046,1816783,3027972,"USA",2422378
1,79.0,"Northern Africa",1138223,0,1138223,796191,1326986,"EGY",1061589
1,79.0,"Russian Federation",5485164,3382788,2102376,3834593,6390988,"RUS",5112791
1,79.0,"Western Africa",174828,0,174828,122456,204093,"NGA",163275
1,79.0,"South America",1686546,1355214,331332,1174207,1957012,"BRA",1565610
1,79.0,"Northern Europe",1593319,1578515,14804,1112810,1854683,"GBR",1483747
1,79.0,"Northern America",639544,638795,749,459172,765287,"CAN",612230
1,79.0,"Oceania",379312,378036,1276,252018,420031,"NZL",336025
1,79.0,"Eastern Africa",154516,0,154516,108552,180921,"ETH",144737
1,79.0,"Middle Africa",62186,0,62186,43566,72610,"AGO",58088
1,79.0,"Eastern Europe",3987277,3975512,11765,2795976,4659960,"POL",3727968
1,79.0,"Central Asia",1457028,1409026,48002,1013631,1689386,"UZB",1351509
1,79.0,"Southern Europe",305716,0,305716,215748,359581,"ITA",287665
1,79.0,"Central America",179904,0,179904,125121,208535,"MEX",166828
1,79.0,"Southern Asia",419875,0,419875,295667,492778,"IRN",394223
1,79.0,"Western Asia",215353,0,215353,151525,252542,"IRQ",202034
1,79.0,"Eastern Asia",828261,0,828261,582291,970485,"JPN",776388
1,79.0,"Southern Africa",56839,0,56839,38403,64005,"ZAF",51204
1,79.0,"South-Eastern Asia",536462,0,536462,358812,598021,"IDN",478417
1,79.0,"Caribbean",160300,0,160300,111500,185833,"CUB",148667
1,80.0,"Pakistan",1512249,1176720,335529,1049896,1749827,"PAK",1399862
1,80.0,"India",5218040,4890911,327129,3612177,6020296,"IND",4816237
1,80.0,"Western Europe",2578587,2576605,1982,1805272,3008787,"NLD",2407030
1,80.0,"China",9778873,7757237,2021636,6760551,11267586,"CPR",9014069
1,80.0,"United States of America",2580009,2579263,746,1816783,3027972,"USA",2422378
1,80.0,"Northern Africa",1137725,0,1137725,796191,1326986,"EGY",1061589
1,80.0,"Russian Federation",5515649,3395692,2119957,3834593,6390988,"RUS",5112791
1,80.0,"Western Africa",175979,0,175979,122456,204093,"NGA",163275
1,80.0,"South America",1689333,1353482,335851,1174207,1957012,"BRA",1565610
1,80.0,"Northern Europe",1591766,1577048,14718,1112810,1854683,"GBR",1483747
1,80.0,"Northern America",679888,678025,1863,459172,765287,"CAN",612230
1,80.0,"Oceania",343553,342781,772,252018,420031,"NZL",336025
1,80.0,"Eastern Africa",156241,0,156241,108552,180921,"ETH",144737
1,80.0,"Middle Africa",62638,0,62638,43566,72610,"AGO",58088
1,80.0,"Eastern Europe",4007667,3995898,11769,2795976,4659960,"POL",3727968
1,80.0,"Central Asia",1453832,1405920,47912,1013631,1689386,"UZB",1351509
1,80.0,"Southern Europe",312379,0,312379,215748,359581,"ITA",287665
1,80.0,"Central America",178218,0,178218,125121,208535,"MEX",166828
1,80.0,"Southern Asia",427176,0,427176,295667,492778,"IRN",394223
1,80.0,"Western Asia",218749,0,218749,151525,252542,"IRQ",202034
1,80.0,"Eastern Asia",840655,0,840655,582291,970485,"JPN",776388
1,80.0,"Southern Africa",53404,0,53404,38403,64005,"ZAF",51204
1,80.0,"South-Eastern Asia",492164,0,492164,358812,598021,"IDN",478417
1,80.0,"Caribbean",158998,0,158998,111500,185833,"CUB",148667
1,81.0,"Pakistan",1510158,1177199,332959,1049896,1749827,"PAK",1399862
1,81.0,"India",5214826,4894885,319941,3612177,6020296,"IND",4816237
1,81.0,"Western Europe",2585326,2582736,2590,1805272,3008787,"NLD",2407030
1,81.0,"China",9771725,7753972,2017753,6760551,11267586,"CPR",9014069
1,81.0,"United States of America",2578485,2577001,1484,1816783,3027972,"USA",2422378
1,81.0,"Northern Africa",1138356,0,1138356,796191,1326986,"EGY",1061589
1,81.0,"Russian Federation",5473642,3389527,2084115,3834593,6390988,"RUS",5112791
1,81.0,"Western Africa",174156,0,174156,122456,204093,"NGA",163275
1,81.0,"South America",1686286,1354616,331670,1174207,1957012,"BRA",1565610
1,81.0,"Northern Europe",1602268,1586471,15797,1112810,1854683,"GBR",1483747
1,81.0,"Northern America",641693,640630,1063,459172,765287,"CAN",612230
1,81.0,"Oceania",386457,384294,2163,252018,420031,"NZL",336025
1,81.0,"Eastern Africa",155363,0,155363,108552,180921,"ETH",144737
1,81.0,"Middle Africa",62063,0,62063,43566,72610,"AGO",58088
1,81.0,"Eastern Europe",4013433,4000742,12691,2795976,4659960,"POL",3727968
1,81.0,"Central Asia",1450919,1401871,49048,1013631,1689386,"UZB",1351509
1,81.0,"Southern Europe",306808,0,306808,215748,359581,"ITA",287665
1,81.0,"Central America",177754,0,177754,125121,208535,"MEX",166828
1,81.0,"Southern Asia",422396,0,422396,295667,492778,"IRN",394223
1,81.0,"Western Asia",216793,0,216793,151525,252542,"IRQ",202034
1,81.0,"Eastern Asia",826045,0,826045,582291,970485,"JPN",776388
1,81.0,"Southern Africa",57643,0,57643,38403,64005,"ZAF",51204
1,81.0,"South-Eastern Asia",546731,0,546731,358812,598021,"IDN",478417
1,81.0,"Caribbean",158264,0,158264,111500,185833,"CUB",148667
1,82.0,"Pakistan",1510203,1173764,336439,1049896,1749827,"PAK",1399862
1,82.0,"India",5226250,4903409,322841,3612177,6020296,"IND",4816237
1,82.0,"Western Europe",2595473,2592865,2608,1805272,3008787,"NLD",2407030
1,82.0,"China",9782747,7770822,2011925,6760551,11267586,"CPR",9014069
1,82.0,"United States of America",2627829,2626491,1338,1816783,3027972,"USA",2422378
1,82.0,"Northern Africa",1142072,0,1142072,796191,1326986,"EGY",1061589
1,82.0,"Russian Federation",5498386,3392199,2106187,3834593,6390988,"RUS",5112791
1,82.0,"Western Africa",176094,0,176094,122456,204093,"NGA",163275
1,82.0,"South America",1689486,1351403,338083,1174207,1957012,"BRA",1565610
1,82.0,"Northern Europe",1591643,1580862,10781,1112810,1854683,"GBR",1483747
1,82.0,"Northern America",655584,654513,1071,459172,765287,"CAN",612230
1,82.0,"Oceania",352794,351603,1191,252018,420031,"NZL",336025
1,82.0,"Eastern Africa",154857,0,154857,108552,180921,"ETH",144737
1,82.0,"Middle Africa",62581,0,62581,43566,72610,"AGO",58088
1,82.0,"Eastern Europe",3974727,3962041,12686,2795976,4659960,"POL",3727968
1,82.0,"Central Asia",1458394,1406626,51768,1013631,1689386,"UZB",1351509
1,82.0,"Southern Europe",308813,0,308813,215748,359581,"ITA",287665
1,82.0,"Central America",180844,0,180844,125121,208535,"MEX",166828
1,82.0,"Southern Asia",421688,0,421688,295667,492778,"IRN",394223
1,82.0,"Western Asia",215842,0,215842,151525,252542,"IRQ",202034
1,82.0,"Eastern Asia",835280,0,835280,582291,970485,"JPN",776388
1,82.0,"Southern Africa",54196,0,54196,38403,64005,"ZAF",51204
1,82.0,"South-Eastern Asia",503314,0,503314,358812,598021,"IDN",478417
1,82.0,"Caribbean",161110,0,161110,111500,185833,"CUB",148667
1,83.0,"Pakistan",1510672,1175257,335415,1049896,1749827,"PAK",1399862
1,83.0,"India",5219392,4898549,320843,3612177,6020296,"IND",4816237
1,83.0,"Western Europe",2585109,2582134,2975,1805272,3008787,"NLD",2407030
1,83.0,"China",9764709,7765516,1999193,6760551,11267586,"CPR",9014069
1,83.0,"United States of America",2595303,2594594,709,1816783,3027972,"USA",2422378
1,83.0,"Northern Africa",1141535,0,1141535,796191,1326986,"EGY",1061589
1,83.0,"Russian Federation",5503881,3395568,2108313,3834593,6390988,"RUS",5112791
1,83.0,"Western Africa",173756,0,173756,122456,204093,"NGA",163275
1,83.0,"South America",1687323,1352312,335011,1174207,1957012,"BRA",1565610
1,83.0,"Northern Europe",1595982,1584136,11846,1112810,1854683,"GBR",1483747
1,83.0,"Northern America",640966,640150,816,459172,765287,"CAN",612230
1,83.0,"Oceania",353501,352957,544,252018,420031,"NZL",336025
1,83.0,"Eastern Africa",155383,0,155383,108552,180921,"ETH",144737
1,83.0,"Middle Africa",61976,0,61976,43566,72610,"AGO",58088
1,83.0,"Eastern Europe",4046407,4031200,15207,2795976,4659960,"POL",3727968
1,83.0,"Central Asia",1453029,1405483,47546,1013631,1689386,"UZB",1351509
1,83.0,"Southern Europe",305319,0,305319,215748,359581,"ITA",287665
1,83.0,"Central America",178613,0,178613,125121,208535,"MEX",166828
1,83.0,"Southern Asia",422317,0,422317,295667,492778,"IRN",394223
1,83.0,"Western Asia",216860,0,216860,151525,252542,"IRQ",202034
1,83.0,"Eastern Asia",821585,0,821585,582291,970485,"JPN",776388
1,83.0,"Southern Africa",54006,0,54006,38403,64005,"ZAF",51204
1,83.0,"South-Eastern Asia",503334,0,503334,358812,598021,"IDN",478417
1,83.0,"Caribbean",159080,0,159080,111500,185833,"CUB",148667
1,84.0,"Pakistan",1488694,1174923,313771,1049896,1749827,"PAK",1399862
1,84.0,"India",5204210,4905819,298391,3612177,6020296,"IND",4816237
1,84.0,"Western Europe",2605226,2603064,2162,1805272,3008787,"NLD",2407030
1,84.0,"China",9752098,7748407,2003691,6760551,11267586,"CPR",9014069
1,84.0,"United States of America",2573868,2573475,393,1816783,3027972,"USA",2422378
1,84.0,"Northern Africa",1140310,0,1140310,796191,1326986,"EGY",1061589
1,84.0,"Russian Federation",5536615,3404419,2132196,3834593,6390988,"RUS",5112791
1,84.0,"Western Africa",177233,0,177233,122456,204093,"NGA",163275
1,84.0,"South America",1691146,1350722,340424,1174207,1957012,"BRA",1565610
1,84.0,"Northern Europe",1601450,1590589,10861,1112810,1854683,"GBR",1483747
1,84.0,"Northern America",691513,689654,1859,459172,765287,"CAN",612230
1,84.0,"Oceania",354997,354684,313,252018,420031,"NZL",336025
1,84.0,"Eastern Africa",156239,0,156239,108552,180921,"ETH",144737
1,84.0,"Middle Africa",63164,0,63164,43566,72610,"AGO",58088
1,84.0,"Eastern Europe",3962827,3953525,9302,2795976,4659960,"POL",3727968
1,84.0,"Central Asia",1453020,1405760,47260,1013631,1689386,"UZB",1351509
1,84.0,"Southern Europe",316666,0,316666,215748,359581,"ITA",287665
1,84.0,"Central America",177773,0,177773,125121,208535,"MEX",166828
1,84.0,"Southern Asia",427612,0,427612,295667,492778,"IRN",394223
1,84.0,"Western Asia",218436,0,218436,151525,252542,"IRQ",202034
1,84.0,"Eastern Asia",848292,0,848292,582291,970485,"JPN",776388
1,84.0,"Southern Africa",54672,0,54672,38403,64005,"ZAF",51204
1,84.0,"South-Eastern Asia",508389,0,508389,358812,598021,"IDN",478417
1,84.0,"Caribbean",158678,0,158678,111500,185833,"CUB",148667
1,85.0,"Pakistan",1510874,1186333,324541,1049896,1749827,"PAK",1399862
1,85.0,"India",5166360,4903996,262364,3612177,6020296,"IND",4816237
1,85.0,"Western Europe",2579173,2576169,3004,1805272,3008787,"NLD",2407030
1,85.0,"China",9744599,7755397,1989202,6760551,11267586,"CPR",9014069
1,85.0,"United States of America",2597893,2596059,1834,1816783,3027972,"USA",2422378
1,85.0,"Northern Africa",1141782,0,1141782,796191,1326986,"EGY",1061589
1,85.0,"Russian Federation",5520992,3396370,2124622,3834593,6390988,"RUS",5112791
1,85.0,"Western Africa",174151,0,174151,122456,204093,"NGA",163275
1,85.0,"South America",1691983,1352796,339187,1174207,1957012,"BRA",1565610
1,85.0,"Northern Europe",1576091,1567737,8354,1112810,1854683,"GBR",1483747
1,85.0,"Northern America",641529,640772,757,459172,765287,"CAN",612230
1,85.0,"Oceania",365986,364700,1286,252018,420031,"NZL",336025
1,85.0,"Eastern Africa",156480,0,156480,108552,180921,"ETH",144737
1,85.0,"Middle Africa",62216,0,62216,43566,72610,"AGO",58088
1,85.0,"Eastern Europe",4067983,4054978,13005,2795976,4659960,"POL",3727968
1,85.0,"Central Asia",1456153,1409323,46830,1013631,1689386,"UZB",1351509
1,85.0,"Southern Europe",305822,0,305822,215748,359581,"ITA",287665
1,85.0,"Central America",178960,0,178960,125121,208535,"MEX",166828
1,85.0,"Southern Asia",424947,0,424947,295667,492778,"IRN",394223
1,85.0,"Western Asia",218019,0,218019,151525,252542,"IRQ",202034
1,85.0,"Eastern Asia",825983,0,825983,582291,970485,"JPN",776388
1,85.0,"Southern Africa",55559,0,55559,38403,64005,"ZAF",51204
1,85.0,"South-Eastern Asia",519279,0,519279,358812,598021,"IDN",478417
1,85.0,"Caribbean",159305,0,159305,111500,185833,"CUB",148667
1,86.0,"Pakistan",1519273,1192067,327206,1049896,1749827,"PAK",1399862
1,86.0,"India",5193772,4926431,267341,3612177,6020296,"IND",4816237
1,86.0,"Western Europe",2599253,2595978,3275,1805272,3008787,"NLD",2407030
1,86.0,"China",9694666,7762144,1932522,6760551,11267586,"CPR",9014069
1,86.0,"United States of America",2613336,2612304,1032,1816783,3027972,"USA",2422378
1,86.0,"Northern Africa",1145558,0,1145558,796191,1326986,"EGY",1061589
1,86.0,"Russian Federation",5538795,3397731,2141064,3834593,6390988,"RUS",5112791
1,86.0,"Western Africa",175619,0,175619,122456,204093,"NGA",163275
1,86.0,"South America",1692074,1349050,343024,1174207,1957012,"BRA",1565610
1,86.0,"Northern Europe",1632162,1619751,12411,1112810,1854683,"GBR",1483747
1,86.0,"Northern America",659685,659301,384,459172,765287,"CAN",612230
1,86.0,"Oceania",335339,334693,646,252018,420031,"NZL",336025
1,86.0,"Eastern Africa",154921,0,154921,108552,180921,"ETH",144737
1,86.0,"Middle Africa",61787,0,61787,43566,72610,"AGO",58088
1,86.0,"Eastern Europe",4046967,4040312,6655,2795976,4659960,"POL",3727968
1,86.0,"Central Asia",1459361,1409920,49441,1013631,1689386,"UZB",1351509
1,86.0,"Southern Europe",310597,0,310597,215748,359581,"ITA",287665
1,86.0,"Central America",179929,0,179929,125121,208535,"MEX",166828
1,86.0,"Southern Asia",422635,0,422635,295667,492778,"IRN",394223
1,86.0,"Western Asia",217470,0,217470,151525,252542,"IRQ",202034
1,86.0,"Eastern Asia",829366,0,829366,582291,970485,"JPN",776388
1,86.0,"Southern Africa",51776,0,51776,38403,64005,"ZAF",51204
1,86.0,"South-Eastern Asia",481144,0,481144,358812,598021,"IDN",478417
1,86.0,"Caribbean",160343,0,160343,111500,185833,"CUB",148667
1,87.0,"Pakistan",1517269,1190076,327193,1049896,1749827,"PAK",1399862
1,87.0,"India",5176715,4910751,265964,3612177,6020296,"IND",4816237
1,87.0,"Western Europe",2610402,2606922,3480,1805272,3008787,"NLD",2407030
1,87.0,"China",9623265,7752790,1870475,6760551,11267586,"CPR",9014069
1,87.0,"United States of America",2621963,2620837,1126,1816783,3027972,"USA",2422378
1,87.0,"Northern Africa",1147310,0,1147310,796191,1326986,"EGY",1061589
1,87.0,"Russian Federation",5509995,3401368,2108627,3834593,6390988,"RUS",5112791
1,87.0,"Western Africa",173912,0,173912,122456,204093,"NGA",163275
1,87.0,"South America",1695500,1352278,343222,1174207,1957012,"BRA",1565610
1,87.0,"Northern Europe",1623070,1615119,7951,1112810,1854683,"GBR",1483747
1,87.0,"Northern America",621161,620976,185,459172,765287,"CAN",612230
1,87.0,"Oceania",413547,403607,9940,252018,420031,"NZL",336025
1,87.0,"Eastern Africa",156145,0,156145,108552,180921,"ETH",144737
1,87.0,"Middle Africa",63121,0,63121,43566,72610,"AGO",58088
1,87.0,"Eastern Europe",3996101,3991500,4601,2795976,4659960,"POL",3727968
1,87.0,"Central Asia",1457401,1405184,52217,1013631,1689386,"UZB",1351509
1,87.0,"Southern Europe",300806,0,300806,215748,359581,"ITA",287665
1,87.0,"Central America",179748,0,179748,125121,208535,"MEX",166828
1,87.0,"Southern Asia",421351,0,421351,295667,492778,"IRN",394223
1,87.0,"Western Asia",214850,0,214850,151525,252542,"IRQ",202034
1,87.0,"Eastern Asia",825981,0,825981,582291,970485,"JPN",776388
1,87.0,"Southern Africa",61386,0,61386,38403,64005,"ZAF",51204
1,87.0,"South-Eastern Asia",575672,0,575672,358812,598021,"IDN",478417
1,87.0,"Caribbean",159936,0,159936,111500,185833,"CUB",148667
1,88.0,"Pakistan",1512397,1192693,319704,1049896,1749827,"PAK",1399862
1,88.0,"India",5176379,4913459,262920,3612177,6020296,"IND",4816237
1,88.0,"Western Europe",2572304,2568123,4181,1805272,3008787,"NLD",2407030
1,88.0,"China",9545343,7773239,1772104,6760551,11267586,"CPR",9014069
1,88.0,"United States of America",2582954,2580675,2279,1816783,3027972,"USA",2422378
1,88.0,"Northern Africa",1144596,0,1144596,796191,1326986,"EGY",1061589
1,88.0,"Russian Federation",5368066,3399941,1968125,3834593,6390988,"RUS",5112791
1,88.0,"Western Africa",190930,0,190930,122456,204093,"NGA",163275
1,88.0,"South America",1663404,1350366,313038,1174207,1957012,"BRA",1565610
1,88.0,"Northern Europe",1591890,1585829,6061,1112810,1854683,"GBR",1483747
1,88.0,"Northern America",834024,824122,9902,459172,765287,"CAN",612230
1,88.0,"Oceania",357965,353343,4622,252018,420031,"NZL",336025
1,88.0,"Eastern Africa",167125,0,167125,108552,180921,"ETH",144737
1,88.0,"Middle Africa",68150,0,68150,43566,72610,"AGO",58088
1,88.0,"Eastern Europe",4018395,4010395,8000,2795976,4659960,"POL",3727968
1,88.0,"Central Asia",1462320,1406254,56066,1013631,1689386,"UZB",1351509
1,88.0,"Southern Europe",353155,0,353155,215748,359581,"ITA",287665
1,88.0,"Central America",181225,0,181225,125121,208535,"MEX",166828
1,88.0,"Southern Asia",462319,0,462319,295667,492778,"IRN",394223
1,88.0,"Western Asia",233954,0,233954,151525,252542,"IRQ",202034
1,88.0,"Eastern Asia",929772,0,929772,582291,970485,"JPN",776388
1,88.0,"Southern Africa",56470,0,56470,38403,64005,"ZAF",51204
1,88.0,"South-Eastern Asia",523918,0,523918,358812,598021,"IDN",478417
1,88.0,"Caribbean",162218,0,162218,111500,185833,"CUB",148667
1,89.0,"Pakistan",1527645,1190654,336991,1049896,1749827,"PAK",1399862
1,89.0,"India",5198508,4914104,284404,3612177,6020296,"IND",4816237
1,89.0,"Western Europe",2601682,2585781,15901,1805272,3008787,"NLD",2407030
1,89.0,"China",9593754,7765113,1828641,6760551,11267586,"CPR",9014069
1,89.0,"United States of America",2653439,2640177,13262,1816783,3027972,"USA",2422378
1,89.0,"Northern Africa",1151334,0,1151334,796191,1326986,"EGY",1061589
1,89.0,"Russian Federation",5446786,3399846,2046940,3834593,6390988,"RUS",5112791
1,89.0,"Western Africa",182179,0,182179,122456,204093,"NGA",163275
1,89.0,"South America",1693228,1353162,340066,1174207,1957012,"BRA",1565610
1,89.0,"Northern Europe",1601190,1584975,16215,1112810,1854683,"GBR",1483747
1,89.0,"Northern America",676988,673273,3715,459172,765287,"CAN",612230
1,89.0,"Oceania",365832,354629,11203,252018,420031,"NZL",336025
1,89.0,"Eastern Africa",159828,0,159828,108552,180921,"ETH",144737
1,89.0,"Middle Africa",64759,0,64759,43566,72610,"AGO",58088
1,89.0,"Eastern Europe",4004285,3986735,17550,2795976,4659960,"POL",3727968
1,89.0,"Central Asia",1466845,1400498,66347,1013631,1689386,"UZB",1351509
1,89.0,"Southern Europe",320166,0,320166,215748,359581,"ITA",287665
1,89.0,"Central America",184838,0,184838,125121,208535,"MEX",166828
1,89.0,"Southern Asia",435508,0,435508,295667,492778,"IRN",394223
1,89.0,"Western Asia",222932,0,222932,151525,252542,"IRQ",202034
1,89.0,"Eastern Asia",862286,0,862286,582291,970485,"JPN",776388
1,89.0,"Southern Africa",56325,0,56325,38403,64005,"ZAF",51204
1,89.0,"South-Eastern Asia",523746,0,523746,358812,598021,"IDN",478417
1,89.0,"Caribbean",164838,0,164838,111500,185833,"CUB",148667
1,90.0,"Pakistan",1522513,1186199,336314,1049896,1749827,"PAK",1399862
1,90.0,"India",5205259,4900680,304579,3612177,6020296,"IND",4816237
1,90.0,"Western Europe",2594762,2568553,26209,1805272,3008787,"NLD",2407030
1,90.0,"China",9648289,7765896,1882393,6760551,11267586,"CPR",9014069
1,90.0,"United States of America",2634474,2614197,20277,1816783,3027972,"USA",2422378
1,90.0,"Northern Africa",1151912,0,1151912,796191,1326986,"EGY",1061589
1,90.0,"Russian Federation",5502870,3394677,2108193,3834593,6390988,"RUS",5112791
1,90.0,"Western Africa",172664,0,172664,122456,204093,"NGA",163275
1,90.0,"South America",1706738,1350433,356305,1174207,1957012,"BRA",1565610
1,90.0,"Northern Europe",1602534,1576915,25619,1112810,1854683,"GBR",1483747
1,90.0,"Northern America",605206,603734,1472,459172,765287,"CAN",612230
1,90.0,"Oceania",363380,348574,14806,252018,420031,"NZL",336025
1,90.0,"Eastern Africa",155159,0,155159,108552,180921,"ETH",144737
1,90.0,"Middle Africa",61394,0,61394,43566,72610,"AGO",58088
1,90.0,"Eastern Europe",4109970,4080143,29827,2795976,4659960,"POL",3727968
1,90.0,"Central Asia",1465397,1391578,73819,1013631,1689386,"UZB",1351509
1,90.0,"Southern Europe",298755,0,298755,215748,359581,"ITA",287665
1,90.0,"Central America",180901,0,180901,125121,208535,"MEX",166828
1,90.0,"Southern Asia",419454,0,419454,295667,492778,"IRN",394223
1,90.0,"Western Asia",216793,0,216793,151525,252542,"IRQ",202034
1,90.0,"Eastern Asia",810522,0,810522,582291,970485,"JPN",776388
1,90.0,"Southern Africa",54775,0,54775,38403,64005,"ZAF",51204
1,90.0,"South-Eastern Asia",513465,0,513465,358812,598021,"IDN",478417
1,90.0,"Caribbean",161028,0,161028,111500,185833,"CUB",148667
1,91.0,"Pakistan",1515506,1182539,332967,1049896,1749827,"PAK",1399862
1,91.0,"India",5218324,4894700,323624,3612177,6020296,"IND",4816237
1,91.0,"Western Europe",2649894,2615463,34431,1805272,3008787,"NLD",2407030
1,91.0,"China",9699320,7766231,1933089,6760551,11267586,"CPR",9014069
1,91.0,"United States of America",2605968,2584001,21967,1816783,3027972,"USA",2422378
1,91.0,"Northern Africa",1155865,0,1155865,796191,1326986,"EGY",1061589
1,91.0,"Russian Federation",5555662,3399850,2155812,3834593,6390988,"RUS",5112791
1,91.0,"Western Africa",165949,0,165949,122456,204093,"NGA",163275
1,91.0,"South America",1715481,1350027,365454,1174207,1957012,"BRA",1565610
1,91.0,"Northern Europe",1604670,1573297,31373,1112810,1854683,"GBR",1483747
1,91.0,"Northern America",575567,575086,481,459172,765287,"CAN",612230
1,91.0,"Oceania",357141,343779,13362,252018,420031,"NZL",336025
1,91.0,"Eastern Africa",149746,0,149746,108552,180921,"ETH",144737
1,91.0,"Middle Africa",58944,0,58944,43566,72610,"AGO",58088
1,91.0,"Eastern Europe",4087731,4056839,30892,2795976,4659960,"POL",3727968
1,91.0,"Central Asia",1469400,1388073,81327,1013631,1689386,"UZB",1351509
1,91.0,"Southern Europe",286951,0,286951,215748,359581,"ITA",287665
1,91.0,"Central America",176018,0,176018,125121,208535,"MEX",166828
1,91.0,"Southern Asia",404753,0,404753,295667,492778,"IRN",394223
1,91.0,"Western Asia",209201,0,209201,151525,252542,"IRQ",202034
1,91.0,"Eastern Asia",781529,0,781529,582291,970485,"JPN",776388
1,91.0,"Southern Africa",53038,0,53038,38403,64005,"ZAF",51204
1,91.0,"South-Eastern Asia",500738,0,500738,358812,598021,"IDN",478417
1,91.0,"Caribbean",156568,0,156568,111500,185833,"CUB",148667
1,92.0,"Pakistan",1495658,1179141,316517,1049896,1749827,"PAK",1399862
1,92.0,"India",5232562,4890431,342131,3612177,6020296,"IND",4816237
1,92.0,"Western Europe",2618374,2600441,17933,1805272,3008787,"NLD",2407030
1,92.0,"China",9742193,7760831,1981362,6760551,11267586,"CPR",9014069
1,92.0,"United States of America",2581124,2570707,10417,1816783,3027972,"USA",2422378
1,92.0,"Northern Africa",1137068,0,1137068,796191,1326986,"EGY",1061589
1,92.0,"Russian Federation",5593512,3393620,2199892,3834593,6390988,"RUS",5112791
1,92.0,"Western Africa",177416,0,177416,122456,204093,"NGA",163275
1,92.0,"South America",1675251,1346591,328660,1174207,1957012,"BRA",1565610
1,92.0,"Northern Europe",1600716,1579140,21576,1112810,1854683,"GBR",1483747
1,92.0,"Northern America",703014,695218,7796,459172,765287,"CAN",612230
1,92.0,"Oceania",311399,305796,5603,252018,420031,"NZL",336025
1,92.0,"Eastern Africa",154229,0,154229,108552,180921,"ETH",144737
1,92.0,"Middle Africa",61971,0,61971,43566,72610,"AGO",58088
1,92.0,"Eastern Europe",3957088,3941751,15337,2795976,4659960,"POL",3727968
1,92.0,"Central Asia",1453259,1380402,72857,1013631,1689386,"UZB",1351509
1,92.0,"Southern Europe",319597,0,319597,215748,359581,"ITA",287665
1,92.0,"Central America",178450,0,178450,125121,208535,"MEX",166828
1,92.0,"Southern Asia",423888,0,423888,295667,492778,"IRN",394223
1,92.0,"Western Asia",217794,0,217794,151525,252542,"IRQ",202034
1,92.0,"Eastern Asia",845399,0,845399,582291,970485,"JPN",776388
1,92.0,"Southern Africa",50160,0,50160,38403,64005,"ZAF",51204
1,92.0,"South-Eastern Asia",455852,0,455852,358812,598021,"IDN",478417
1,92.0,"Caribbean",158943,0,158943,111500,185833,"CUB",148667
1,93.0,"Pakistan",1502478,1176215,326263,1049896,1749827,"PAK",1399862
1,93.0,"India",5222111,4877939,344172,3612177,6020296,"IND",4816237
1,93.0,"Western Europe",2531379,2514420,16959,1805272,3008787,"NLD",2407030
1,93.0,"China",9703326,7752292,1951034,6760551,11267586,"CPR",9014069
1,93.0,"United States of America",2577157,2563056,14101,1816783,3027972,"USA",2422378
1,93.0,"Northern Africa",1126700,0,1126700,796191,1326986,"EGY",1061589
1,93.0,"Russian Federation",5558796,3394653,2164143,3834593,6390988,"RUS",5112791
1,93.0,"Western Africa",171452,0,171452,122456,204093,"NGA",163275
1,93.0,"South America",1682383,1344895,337488,1174207,1957012,"BRA",1565610
1,93.0,"Northern Europe",1602520,1578913,23607,1112810,1854683,"GBR",1483747
1,93.0,"Northern America",609424,606853,2571,459172,765287,"CAN",612230
1,93.0,"Oceania",396951,366420,30531,252018,420031,"NZL",336025
1,93.0,"Eastern Africa",154574,0,154574,108552,180921,"ETH",144737
1,93.0,"Middle Africa",62006,0,62006,43566,72610,"AGO",58088
1,93.0,"Eastern Europe",3977609,3957478,20131,2795976,4659960,"POL",3727968
1,93.0,"Central Asia",1453988,1375278,78710,1013631,1689386,"UZB",1351509
1,93.0,"Southern Europe",296674,0,296674,215748,359581,"ITA",287665
1,93.0,"Central America",177503,0,177503,125121,208535,"MEX",166828
1,93.0,"Southern Asia",417504,0,417504,295667,492778,"IRN",394223
1,93.0,"Western Asia",213642,0,213642,151525,252542,"IRQ",202034
1,93.0,"Eastern Asia",807816,0,807816,582291,970485,"JPN",776388
1,93.0,"Southern Africa",58668,0,58668,38403,64005,"ZAF",51204
1,93.0,"South-Eastern Asia",555636,0,555636,358812,598021,"IDN",478417
1,93.0,"Caribbean",158257,0,158257,111500,185833,"CUB",148667
1,94.0,"Pakistan",1513865,1175731,338134,1049896,1749827,"PAK",1399862
1,94.0,"India",5221338,4868465,352873,3612177,6020296,"IND",4816237
1,94.0,"Western Europe",2617951,2596637,21314,1805272,3008787,"NLD",2407030
1,94.0,"China",9771034,7761465,2009569,6760551,11267586,"CPR",9014069
1,94.0,"United States of America",2593388,2578115,15273,1816783,3027972,"USA",2422378
1,94.0,"Northern Africa",1143456,0,1143456,796191,1326986,"EGY",1061589
1,94.0,"Russian Federation",5574816,3393046,2181770,3834593,6390988,"RUS",5112791
1,94.0,"Western Africa",170780,0,170780,122456,204093,"NGA",163275
1,94.0,"South America",1694293,1345240,349053,1174207,1957012,"BRA",1565610
1,94.0,"Northern Europe",1548287,1528635,19652,1112810,1854683,"GBR",1483747
1,94.0,"Northern America",622814,620663,2151,459172,765287,"CAN",612230
1,94.0,"Oceania",353260,344941,8319,252018,420031,"NZL",336025
1,94.0,"Eastern Africa",151933,0,151933,108552,180921,"ETH",144737
1,94.0,"Middle Africa",60545,0,60545,43566,72610,"AGO",58088
1,94.0,"Eastern Europe",3999932,3980217,19715,2795976,4659960,"POL",3727968
1,94.0,"Central Asia",1451026,1371051,79975,1013631,1689386,"UZB",1351509
1,94.0,"Southern Europe",299014,0,299014,215748,359581,"ITA",287665
1,94.0,"Central America",177160,0,177160,125121,208535,"MEX",166828
1,94.0,"Southern Asia",412569,0,412569,295667,492778,"IRN",394223
1,94.0,"Western Asia",212410,0,212410,151525,252542,"IRQ",202034
1,94.0,"Eastern Asia",812763,0,812763,582291,970485,"JPN",776388
1,94.0,"Southern Africa",53568,0,53568,38403,64005,"ZAF",51204
1,94.0,"South-Eastern Asia",500662,0,500662,358812,598021,"IDN",478417
1,94.0,"Caribbean",157744,0,157744,111500,185833,"CUB",148667
1,95.0,"Pakistan",1484138,1172550,311588,1049896,1749827,"PAK",1399862
1,95.0,"India",5156830,4846625,310205,3612177,6020296,"IND",4816237
1,95.0,"Western Europe",2487779,2482171,5608,1805272,3008787,"NLD",2407030
1,95.0,"China",9744917,7752211,1992706,6760551,11267586,"CPR",9014069
1,95.0,"United States of America",2492656,2488550,4106,1816783,3027972,"USA",2422378
1,95.0,"Northern Africa",1097690,0,1097690,796191,1326986,"EGY",1061589
1,95.0,"Russian Federation",5499106,3387692,2111414,3834593,6390988,"RUS",5112791
1,95.0,"Western Africa",167764,0,167764,122456,204093,"NGA",163275
1,95.0,"South America",1655657,1343253,312404,1174207,1957012,"BRA",1565610
1,95.0,"Northern Europe",1573218,1542238,30980,1112810,1854683,"GBR",1483747
1,95.0,"Northern America",635830,629040,6790,459172,765287,"CAN",612230
1,95.0,"Oceania",328707,326480,2227,252018,420031,"NZL",336025
1,95.0,"Eastern Africa",148254,0,148254,108552,180921,"ETH",144737
1,95.0,"Middle Africa",59110,0,59110,43566,72610,"AGO",58088
1,95.0,"Eastern Europe",3890033,3880050,9983,2795976,4659960,"POL",3727968
1,95.0,"Central Asia",1424430,1355339,69091,1013631,1689386,"UZB",1351509
1,95.0,"Southern Europe",297156,0,297156,215748,359581,"ITA",287665
1,95.0,"Central America",171376,0,171376,125121,208535,"MEX",166828
1,95.0,"Southern Asia",407043,0,407043,295667,492778,"IRN",394223
1,95.0,"Western Asia",208673,0,208673,151525,252542,"IRQ",202034
1,95.0,"Eastern Asia",800462,0,800462,582291,970485,"JPN",776388
1,95.0,"Southern Africa",50715,0,50715,38403,64005,"ZAF",51204
1,95.0,"South-Eastern Asia",471499,0,471499,358812,598021,"IDN",478417
1,95.0,"Caribbean",152659,0,152659,111500,185833,"CUB",148667
1,96.0,"Pakistan",1353940,1155140,198800,1049896,1749827,"PAK",1399862
1,96.0,"India",4891328,4815755,75573,3612177,6020296,"IND",4816237
1,96.0,"Western Europe",2427516,2426090,1426,1805272,3008787,"NLD",2407030
1,96.0,"China",9568034,7682695,1885339,6760551,11267586,"CPR",9014069
1,96.0,"United States of America",2440334,2439288,1046,1816783,3027972,"USA",2422378
1,96.0,"Northern Africa",1073351,0,1073351,796191,1326986,"EGY",1061589
1,96.0,"Russian Federation",5004789,3364652,1640137,3834593,6390988,"RUS",5112791
1,96.0,"Western Africa",165385,0,165385,122456,204093,"NGA",163275
1,96.0,"South America",1532404,1344353,188051,1174207,1957012,"BRA",1565610
1,96.0,"Northern Europe",1506639,1499019,7620,1112810,1854683,"GBR",1483747
1,96.0,"Northern America",618327,616582,1745,459172,765287,"CAN",612230
1,96.0,"Oceania",346339,326595,19744,252018,420031,"NZL",336025
1,96.0,"Eastern Africa",147386,0,147386,108552,180921,"ETH",144737
1,96.0,"Middle Africa",59196,0,59196,43566,72610,"AGO",58088
1,96.0,"Eastern Europe",3769446,3765561,3885,2795976,4659960,"POL",3727968
1,96.0,"Central Asia",1370343,1353182,17161,1013631,1689386,"UZB",1351509
1,96.0,"Southern Europe",291296,0,291296,215748,359581,"ITA",287665
1,96.0,"Central America",168647,0,168647,125121,208535,"MEX",166828
1,96.0,"Southern Asia",398869,0,398869,295667,492778,"IRN",394223
1,96.0,"Western Asia",204933,0,204933,151525,252542,"IRQ",202034
1,96.0,"Eastern Asia",783682,0,783682,582291,970485,"JPN",776388
1,96.0,"Southern Africa",52468,0,52468,38403,64005,"ZAF",51204
1,96.0,"South-Eastern Asia",492074,0,492074,358812,598021,"IDN",478417
1,96.0,"Caribbean",150339,0,150339,111500,185833,"CUB",148667
1,97.0,"Pakistan",1436716,1185967,250749,1049896,1749827,"PAK",1399862
1,97.0,"India",4823148,4804183,18965,3612177,6020296,"IND",4816237
1,97.0,"Western Europe",2412193,2411749,444,1805272,3008787,"NLD",2407030
1,97.0,"China",8832606,7672057,1160549,6760551,11267586,"CPR",9014069
1,97.0,"United States of America",2426923,2426695,228,1816783,3027972,"USA",2422378
1,97.0,"Northern Africa",1064596,0,1064596,796191,1326986,"EGY",1061589
1,97.0,"Russian Federation",5100499,3391640,1708859,3834593,6390988,"RUS",5112791
1,97.0,"Western Africa",163823,0,163823,122456,204093,"NGA",163275
1,97.0,"South America",1567881,1350768,217113,1174207,1957012,"BRA",1565610
1,97.0,"Northern Europe",1489593,1487668,1925,1112810,1854683,"GBR",1483747
1,97.0,"Northern America",613789,613347,442,459172,765287,"CAN",612230
1,97.0,"Oceania",338827,333739,5088,252018,420031,"NZL",336025
1,97.0,"Eastern Africa",144942,0,144942,108552,180921,"ETH",144737
1,97.0,"Middle Africa",58381,0,58381,43566,72610,"AGO",58088
1,97.0,"Eastern Europe",3738524,3736292,2232,2795976,4659960,"POL",3727968
1,97.0,"Central Asia",1325654,1321362,4292,1013631,1689386,"UZB",1351509
1,97.0,"Southern Europe",288599,0,288599,215748,359581,"ITA",287665
1,97.0,"Central America",167300,0,167300,125121,208535,"MEX",166828
1,97.0,"Southern Asia",395346,0,395346,295667,492778,"IRN",394223
1,97.0,"Western Asia",202781,0,202781,151525,252542,"IRQ",202034
1,97.0,"Eastern Asia",776359,0,776359,582291,970485,"JPN",776388
1,97.0,"Southern Africa",51714,0,51714,38403,64005,"ZAF",51204
1,97.0,"South-Eastern Asia",481828,0,481828,358812,598021,"IDN",478417
1,97.0,"Caribbean",149098,0,149098,111500,185833,"CUB",148667
1,98.0,"Pakistan",1375494,1183029,192465,1049896,1749827,"PAK",1399862
1,98.0,"India",4805810,4800950,4860,3612177,6020296,"IND",4816237
1,98.0,"Western Europe",2408286,2408088,198,1805272,3008787,"NLD",2407030
1,98.0,"China",8925025,7726015,1199010,6760551,11267586,"CPR",9014069
1,98.0,"United States of America",2423481,2423481,0,1816783,3027972,"USA",2422378
1,98.0,"Northern Africa",1062357,0,1062357,796191,1326986,"EGY",1061589
1,98.0,"Russian Federation",5139663,3390770,1748893,3834593,6390988,"RUS",5112791
1,98.0,"Western Africa",163414,0,163414,122456,204093,"NGA",163275
1,98.0,"South America",1577168,1349491,227677,1174207,1957012,"BRA",1565610
1,98.0,"Northern Europe",1484974,1484750,224,1112810,1854683,"GBR",1483747
1,98.0,"Northern America",612516,612516,0,459172,765287,"CAN",612230
1,98.0,"Oceania",336544,335451,1093,252018,420031,"NZL",336025
1,98.0,"Eastern Africa",145270,0,145270,108552,180921,"ETH",144737
1,98.0,"Middle Africa",58164,0,58164,43566,72610,"AGO",58088
1,98.0,"Eastern Europe",3730531,3728823,1708,2795976,4659960,"POL",3727968
1,98.0,"Central Asia",1375683,1359746,15937,1013631,1689386,"UZB",1351509
1,98.0,"Southern Europe",287853,0,287853,215748,359581,"ITA",287665
1,98.0,"Central America",166950,0,166950,125121,208535,"MEX",166828
1,98.0,"Southern Asia",395304,0,395304,295667,492778,"IRN",394223
1,98.0,"Western Asia",202229,0,202229,151525,252542,"IRQ",202034
1,98.0,"Eastern Asia",778961,0,778961,582291,970485,"JPN",776388
1,98.0,"Southern Africa",51460,0,51460,38403,64005,"ZAF",51204
1,98.0,"South-Eastern Asia",479203,0,479203,358812,598021,"IDN",478417
1,98.0,"Caribbean",148781,0,148781,111500,185833,"CUB",148667
1,99.0,"Pakistan",1410891,1194743,216148,1049896,1749827,"PAK",1399862
1,99.0,"India",4788976,4786446,2530,3612177,6020296,"IND",4816237
1,99.0,"Western Europe",2407351,2407153,198,1805272,3008787,"NLD",2407030
1,99.0,"China",8961207,7740534,1220673,6760551,11267586,"CPR",9014069
1,99.0,"United States of America",2422660,2422660,0,1816783,3027972,"USA",2422378
1,99.0,"Northern Africa",1057287,0,1057287,796191,1326986,"EGY",1061589
1,99.0,"Russian Federation",5148540,3399039,1749501,3834593,6390988,"RUS",5112791
1,99.0,"Western Africa",162707,0,162707,122456,204093,"NGA",163275
1,99.0,"South America",1582569,1350771,231798,1174207,1957012,"BRA",1565610
1,99.0,"Northern Europe",1484004,1484004,0,1112810,1854683,"GBR",1483747
1,99.0,"Northern America",612303,612303,0,459172,765287,"CAN",612230
1,99.0,"Oceania",335879,335879,0,252018,420031,"NZL",336025
1,99.0,"Eastern Africa",143825,0,143825,108552,180921,"ETH",144737
1,99.0,"Middle Africa",57896,0,57896,43566,72610,"AGO",58088
1,99.0,"Eastern Europe",3681722,3680015,1707,2795976,4659960,"POL",3727968
1,99.0,"Central Asia",1337156,1333226,3930,1013631,1689386,"UZB",1351509
1,99.0,"Southern Europe",286376,0,286376,215748,359581,"ITA",287665
1,99.0,"Central America",166861,0,166861,125121,208535,"MEX",166828
1,99.0,"Southern Asia",392081,0,392081,295667,492778,"IRN",394223
1,99.0,"Western Asia",200302,0,200302,151525,252542,"IRQ",202034
1,99.0,"Eastern Asia",775557,0,775557,582291,970485,"JPN",776388
1,99.0,"Southern Africa",51078,0,51078,38403,64005,"ZAF",51204
1,99.0,"South-Eastern Asia",478444,0,478444,358812,598021,"IDN",478417
1,99.0,"Caribbean",148699,0,148699,111500,185833,"CUB",148667
1,100.0,"Pakistan",1419591,1195046,224545,1049896,1749827,"PAK",1399862
1,100.0,"India",4784517,4783681,836,3612177,6020296,"IND",4816237
1,100.0,"Western Europe",2407107,2406914,193,1805272,3008787,"NLD",2407030
1,100.0,"China",9004536,7748661,1255875,6760551,11267586,"CPR",9014069
1,100.0,"United States of America",2422450,2422450,0,1816783,3027972,"USA",2422378
1,100.0,"Northern Africa",1064652,0,1064652,796191,1326986,"EGY",1061589
1,100.0,"Russian Federation",5153708,3396634,1757074,3834593,6390988,"RUS",5112791
1,100.0,"Western Africa",163453,0,163453,122456,204093,"NGA",163275
1,100.0,"South America",1569936,1350945,218991,1174207,1957012,"BRA",1565610
1,100.0,"Northern Europe",1446469,1446469,0,1112810,1854683,"GBR",1483747
1,100.0,"Northern America",612250,612250,0,459172,765287,"CAN",612230
1,100.0,"Oceania",335987,335987,0,252018,420031,"NZL",336025
1,100.0,"Eastern Africa",145183,0,145183,108552,180921,"ETH",144737
1,100.0,"Middle Africa",58209,0,58209,43566,72610,"AGO",58088
1,100.0,"Eastern Europe",3763113,3758891,4222,2795976,4659960,"POL",3727968
1,100.0,"Central Asia",1347637,1343724,3913,1013631,1689386,"UZB",1351509
1,100.0,"Southern Europe",288162,0,288162,215748,359581,"ITA",287665
1,100.0,"Central America",166837,0,166837,125121,208535,"MEX",166828
1,100.0,"Southern Asia",394922,0,394922,295667,492778,"IRN",394223
1,100.0,"Western Asia",202991,0,202991,151525,252542,"IRQ",202034
1,100.0,"Eastern Asia",777290,0,777290,582291,970485,"JPN",776388
1,100.0,"Southern Africa",51202,0,51202,38403,64005,"ZAF",51204
1,100.0,"South-Eastern Asia",478247,0,478247,358812,598021,"IDN",478417
1,100.0,"Caribbean",148676,0,148676,111500,185833,"CUB",148667
1,101.0,"Pakistan",1381477,1194935,186542,1049896,1749827,"PAK",1399862
1,101.0,"India",4795396,4792280,3116,3612177,6020296,"IND",4816237
1,101.0,"Western Europe",2407001,2407001,0,1805272,3008787,"NLD",2407030
1,101.0,"China",9027973,7749321,1278652,6760551,11267586,"CPR",9014069
1,101.0,"United States of America",2422398,2422398,0,1816783,3027972,"USA",2422378
1,101.0,"Northern Africa",1057519,0,1057519,796191,1326986,"EGY",1061589
1,101.0,"Russian Federation",5082123,3398334,1683789,3834593,6390988,"RUS",5112791
1,101.0,"Western Africa",162901,0,162901,122456,204093,"NGA",163275
1,101.0,"South America",1566674,1349452,217222,1174207,1957012,"BRA",1565610
1,101.0,"Northern Europe",1511857,1501884,9973,1112810,1854683,"GBR",1483747
1,101.0,"Northern America",612236,612236,0,459172,765287,"CAN",612230
1,101.0,"Oceania",336014,336014,0,252018,420031,"NZL",336025
1,101.0,"Eastern Africa",144241,0,144241,108552,180921,"ETH",144737
1,101.0,"Middle Africa",57973,0,57973,43566,72610,"AGO",58088
1,101.0,"Eastern Europe",3680511,3677152,3359,2795976,4659960,"POL",3727968
1,101.0,"Central Asia",1370974,1364497,6477,1013631,1689386,"UZB",1351509
1,101.0,"Southern Europe",286722,0,286722,215748,359581,"ITA",287665
1,101.0,"Central America",166830,0,166830,125121,208535,"MEX",166828
1,101.0,"Southern Asia",393349,0,393349,295667,492778,"IRN",394223
1,101.0,"Western Asia",200518,0,200518,151525,252542,"IRQ",202034
1,101.0,"Eastern Asia",776102,0,776102,582291,970485,"JPN",776388
1,101.0,"Southern Africa",51210,0,51210,38403,64005,"ZAF",51204
1,101.0,"South-Eastern Asia",478285,0,478285,358812,598021,"IDN",478417
1,101.0,"Caribbean",148671,0,148671,111500,185833,"CUB",148667
1,102.0,"Pakistan",1396791,1194315,202476,1049896,1749827,"PAK",1399862
1,102.0,"India",4786077,4781762,4315,3612177,6020296,"IND",4816237
1,102.0,"Western Europe",2407023,2407023,0,1805272,3008787,"NLD",2407030
1,102.0,"China",9064261,7760537,1303724,6760551,11267586,"CPR",9014069
1,102.0,"United States of America",2422383,2422383,0,1816783,3027972,"USA",2422378
1,102.0,"Northern Africa",1065411,0,1065411,796191,1326986,"EGY",1061589
1,102.0,"Russian Federation",5110274,3397445,1712829,3834593,6390988,"RUS",5112791
1,102.0,"Western Africa",163906,0,163906,122456,204093,"NGA",163275
1,102.0,"South America",1565897,1349387,216510,1174207,1957012,"BRA",1565610
1,102.0,"Northern Europe",1490925,1488415,2510,1112810,1854683,"GBR",1483747
1,102.0,"Northern America",612232,612232,0,459172,765287,"CAN",612230
1,102.0,"Oceania",336022,336022,0,252018,420031,"NZL",336025
1,102.0,"Eastern Africa",145145,0,145145,108552,180921,"ETH",144737
1,102.0,"Middle Africa",58312,0,58312,43566,72610,"AGO",58088
1,102.0,"Eastern Europe",3772398,3764753,7645,2795976,4659960,"POL",3727968
1,102.0,"Central Asia",1318952,1317336,1616,1013631,1689386,"UZB",1351509
1,102.0,"Southern Europe",289038,0,289038,215748,359581,"ITA",287665
1,102.0,"Central America",166831,0,166831,125121,208535,"MEX",166828
1,102.0,"Southern Asia",395113,0,395113,295667,492778,"IRN",394223
1,102.0,"Western Asia",203454,0,203454,151525,252542,"IRQ",202034
1,102.0,"Eastern Asia",777511,0,777511,582291,970485,"JPN",776388
1,102.0,"Southern Africa",51202,0,51202,38403,64005,"ZAF",51204
1,102.0,"South-Eastern Asia",478206,0,478206,358812,598021,"IDN",478417
1,102.0,"Caribbean",148668,0,148668,111500,185833,"CUB",148667
1,103.0,"Pakistan",1411517,1195995,215522,1049896,1749827,"PAK",1399862
1,103.0,"India",4795792,4785240,10552,3612177,6020296,"IND",4816237
1,103.0,"Western Europe",2407027,2407027,0,1805272,3008787,"NLD",2407030
1,103.0,"China",9070732,7754760,1315972,6760551,11267586,"CPR",9014069
1,103.0,"United States of America",2422380,2422380,0,1816783,3027972,"USA",2422378
1,103.0,"Northern Africa",1062240,0,1062240,796191,1326986,"EGY",1061589
1,103.0,"Russian Federation",5131490,3399706,1731784,3834593,6390988,"RUS",5112791
1,103.0,"Western Africa",163317,0,163317,122456,204093,"NGA",163275
1,103.0,"South America",1569167,1349828,219339,1174207,1957012,"BRA",1565610
1,103.0,"Northern Europe",1485504,1484941,563,1112810,1854683,"GBR",1483747
1,103.0,"Northern America",612231,612231,0,459172,765287,"CAN",612230
1,103.0,"Oceania",336024,336024,0,252018,420031,"NZL",336025
1,103.0,"Eastern Africa",145178,0,145178,108552,180921,"ETH",144737
1,103.0,"Middle Africa",58068,0,58068,43566,72610,"AGO",58088
1,103.0,"Eastern Europe",3729926,3723462,6464,2795976,4659960,"POL",3727968
1,103.0,"Central Asia",1380885,1366949,13936,1013631,1689386,"UZB",1351509
1,103.0,"Southern Europe",287750,0,287750,215748,359581,"ITA",287665
1,103.0,"Central America",166829,0,166829,125121,208535,"MEX",166828
1,103.0,"Southern Asia",395342,0,395342,295667,492778,"IRN",394223
1,103.0,"Western Asia",202463,0,202463,151525,252542,"IRQ",202034
1,103.0,"Eastern Asia",776965,0,776965,582291,970485,"JPN",776388
1,103.0,"Southern Africa",51299,0,51299,38403,64005,"ZAF",51204
1,103.0,"South-Eastern Asia",478271,0,478271,358812,598021,"IDN",478417
1,103.0,"Caribbean",148668,0,148668,111500,185833,"CUB",148667
1,104.0,"Pakistan",1409100,1193060,216040,1049896,1749827,"PAK",1399862
1,104.0,"India",4835634,4816038,19596,3612177,6020296,"IND",4816237
1,104.0,"Western Europe",2407029,2407029,0,1805272,3008787,"NLD",2407030
1,104.0,"China",9087210,7766521,1320689,6760551,11267586,"CPR",9014069
1,104.0,"United States of America",2422379,2422379,0,1816783,3027972,"USA",2422378
1,104.0,"Northern Africa",1061225,0,1061225,796191,1326986,"EGY",1061589
1,104.0,"Russian Federation",5106152,3397471,1708681,3834593,6390988,"RUS",5112791
1,104.0,"Western Africa",163150,0,163150,122456,204093,"NGA",163275
1,104.0,"South America",1569979,1350713,219266,1174207,1957012,"BRA",1565610
1,104.0,"Northern Europe",1476581,1476581,0,1112810,1854683,"GBR",1483747
1,104.0,"Northern America",612231,612231,0,459172,765287,"CAN",612230
1,104.0,"Oceania",336024,336024,0,252018,420031,"NZL",336025
1,104.0,"Eastern Africa",144240,0,144240,108552,180921,"ETH",144737
1,104.0,"Middle Africa",58031,0,58031,43566,72610,"AGO",58088
1,104.0,"Eastern Europe",3728365,3721867,6498,2795976,4659960,"POL",3727968
1,104.0,"Central Asia",1314668,1311160,3508,1013631,1689386,"UZB",1351509
1,104.0,"Southern Europe",287442,0,287442,215748,359581,"ITA",287665
1,104.0,"Central America",166829,0,166829,125121,208535,"MEX",166828
1,104.0,"Southern Asia",392793,0,392793,295667,492778,"IRN",394223
1,104.0,"Western Asia",201497,0,201497,151525,252542,"IRQ",202034
1,104.0,"Eastern Asia",775828,0,775828,582291,970485,"JPN",776388
1,104.0,"Southern Africa",51064,0,51064,38403,64005,"ZAF",51204
1,104.0,"South-Eastern Asia",478555,0,478555,358812,598021,"IDN",478417
1,104.0,"Caribbean",148668,0,148668,111500,185833,"CUB",148667
1,105.0,"Pakistan",1397740,1192291,205449,1049896,1749827,"PAK",1399862
1,105.0,"India",4833867,4811670,22197,3612177,6020296,"IND",4816237
1,105.0,"Western Europe",2407029,2407029,0,1805272,3008787,"NLD",2407030
1,105.0,"China",9009273,7766403,1242870,6760551,11267586,"CPR",9014069
1,105.0,"United States of America",2422379,2422379,0,1816783,3027972,"USA",2422378
1,105.0,"Northern Africa",1058690,0,1058690,796191,1326986,"EGY",1061589
1,105.0,"Russian Federation",5051389,3397441,1653948,3834593,6390988,"RUS",5112791
1,105.0,"Western Africa",162771,0,162771,122456,204093,"NGA",163275
1,105.0,"South America",1566654,1349138,217516,1174207,1957012,"BRA",1565610
1,105.0,"Northern Europe",1489439,1489068,371,1112810,1854683,"GBR",1483747
1,105.0,"Northern America",612231,612231,0,459172,765287,"CAN",612230
1,105.0,"Oceania",336024,336024,0,252018,420031,"NZL",336025
1,105.0,"Eastern Africa",144185,0,144185,108552,180921,"ETH",144737
1,105.0,"Middle Africa",57905,0,57905,43566,72610,"AGO",58088
1,105.0,"Eastern Europe",3681119,3675139,5980,2795976,4659960,"POL",3727968
1,105.0,"Central Asia",1386540,1366040,20500,1013631,1689386,"UZB",1351509
1,105.0,"Southern Europe",286510,0,286510,215748,359581,"ITA",287665
1,105.0,"Central America",166829,0,166829,125121,208535,"MEX",166828
1,105.0,"Southern Asia",393027,0,393027,295667,492778,"IRN",394223
1,105.0,"Western Asia",200528,0,200528,151525,252542,"IRQ",202034
1,105.0,"Eastern Asia",775667,0,775667,582291,970485,"JPN",776388
1,105.0,"Southern Africa",51289,0,51289,38403,64005,"ZAF",51204
1,105.0,"South-Eastern Asia",478540,0,478540,358812,598021,"IDN",478417
1,105.0,"Caribbean",148668,0,148668,111500,185833,"CUB",148667
1,106.0,"Pakistan",1309604,1193490,116114,1049896,1749827,"PAK",1399862
1,106.0,"India",4833076,4815405,17671,3612177,6020296,"IND",4816237
1,106.0,"Western Europe",2382798,2382798,0,1805272,3008787,"NLD",2407030
1,106.0,"China",9014767,7760219,1254548,6760551,11267586,"CPR",9014069
1,106.0,"United States of America",2422379,2422379,0,1816783,3027972,"USA",2422378
1,106.0,"Northern Africa",1055525,0,1055525,796191,1326986,"EGY",1061589
1,106.0,"Russian Federation",5099321,3396751,1702570,3834593,6390988,"RUS",5112791
1,106.0,"Western Africa",162025,0,162025,122456,204093,"NGA",163275
1,106.0,"South America",1565622,1348475,217147,1174207,1957012,"BRA",1565610
1,106.0,"Northern Europe",1425303,1425303,0,1112810,1854683,"GBR",1483747
1,106.0,"Northern America",612231,612231,0,459172,765287,"CAN",612230
1,106.0,"Oceania",336024,336024,0,252018,420031,"NZL",336025
1,106.0,"Eastern Africa",145678,0,145678,108552,180921,"ETH",144737
1,106.0,"Middle Africa",57679,0,57679,43566,72610,"AGO",58088
1,106.0,"Eastern Europe",3772347,3762233,10114,2795976,4659960,"POL",3727968
1,106.0,"Central Asia",1360544,1355319,5225,1013631,1689386,"UZB",1351509
1,106.0,"Southern Europe",285401,0,285401,215748,359581,"ITA",287665
1,106.0,"Central America",166829,0,166829,125121,208535,"MEX",166828
1,106.0,"Southern Asia",394797,0,394797,295667,492778,"IRN",394223
1,106.0,"Western Asia",203708,0,203708,151525,252542,"IRQ",202034
1,106.0,"Eastern Asia",776222,0,776222,582291,970485,"JPN",776388
1,106.0,"Southern Africa",51259,0,51259,38403,64005,"ZAF",51204
1,106.0,"South-Eastern Asia",478540,0,478540,358812,598021,"IDN",478417
1,106.0,"Caribbean",148668,0,148668,111500,185833,"CUB",148667
1,107.0,"Pakistan",1394578,1196939,197639,1049896,1749827,"PAK",1399862
1,107.0,"India",4808528,4795540,12988,3612177,6020296,"IND",4816237
1,107.0,"Western Europe",2425204,2423638,1566,1805272,3008787,"NLD",2407030
1,107.0,"China",8958413,7739627,1218786,6760551,11267586,"CPR",9014069
1,107.0,"United States of America",2422379,2422379,0,1816783,3027972,"USA",2422378
1,107.0,"Northern Africa",1069359,0,1069359,796191,1326986,"EGY",1061589
1,107.0,"Russian Federation",5115185,3397548,1717637,3834593,6390988,"RUS",5112791
1,107.0,"Western Africa",164797,0,164797,122456,204093,"NGA",163275
1,107.0,"South America",1537760,1345625,192135,1174207,1957012,"BRA",1565610
1,107.0,"Northern Europe",1529104,1508020,21084,1112810,1854683,"GBR",1483747
1,107.0,"Northern America",612231,612231,0,459172,765287,"CAN",612230
1,107.0,"Oceania",336024,336024,0,252018,420031,"NZL",336025
1,107.0,"Eastern Africa",145032,0,145032,108552,180921,"ETH",144737
1,107.0,"Middle Africa",58596,0,58596,43566,72610,"AGO",58088
1,107.0,"Eastern Europe",3739410,3736733,2677,2795976,4659960,"POL",3727968
1,107.0,"Central Asia",1353633,1352489,1144,1013631,1689386,"UZB",1351509
1,107.0,"Southern Europe",290660,0,290660,215748,359581,"ITA",287665
1,107.0,"Central America",166829,0,166829,125121,208535,"MEX",166828
1,107.0,"Southern Asia",396374,0,396374,295667,492778,"IRN",394223
1,107.0,"Western Asia",202780,0,202780,151525,252542,"IRQ",202034
1,107.0,"Eastern Asia",777866,0,777866,582291,970485,"JPN",776388
1,107.0,"Southern Africa",51302,0,51302,38403,64005,"ZAF",51204
1,107.0,"South-Eastern Asia",478361,0,478361,358812,598021,"IDN",478417
1,107.0,"Caribbean",148668,0,148668,111500,185833,"CUB",148667
1,108.0,"Pakistan",1454364,1198726,255638,1049896,1749827,"PAK",1399862
1,108.0,"India",4801836,4784200,17636,3612177,6020296,"IND",4816237
1,108.0,"Western Europe",2411622,2411272,350,1805272,3008787,"NLD",2407030
1,108.0,"China",8972905,7737475,1235430,6760551,11267586,"CPR",9014069
1,108.0,"United States of America",2422379,2422379,0,1816783,3027972,"USA",2422378
1,108.0,"Northern Africa",1060947,0,1060947,796191,1326986,"EGY",1061589
1,108.0,"Russian Federation",5135299,3394554,1740745,3834593,6390988,"RUS",5112791
1,108.0,"Western Africa",163064,0,163064,122456,204093,"NGA",163275
1,108.0,"South America",1554907,1347531,207376,1174207,1957012,"BRA",1565610
1,108.0,"Northern Europe",1495333,1490063,5270,1112810,1854683,"GBR",1483747
1,108.0,"Northern America",612231,612231,0,459172,765287,"CAN",612230
1,108.0,"Oceania",336024,336024,0,252018,420031,"NZL",336025
1,108.0,"Eastern Africa",143622,0,143622,108552,180921,"ETH",144737
1,108.0,"Middle Africa",58007,0,58007,43566,72610,"AGO",58088
1,108.0,"Eastern Europe",3693257,3690960,2297,2795976,4659960,"POL",3727968
1,108.0,"Central Asia",1334857,1334749,108,1013631,1689386,"UZB",1351509
1,108.0,"Southern Europe",287144,0,287144,215748,359581,"ITA",287665
1,108.0,"Central America",166829,0,166829,125121,208535,"MEX",166828
1,108.0,"Southern Asia",392049,0,392049,295667,492778,"IRN",394223
1,108.0,"Western Asia",200239,0,200239,151525,252542,"IRQ",202034
1,108.0,"Eastern Asia",774883,0,774883,582291,970485,"JPN",776388
1,108.0,"Southern Africa",50965,0,50965,38403,64005,"ZAF",51204
1,108.0,"South-Eastern Asia",478314,0,478314,358812,598021,"IDN",478417
1,108.0,"Caribbean",148668,0,148668,111500,185833,"CUB",148667
1,109.0,"Pakistan",1439715,1197925,241790,1049896,1749827,"PAK",1399862
1,109.0,"India",4800097,4778718,21379,3612177,6020296,"IND",4816237
1,109.0,"Western Europe",2389931,2389931,0,1805272,3008787,"NLD",2407030
1,109.0,"China",9005842,7746222,1259620,6760551,11267586,"CPR",9014069
1,109.0,"United States of America",2422379,2422379,0,1816783,3027972,"USA",2422378
1,109.0,"Northern Africa",1057548,0,1057548,796191,1326986,"EGY",1061589
1,109.0,"Russian Federation",5148695,3397066,1751629,3834593,6390988,"RUS",5112791
1,109.0,"Western Africa",162850,0,162850,122456,204093,"NGA",163275
1,109.0,"South America",1569912,1349760,220152,1174207,1957012,"BRA",1565610
1,109.0,"Northern Europe",1460491,1459199,1292,1112810,1854683,"GBR",1483747
1,109.0,"Northern America",612231,612231,0,459172,765287,"CAN",612230
1,109.0,"Oceania",336024,336024,0,252018,420031,"NZL",336025
1,109.0,"Eastern Africa",145435,0,145435,108552,180921,"ETH",144737
1,109.0,"Middle Africa",57998,0,57998,43566,72610,"AGO",58088
1,109.0,"Eastern Europe",3756608,3752526,4082,2795976,4659960,"POL",3727968
1,109.0,"Central Asia",1364328,1362880,1448,1013631,1689386,"UZB",1351509
1,109.0,"Southern Europe",287023,0,287023,215748,359581,"ITA",287665
1,109.0,"Central America",166829,0,166829,125121,208535,"MEX",166828
1,109.0,"Southern Asia",395426,0,395426,295667,492778,"IRN",394223
1,109.0,"Western Asia",203241,0,203241,151525,252542,"IRQ",202034
1,109.0,"Eastern Asia",777176,0,777176,582291,970485,"JPN",776388
1,109.0,"Southern Africa",51257,0,51257,38403,64005,"ZAF",51204
1,109.0,"South-Eastern Asia",478301,0,478301,358812,598021,"IDN",478417
1,109.0,"Caribbean",148668,0,148668,111500,185833,"CUB",148667
1,110.0,"Pakistan",1330908,1195198,135710,1049896,1749827,"PAK",1399862
1,110.0,"India",4824134,4797622,26512,3612177,6020296,"IND",4816237
1,110.0,"Western Europe",2420918,2419972,946,1805272,3008787,"NLD",2407030
1,110.0,"China",9022377,7754099,1268278,6760551,11267586,"CPR",9014069
1,110.0,"United States of America",2422379,2422379,0,1816783,3027972,"USA",2422378
1,110.0,"Northern Africa",1060793,0,1060793,796191,1326986,"EGY",1061589
1,110.0,"Russian Federation",5139063,3393292,1745771,3834593,6390988,"RUS",5112791
1,110.0,"Western Africa",162671,0,162671,122456,204093,"NGA",163275
1,110.0,"South America",1577341,1350481,226860,1174207,1957012,"BRA",1565610
1,110.0,"Northern Europe",1503881,1497753,6128,1112810,1854683,"GBR",1483747
1,110.0,"Northern America",612231,612231,0,459172,765287,"CAN",612230
1,110.0,"Oceania",336024,336024,0,252018,420031,"NZL",336025
1,110.0,"Eastern Africa",142460,0,142460,108552,180921,"ETH",144737
1,110.0,"Middle Africa",57860,0,57860,43566,72610,"AGO",58088
1,110.0,"Eastern Europe",3650729,3649654,1075,2795976,4659960,"POL",3727968
1,110.0,"Central Asia",1317301,1316919,382,1013631,1689386,"UZB",1351509
1,110.0,"Southern Europe",286386,0,286386,215748,359581,"ITA",287665
1,110.0,"Central America",166829,0,166829,125121,208535,"MEX",166828
1,110.0,"Southern Asia",388596,0,388596,295667,492778,"IRN",394223
1,110.0,"Western Asia",198277,0,198277,151525,252542,"IRQ",202034
1,110.0,"Eastern Asia",773024,0,773024,582291,970485,"JPN",776388
1,110.0,"Southern Africa",50862,0,50862,38403,64005,"ZAF",51204
1,110.0,"South-Eastern Asia",478473,0,478473,358812,598021,"IDN",478417
1,110.0,"Caribbean",148668,0,148668,111500,185833,"CUB",148667
1,111.0,"Pakistan",1393173,1196881,196292,1049896,1749827,"PAK",1399862
1,111.0,"India",4818541,4799516,19025,3612177,6020296,"IND",4816237
1,111.0,"Western Europe",2410598,2410336,262,1805272,3008787,"NLD",2407030
1,111.0,"China",9049915,7757666,1292249,6760551,11267586,"CPR",9014069
1,111.0,"United States of America",2422379,2422379,0,1816783,3027972,"USA",2422378
1,111.0,"Northern Africa",1067223,0,1067223,796191,1326986,"EGY",1061589
1,111.0,"Russian Federation",4775169,3394280,1380889,3834593,6390988,"RUS",5112791
1,111.0,"Western Africa",163485,0,163485,122456,204093,"NGA",163275
1,111.0,"South America",1572337,1349085,223252,1174207,1957012,"BRA",1565610
1,111.0,"Northern Europe",1451529,1449905,1624,1112810,1854683,"GBR",1483747
1,111.0,"Northern America",612231,612231,0,459172,765287,"CAN",612230
1,111.0,"Oceania",336024,336024,0,252018,420031,"NZL",336025
1,111.0,"Eastern Africa",146461,0,146461,108552,180921,"ETH",144737
1,111.0,"Middle Africa",58156,0,58156,43566,72610,"AGO",58088
1,111.0,"Eastern Europe",3792934,3785049,7885,2795976,4659960,"POL",3727968
1,111.0,"Central Asia",1380475,1371364,9111,1013631,1689386,"UZB",1351509
1,111.0,"Southern Europe",288465,0,288465,215748,359581,"ITA",287665
1,111.0,"Central America",166829,0,166829,125121,208535,"MEX",166828
1,111.0,"Southern Asia",398591,0,398591,295667,492778,"IRN",394223
1,111.0,"Western Asia",204956,0,204956,151525,252542,"IRQ",202034
1,111.0,"Eastern Asia",778815,0,778815,582291,970485,"JPN",776388
1,111.0,"Southern Africa",51423,0,51423,38403,64005,"ZAF",51204
1,111.0,"South-Eastern Asia",478433,0,478433,358812,598021,"IDN",478417
1,111.0,"Caribbean",148668,0,148668,111500,185833,"CUB",148667
1,112.0,"Pakistan",1435023,1194889,240134,1049896,1749827,"PAK",1399862
1,112.0,"India",4804596,4781240,23356,3612177,6020296,"IND",4816237
1,112.0,"Western Europe",2401814,2401814,0,1805272,3008787,"NLD",2407030
1,112.0,"China",9003285,7719022,1284263,6760551,11267586,"CPR",9014069
1,112.0,"United States of America",2422379,2422379,0,1816783,3027972,"USA",2422378
1,112.0,"Northern Africa",1061354,0,1061354,796191,1326986,"EGY",1061589
1,112.0,"Russian Federation",4946019,3395379,1550640,3834593,6390988,"RUS",5112791
1,112.0,"Western Africa",164278,0,164278,122456,204093,"NGA",163275
1,112.0,"South America",1570728,1345684,225044,1174207,1957012,"BRA",1565610
1,112.0,"Northern Europe",1512944,1500908,12036,1112810,1854683,"GBR",1483747
1,112.0,"Northern America",612231,612231,0,459172,765287,"CAN",612230
1,112.0,"Oceania",336024,336024,0,252018,420031,"NZL",336025
1,112.0,"Eastern Africa",145535,0,145535,108552,180921,"ETH",144737
1,112.0,"Middle Africa",58454,0,58454,43566,72610,"AGO",58088
1,112.0,"Eastern Europe",3744524,3739777,4747,2795976,4659960,"POL",3727968
1,112.0,"Central Asia",1358942,1356613,2329,1013631,1689386,"UZB",1351509
1,112.0,"Southern Europe",289465,0,289465,215748,359581,"ITA",287665
1,112.0,"Central America",166829,0,166829,125121,208535,"MEX",166828
1,112.0,"Southern Asia",396366,0,396366,295667,492778,"IRN",394223
1,112.0,"Western Asia",203278,0,203278,151525,252542,"IRQ",202034
1,112.0,"Eastern Asia",778001,0,778001,582291,970485,"JPN",776388
1,112.0,"Southern Africa",51387,0,51387,38403,64005,"ZAF",51204
1,112.0,"South-Eastern Asia",478333,0,478333,358812,598021,"IDN",478417
1,112.0,"Caribbean",148668,0,148668,111500,185833,"CUB",148667
1,113.0,"Pakistan",1434058,1193422,240636,1049896,1749827,"PAK",1399862
1,113.0,"India",4800762,4770117,30645,3612177,6020296,"IND",4816237
1,113.0,"Western Europe",2399672,2399489,183,1805272,3008787,"NLD",2407030
1,113.0,"China",9009111,7709587,1299524,6760551,11267586,"CPR",9014069
1,113.0,"United States of America",2422379,2422379,0,1816783,3027972,"USA",2422378
1,113.0,"Northern Africa",1059517,0,1059517,796191,1326986,"EGY",1061589
1,113.0,"Russian Federation",5100459,3397361,1703098,3834593,6390988,"RUS",5112791
1,113.0,"Western Africa",163477,0,163477,122456,204093,"NGA",163275
1,113.0,"South America",1570385,1343387,226998,1174207,1957012,"BRA",1565610
1,113.0,"Northern Europe",1491197,1488173,3024,1112810,1854683,"GBR",1483747
1,113.0,"Northern America",612231,612231,0,459172,765287,"CAN",612230
1,113.0,"Oceania",336024,336024,0,252018,420031,"NZL",336025
1,113.0,"Eastern Africa",143129,0,143129,108552,180921,"ETH",144737
1,113.0,"Middle Africa",58172,0,58172,43566,72610,"AGO",58088
1,113.0,"Eastern Europe",3732136,3730702,1434,2795976,4659960,"POL",3727968
1,113.0,"Central Asia",1305478,1305148,330,1013631,1689386,"UZB",1351509
1,113.0,"Southern Europe",287942,0,287942,215748,359581,"ITA",287665
1,113.0,"Central America",166829,0,166829,125121,208535,"MEX",166828
1,113.0,"Southern Asia",389558,0,389558,295667,492778,"IRN",394223
1,113.0,"Western Asia",202300,0,202300,151525,252542,"IRQ",202034
1,113.0,"Eastern Asia",775435,0,775435,582291,970485,"JPN",776388
1,113.0,"Southern Africa",50669,0,50669,38403,64005,"ZAF",51204
1,113.0,"South-Eastern Asia",478307,0,478307,358812,598021,"IDN",478417
1,113.0,"Caribbean",148668,0,148668,111500,185833,"CUB",148667
1,114.0,"Pakistan",1378922,1188003,190919,1049896,1749827,"PAK",1399862
1,114.0,"India",4799581,4763179,36402,3612177,6020296,"IND",4816237
1,114.0,"Western Europe",2417344,2416411,933,1805272,3008787,"NLD",2407030
1,114.0,"China",8977955,7704972,1272983,6760551,11267586,"CPR",9014069
1,114.0,"United States of America",2422379,2422379,0,1816783,3027972,"USA",2422378
1,114.0,"Northern Africa",1056262,0,1056262,796191,1326986,"EGY",1061589
1,114.0,"Russian Federation",5200727,3392971,1807756,3834593,6390988,"RUS",5112791
1,114.0,"Western Africa",160888,0,160888,122456,204093,"NGA",163275
1,114.0,"South America",1556360,1342298,214062,1174207,1957012,"BRA",1565610
1,114.0,"Northern Europe",1485498,1484881,617,1112810,1854683,"GBR",1483747
1,114.0,"Northern America",612231,612231,0,459172,765287,"CAN",612230
1,114.0,"Oceania",336024,336024,0,252018,420031,"NZL",336025
1,114.0,"Eastern Africa",143662,0,143662,108552,180921,"ETH",144737
1,114.0,"Middle Africa",57231,0,57231,43566,72610,"AGO",58088
1,114.0,"Eastern Europe",3616409,3615781,628,2795976,4659960,"POL",3727968
1,114.0,"Central Asia",1387518,1369406,18112,1013631,1689386,"UZB",1351509
1,114.0,"Southern Europe",282957,0,282957,215748,359581,"ITA",287665
1,114.0,"Central America",166829,0,166829,125121,208535,"MEX",166828
1,114.0,"Southern Asia",392507,0,392507,295667,492778,"IRN",394223
1,114.0,"Western Asia",196417,0,196417,151525,252542,"IRQ",202034
1,114.0,"Eastern Asia",769873,0,769873,582291,970485,"JPN",776388
1,114.0,"Southern Africa",51426,0,51426,38403,64005,"ZAF",51204
1,114.0,"South-Eastern Asia",478298,0,478298,358812,598021,"IDN",478417
1,114.0,"Caribbean",148668,0,148668,111500,185833,"CUB",148667
1,115.0,"Pakistan",1396572,1187958,208614,1049896,1749827,"PAK",1399862
1,115.0,"India",4786941,4752015,34926,3612177,6020296,"IND",4816237
1,115.0,"Western Europe",2397550,2396970,580,1805272,3008787,"NLD",2407030
1,115.0,"China",8977824,7686685,1291139,6760551,11267586,"CPR",9014069
1,115.0,"United States of America",2422379,2422379,0,1816783,3027972,"USA",2422378
1,115.0,"Northern Africa",1064731,0,1064731,796191,1326986,"EGY",1061589
1,115.0,"Russian Federation",5273287,3399802,1873485,3834593,6390988,"RUS",5112791
1,115.0,"Western Africa",164892,0,164892,122456,204093,"NGA",163275
1,115.0,"South America",1556407,1339051,217356,1174207,1957012,"BRA",1565610
1,115.0,"Northern Europe",1476566,1476566,0,1112810,1854683,"GBR",1483747
1,115.0,"Northern America",612231,612231,0,459172,765287,"CAN",612230
1,115.0,"Oceania",336024,336024,0,252018,420031,"NZL",336025
1,115.0,"Eastern Africa",145844,0,145844,108552,180921,"ETH",144737
1,115.0,"Middle Africa",58672,0,58672,43566,72610,"AGO",58088
1,115.0,"Eastern Europe",3812226,3799952,12274,2795976,4659960,"POL",3727968
1,115.0,"Central Asia",1333603,1328867,4736,1013631,1689386,"UZB",1351509
1,115.0,"Southern Europe",290923,0,290923,215748,359581,"ITA",287665
1,115.0,"Central America",166829,0,166829,125121,208535,"MEX",166828
1,115.0,"Southern Asia",396668,0,396668,295667,492778,"IRN",394223
1,115.0,"Western Asia",205963,0,205963,151525,252542,"IRQ",202034
1,115.0,"Eastern Asia",781686,0,781686,582291,970485,"JPN",776388
1,115.0,"Southern Africa",51143,0,51143,38403,64005,"ZAF",51204
1,115.0,"South-Eastern Asia",478209,0,478209,358812,598021,"IDN",478417
1,115.0,"Caribbean",148668,0,148668,111500,185833,"CUB",148667
1,116.0,"Pakistan",1409549,1186131,223418,1049896,1749827,"PAK",1399862
1,116.0,"India",4795875,4748401,47474,3612177,6020296,"IND",4816237
1,116.0,"Western Europe",2410642,2409966,676,1805272,3008787,"NLD",2407030
1,116.0,"China",8990147,7689853,1300294,6760551,11267586,"CPR",9014069
1,116.0,"United States of America",2422379,2422379,0,1816783,3027972,"USA",2422378
1,116.0,"Northern Africa",1057626,0,1057626,796191,1326986,"EGY",1061589
1,116.0,"Russian Federation",5271320,3396900,1874420,3834593,6390988,"RUS",5112791
1,116.0,"Western Africa",161607,0,161607,122456,204093,"NGA",163275
1,116.0,"South America",1563245,1337256,225989,1174207,1957012,"BRA",1565610
1,116.0,"Northern Europe",1489384,1489384,0,1112810,1854683,"GBR",1483747
1,116.0,"Northern America",612231,612231,0,459172,765287,"CAN",612230
1,116.0,"Oceania",336024,336024,0,252018,420031,"NZL",336025
1,116.0,"Eastern Africa",143841,0,143841,108552,180921,"ETH",144737
1,116.0,"Middle Africa",57406,0,57406,43566,72610,"AGO",58088
1,116.0,"Eastern Europe",3645803,3642665,3138,2795976,4659960,"POL",3727968
1,116.0,"Central Asia",1374015,1363334,10681,1013631,1689386,"UZB",1351509
1,116.0,"Southern Europe",284339,0,284339,215748,359581,"ITA",287665
1,116.0,"Central America",166829,0,166829,125121,208535,"MEX",166828
1,116.0,"Southern Asia",392387,0,392387,295667,492778,"IRN",394223
1,116.0,"Western Asia",198123,0,198123,151525,252542,"IRQ",202034
1,116.0,"Eastern Asia",771539,0,771539,582291,970485,"JPN",776388
1,116.0,"Southern Africa",51323,0,51323,38403,64005,"ZAF",51204
1,116.0,"South-Eastern Asia",478273,0,478273,358812,598021,"IDN",478417
1,116.0,"Caribbean",148668,0,148668,111500,185833,"CUB",148667
1,117.0,"Pakistan",1347324,1187470,159854,1049896,1749827,"PAK",1399862
1,117.0,"India",4860450,4801857,58593,3612177,6020296,"IND",4816237
1,117.0,"Western Europe",2383664,2383272,392,1805272,3008787,"NLD",2407030
1,117.0,"China",9060316,7728975,1331341,6760551,11267586,"CPR",9014069
1,117.0,"United States of America",2422379,2422379,0,1816783,3027972,"USA",2422378
1,117.0,"Northern Africa",1058062,0,1058062,796191,1326986,"EGY",1061589
1,117.0,"Russian Federation",5149671,3399609,1750062,3834593,6390988,"RUS",5112791
1,117.0,"Western Africa",162699,0,162699,122456,204093,"NGA",163275
1,117.0,"South America",1578789,1348220,230569,1174207,1957012,"BRA",1565610
1,117.0,"Northern Europe",1421642,1421642,0,1112810,1854683,"GBR",1483747
1,117.0,"Northern America",612231,612231,0,459172,765287,"CAN",612230
1,117.0,"Oceania",336024,336024,0,252018,420031,"NZL",336025
1,117.0,"Eastern Africa",145796,0,145796,108552,180921,"ETH",144737
1,117.0,"Middle Africa",57895,0,57895,43566,72610,"AGO",58088
1,117.0,"Eastern Europe",3810564,3797658,12906,2795976,4659960,"POL",3727968
1,117.0,"Central Asia",1336917,1334110,2807,1013631,1689386,"UZB",1351509
1,117.0,"Southern Europe",287097,0,287097,215748,359581,"ITA",287665
1,117.0,"Central America",166829,0,166829,125121,208535,"MEX",166828
1,117.0,"Southern Asia",394998,0,394998,295667,492778,"IRN",394223
1,117.0,"Western Asia",205778,0,205778,151525,252542,"IRQ",202034
1,117.0,"Eastern Asia",780685,0,780685,582291,970485,"JPN",776388
1,117.0,"Southern Africa",51132,0,51132,38403,64005,"ZAF",51204
1,117.0,"South-Eastern Asia",478733,0,478733,358812,598021,"IDN",478417
1,117.0,"Caribbean",148668,0,148668,111500,185833,"CUB",148667
1,118.0,"Pakistan",1412949,1196378,216571,1049896,1749827,"PAK",1399862
1,118.0,"India",4853192,4792378,60814,3612177,6020296,"IND",4816237
1,118.0,"Western Europe",2400847,2398711,2136,1805272,3008787,"NLD",2407030
1,118.0,"China",9080542,7756392,1324150,6760551,11267586,"CPR",9014069
1,118.0,"United States of America",2422379,2422379,0,1816783,3027972,"USA",2422378
1,118.0,"Northern Africa",1058776,0,1058776,796191,1326986,"EGY",1061589
1,118.0,"Russian Federation",5102062,3394577,1707485,3834593,6390988,"RUS",5112791
1,118.0,"Western Africa",164080,0,164080,122456,204093,"NGA",163275
1,118.0,"South America",1569115,1346703,222412,1174207,1957012,"BRA",1565610
1,118.0,"Northern Europe",1531711,1511527,20184,1112810,1854683,"GBR",1483747
1,118.0,"Northern America",612231,612231,0,459172,765287,"CAN",612230
1,118.0,"Oceania",336024,336024,0,252018,420031,"NZL",336025
1,118.0,"Eastern Africa",144733,0,144733,108552,180921,"ETH",144737
1,118.0,"Middle Africa",58379,0,58379,43566,72610,"AGO",58088
1,118.0,"Eastern Europe",3692623,3689236,3387,2795976,4659960,"POL",3727968
1,118.0,"Central Asia",1368106,1363990,4116,1013631,1689386,"UZB",1351509
1,118.0,"Southern Europe",288883,0,288883,215748,359581,"ITA",287665
1,118.0,"Central America",166829,0,166829,125121,208535,"MEX",166828
1,118.0,"Southern Asia",395307,0,395307,295667,492778,"IRN",394223
1,118.0,"Western Asia",200652,0,200652,151525,252542,"IRQ",202034
1,118.0,"Eastern Asia",775099,0,775099,582291,970485,"JPN",776388
1,118.0,"Southern Africa",51380,0,51380,38403,64005,"ZAF",51204
1,118.0,"South-Eastern Asia",478679,0,478679,358812,598021,"IDN",478417
1,118.0,"Caribbean",148668,0,148668,111500,185833,"CUB",148667
1,119.0,"Pakistan",1441765,1198448,243317,1049896,1749827,"PAK",1399862
1,119.0,"India",4826168,4776381,49787,3612177,6020296,"IND",4816237
1,119.0,"Western Europe",2399064,2397129,1935,1805272,3008787,"NLD",2407030
1,119.0,"China",9079719,7746527,1333192,6760551,11267586,"CPR",9014069
1,119.0,"United States of America",2422379,2422379,0,1816783,3027972,"USA",2422378
1,119.0,"Northern Africa",1060816,0,1060816,796191,1326986,"EGY",1061589
1,119.0,"Russian Federation",5131110,3395533,1735577,3834593,6390988,"RUS",5112791
1,119.0,"Western Africa",163925,0,163925,122456,204093,"NGA",163275
1,119.0,"South America",1566522,1345440,221082,1174207,1957012,"BRA",1565610
1,119.0,"Northern Europe",1473516,1468447,5069,1112810,1854683,"GBR",1483747
1,119.0,"Northern America",612231,612231,0,459172,765287,"CAN",612230
1,119.0,"Oceania",336024,336024,0,252018,420031,"NZL",336025
1,119.0,"Eastern Africa",144186,0,144186,108552,180921,"ETH",144737
1,119.0,"Middle Africa",58330,0,58330,43566,72610,"AGO",58088
1,119.0,"Eastern Europe",3775427,3769699,5728,2795976,4659960,"POL",3727968
1,119.0,"Central Asia",1311412,1310382,1030,1013631,1689386,"UZB",1351509
1,119.0,"Southern Europe",289071,0,289071,215748,359581,"ITA",287665
1,119.0,"Central America",166829,0,166829,125121,208535,"MEX",166828
1,119.0,"Southern Asia",393019,0,393019,295667,492778,"IRN",394223
1,119.0,"Western Asia",203676,0,203676,151525,252542,"IRQ",202034
1,119.0,"Eastern Asia",778758,0,778758,582291,970485,"JPN",776388
1,119.0,"Southern Africa",50784,0,50784,38403,64005,"ZAF",51204
1,119.0,"South-Eastern Asia",478485,0,478485,358812,598021,"IDN",478417
1,119.0,"Caribbean",148668,0,148668,111500,185833,"CUB",148667
1,120.0,"Pakistan",1356102,1196736,159366,1049896,1749827,"PAK",1399862
1,120.0,"India",4831204,4786595,44609,3612177,6020296,"IND",4816237
1,120.0,"Western Europe",2441730,2437606,4124,1805272,3008787,"NLD",2407030
1,120.0,"China",9071039,7752683,1318356,6760551,11267586,"CPR",9014069
1,120.0,"United States of America",2422379,2422379,0,1816783,3027972,"USA",2422378
1,120.0,"Northern Africa",1072621,0,1072621,796191,1326986,"EGY",1061589
1,120.0,"Russian Federation",5150628,3395241,1755387,3834593,6390988,"RUS",5112791
1,120.0,"Western Africa",163530,0,163530,122456,204093,"NGA",163275
1,120.0,"South America",1572750,1350958,221792,1174207,1957012,"BRA",1565610
1,120.0,"Northern Europe",1503481,1497154,6327,1112810,1854683,"GBR",1483747
1,120.0,"Northern America",612231,612231,0,459172,765287,"CAN",612230
1,120.0,"Oceania",336024,336024,0,252018,420031,"NZL",336025
1,120.0,"Eastern Africa",145342,0,145342,108552,180921,"ETH",144737
1,120.0,"Middle Africa",58124,0,58124,43566,72610,"AGO",58088
1,120.0,"Eastern Europe",3693102,3691581,1521,2795976,4659960,"POL",3727968
1,120.0,"Central Asia",1385778,1369894,15884,1013631,1689386,"UZB",1351509
1,120.0,"Southern Europe",287974,0,287974,215748,359581,"ITA",287665
1,120.0,"Central America",166829,0,166829,125121,208535,"MEX",166828
1,120.0,"Southern Asia",395971,0,395971,295667,492778,"IRN",394223
1,120.0,"Western Asia",200878,0,200878,151525,252542,"IRQ",202034
1,120.0,"Eastern Asia",774960,0,774960,582291,970485,"JPN",776388
1,120.0,"Southern Africa",51582,0,51582,38403,64005,"ZAF",51204
1,120.0,"South-Eastern Asia",478524,0,478524,358812,598021,"IDN",478417
1,120.0,"Caribbean",148668,0,148668,111500,185833,"CUB",148667
1,121.0,"Pakistan",1412253,1197364,214889,1049896,1749827,"PAK",1399862
1,121.0,"India",4881711,4840012,41699,3612177,6020296,"IND",4816237
1,121.0,"Western Europe",2415914,2414703,1211,1805272,3008787,"NLD",2407030
1,121.0,"China",8996434,7732690,1263744,6760551,11267586,"CPR",9014069
1,121.0,"United States of America",2422379,2422379,0,1816783,3027972,"USA",2422378
1,121.0,"Northern Africa",1066118,0,1066118,796191,1326986,"EGY",1061589
1,121.0,"Russian Federation",5162290,3397551,1764739,3834593,6390988,"RUS",5112791
1,121.0,"Western Africa",162630,0,162630,122456,204093,"NGA",163275
1,121.0,"South America",1570903,1350037,220866,1174207,1957012,"BRA",1565610
1,121.0,"Northern Europe",1447589,1446014,1575,1112810,1854683,"GBR",1483747
1,121.0,"Northern America",612231,612231,0,459172,765287,"CAN",612230
1,121.0,"Oceania",336024,336024,0,252018,420031,"NZL",336025
1,121.0,"Eastern Africa",144938,0,144938,108552,180921,"ETH",144737
1,121.0,"Middle Africa",57870,0,57870,43566,72610,"AGO",58088
1,121.0,"Eastern Europe",3766007,3761871,4136,2795976,4659960,"POL",3727968
1,121.0,"Central Asia",1336489,1332384,4105,1013631,1689386,"UZB",1351509
1,121.0,"Southern Europe",286757,0,286757,215748,359581,"ITA",287665
1,121.0,"Central America",166829,0,166829,125121,208535,"MEX",166828
1,121.0,"Southern Asia",393978,0,393978,295667,492778,"IRN",394223
1,121.0,"Western Asia",203662,0,203662,151525,252542,"IRQ",202034
1,121.0,"Eastern Asia",778015,0,778015,582291,970485,"JPN",776388
1,121.0,"Southern Africa",51079,0,51079,38403,64005,"ZAF",51204
1,121.0,"South-Eastern Asia",478889,0,478889,358812,598021,"IDN",478417
1,121.0,"Caribbean",148668,0,148668,111500,185833,"CUB",148667
1,122.0,"Pakistan",1444353,1199294,245059,1049896,1749827,"PAK",1399862
1,122.0,"India",4845272,4824153,21119,3612177,6020296,"IND",4816237
1,122.0,"Western Europe",2409169,2408989,180,1805272,3008787,"NLD",2407030
1,122.0,"China",9004056,7737762,1266294,6760551,11267586,"CPR",9014069
1,122.0,"United States of America",2422379,2422379,0,1816783,3027972,"USA",2422378
1,122.0,"Northern Africa",1061668,0,1061668,796191,1326986,"EGY",1061589
1,122.0,"Russian Federation",5132305,3392942,1739363,3834593,6390988,"RUS",5112791
1,122.0,"Western Africa",164032,0,164032,122456,204093,"NGA",163275
1,122.0,"South America",1552915,1347304,205611,1174207,1957012,"BRA",1565610
1,122.0,"Northern Europe",1515853,1501845,14008,1112810,1854683,"GBR",1483747
1,122.0,"Northern America",612231,612231,0,459172,765287,"CAN",612230
1,122.0,"Oceania",336024,336024,0,252018,420031,"NZL",336025
1,122.0,"Eastern Africa",144952,0,144952,108552,180921,"ETH",144737
1,122.0,"Middle Africa",58334,0,58334,43566,72610,"AGO",58088
1,122.0,"Eastern Europe",3700111,3697551,2560,2795976,4659960,"POL",3727968
1,122.0,"Central Asia",1371400,1361580,9820,1013631,1689386,"UZB",1351509
1,122.0,"Southern Europe",288851,0,288851,215748,359581,"ITA",287665
1,122.0,"Central America",166829,0,166829,125121,208535,"MEX",166828
1,122.0,"Southern Asia",395393,0,395393,295667,492778,"IRN",394223
1,122.0,"Western Asia",201011,0,201011,151525,252542,"IRQ",202034
1,122.0,"Eastern Asia",775449,0,775449,582291,970485,"JPN",776388
1,122.0,"Southern Africa",51415,0,51415,38403,64005,"ZAF",51204
1,122.0,"South-Eastern Asia",478628,0,478628,358812,598021,"IDN",478417
1,122.0,"Caribbean",148668,0,148668,111500,185833,"CUB",148667
1,123.0,"Pakistan",1339287,1198628,140659,1049896,1749827,"PAK",1399862
1,123.0,"India",4835931,4830072,5859,3612177,6020296,"IND",4816237
1,123.0,"Western Europe",2401471,2401471,0,1805272,3008787,"NLD",2407030
1,123.0,"China",9036242,7753736,1282506,6760551,11267586,"CPR",9014069
1,123.0,"United States of America",2422379,2422379,0,1816783,3027972,"USA",2422378
1,123.0,"Northern Africa",1059627,0,1059627,796191,1326986,"EGY",1061589
1,123.0,"Russian Federation",5136818,3395829,1740989,3834593,6390988,"RUS",5112791
1,123.0,"Western Africa",162357,0,162357,122456,204093,"NGA",163275
1,123.0,"South America",1558918,1348508,210410,1174207,1957012,"BRA",1565610
1,123.0,"Northern Europe",1446958,1443473,3485,1112810,1854683,"GBR",1483747
1,123.0,"Northern America",612231,612231,0,459172,765287,"CAN",612230
1,123.0,"Oceania",336024,336024,0,252018,420031,"NZL",336025
1,123.0,"Eastern Africa",144505,0,144505,108552,180921,"ETH",144737
1,123.0,"Middle Africa",57792,0,57792,43566,72610,"AGO",58088
1,123.0,"Eastern Europe",3758392,3753795,4597,2795976,4659960,"POL",3727968
1,123.0,"Central Asia",1329304,1326844,2460,1013631,1689386,"UZB",1351509
1,123.0,"Southern Europe",286205,0,286205,215748,359581,"ITA",287665
1,123.0,"Central America",166829,0,166829,125121,208535,"MEX",166828
1,123.0,"Southern Asia",392995,0,392995,295667,492778,"IRN",394223
1,123.0,"Western Asia",203161,0,203161,151525,252542,"IRQ",202034
1,123.0,"Eastern Asia",777402,0,777402,582291,970485,"JPN",776388
1,123.0,"Southern Africa",50974,0,50974,38403,64005,"ZAF",51204
1,123.0,"South-Eastern Asia",478559,0,478559,358812,598021,"IDN",478417
1,123.0,"Caribbean",148668,0,148668,111500,185833,"CUB",148667
1,124.0,"Pakistan",1404718,1198883,205835,1049896,1749827,"PAK",1399862
1,124.0,"India",4809071,4807636,1435,3612177,6020296,"IND",4816237
1,124.0,"Western Europe",2399531,2399531,0,1805272,3008787,"NLD",2407030
1,124.0,"China",9017428,7739872,1277556,6760551,11267586,"CPR",9014069
1,124.0,"United States of America",2422379,2422379,0,1816783,3027972,"USA",2422378
1,124.0,"Northern Africa",1059559,0,1059559,796191,1326986,"EGY",1061589
1,124.0,"Russian Federation",5098866,3393373,1705493,3834593,6390988,"RUS",5112791
1,124.0,"Western Africa",164520,0,164520,122456,204093,"NGA",163275
1,124.0,"South America",1563956,1348222,215734,1174207,1957012,"BRA",1565610
1,124.0,"Northern Europe",1519423,1501025,18398,1112810,1854683,"GBR",1483747
1,124.0,"Northern America",612231,612231,0,459172,765287,"CAN",612230
1,124.0,"Oceania",336024,336024,0,252018,420031,"NZL",336025
1,124.0,"Eastern Africa",145232,0,145232,108552,180921,"ETH",144737
1,124.0,"Middle Africa",58517,0,58517,43566,72610,"AGO",58088
1,124.0,"Eastern Europe",3716972,3715766,1206,2795976,4659960,"POL",3727968
1,124.0,"Central Asia",1373129,1362157,10972,1013631,1689386,"UZB",1351509
1,124.0,"Southern Europe",289789,0,289789,215748,359581,"ITA",287665
1,124.0,"Central America",166829,0,166829,125121,208535,"MEX",166828
1,124.0,"Southern Asia",396319,0,396319,295667,492778,"IRN",394223
1,124.0,"Western Asia",201887,0,201887,151525,252542,"IRQ",202034
1,124.0,"Eastern Asia",776621,0,776621,582291,970485,"JPN",776388
1,124.0,"Southern Africa",51437,0,51437,38403,64005,"ZAF",51204
1,124.0,"South-Eastern Asia",478365,0,478365,358812,598021,"IDN",478417
1,124.0,"Caribbean",148668,0,148668,111500,185833,"CUB",148667
1,125.0,"Pakistan",1446387,1199158,247229,1049896,1749827,"PAK",1399862
1,125.0,"India",4802119,4801719,400,3612177,6020296,"IND",4816237
1,125.0,"Western Europe",2417306,2416994,312,1805272,3008787,"NLD",2407030
1,125.0,"China",9018999,7729705,1289294,6760551,11267586,"CPR",9014069
1,125.0,"United States of America",2422379,2422379,0,1816783,3027972,"USA",2422378
1,125.0,"Northern Africa",1065558,0,1065558,796191,1326986,"EGY",1061589
1,125.0,"Russian Federation",5113404,3392566,1720838,3834593,6390988,"RUS",5112791
1,125.0,"Western Africa",164088,0,164088,122456,204093,"NGA",163275
1,125.0,"South America",1568749,1348418,220331,1174207,1957012,"BRA",1565610
1,125.0,"Northern Europe",1492717,1488240,4477,1112810,1854683,"GBR",1483747
1,125.0,"Northern America",612231,612231,0,459172,765287,"CAN",612230
1,125.0,"Oceania",336024,336024,0,252018,420031,"NZL",336025
1,125.0,"Eastern Africa",143960,0,143960,108552,180921,"ETH",144737
1,125.0,"Middle Africa",58361,0,58361,43566,72610,"AGO",58088
1,125.0,"Eastern Europe",3744338,3742752,1586,2795976,4659960,"POL",3727968
1,125.0,"Central Asia",1322918,1320177,2741,1013631,1689386,"UZB",1351509
1,125.0,"Southern Europe",289203,0,289203,215748,359581,"ITA",287665
1,125.0,"Central America",166829,0,166829,125121,208535,"MEX",166828
1,125.0,"Southern Asia",392395,0,392395,295667,492778,"IRN",394223
1,125.0,"Western Asia",202257,0,202257,151525,252542,"IRQ",202034
1,125.0,"Eastern Asia",777117,0,777117,582291,970485,"JPN",776388
1,125.0,"Southern Africa",50787,0,50787,38403,64005,"ZAF",51204
1,125.0,"South-Eastern Asia",478315,0,478315,358812,598021,"IDN",478417
1,125.0,"Caribbean",148668,0,148668,111500,185833,"CUB",148667
1,126.0,"Pakistan",1415238,1198385,216853,1049896,1749827,"PAK",1399862
1,126.0,"India",4800309,4800063,246,3612177,6020296,"IND",4816237
1,126.0,"Western Europe",2409653,2409342,311,1805272,3008787,"NLD",2407030
1,126.0,"China",9047888,7760073,1287815,6760551,11267586,"CPR",9014069
1,126.0,"United States of America",2422379,2422379,0,1816783,3027972,"USA",2422378
1,126.0,"Northern Africa",1061369,0,1061369,796191,1326986,"EGY",1061589
1,126.0,"Russian Federation",5108681,3392051,1716630,3834593,6390988,"RUS",5112791
1,126.0,"Western Africa",162421,0,162421,122456,204093,"NGA",163275
1,126.0,"South America",1573332,1349188,224144,1174207,1957012,"BRA",1565610
1,126.0,"Northern Europe",1486038,1484901,1137,1112810,1854683,"GBR",1483747
1,126.0,"Northern America",612231,612231,0,459172,765287,"CAN",612230
1,126.0,"Oceania",336024,336024,0,252018,420031,"NZL",336025
1,126.0,"Eastern Africa",144648,0,144648,108552,180921,"ETH",144737
1,126.0,"Middle Africa",57783,0,57783,43566,72610,"AGO",58088
1,126.0,"Eastern Europe",3685129,3683813,1316,2795976,4659960,"POL",3727968
1,126.0,"Central Asia",1378356,1362581,15775,1013631,1689386,"UZB",1351509
1,126.0,"Southern Europe",285919,0,285919,215748,359581,"ITA",287665
1,126.0,"Central America",166829,0,166829,125121,208535,"MEX",166828
1,126.0,"Southern Asia",394052,0,394052,295667,492778,"IRN",394223
1,126.0,"Western Asia",200218,0,200218,151525,252542,"IRQ",202034
1,126.0,"Eastern Asia",774346,0,774346,582291,970485,"JPN",776388
1,126.0,"Southern Africa",51445,0,51445,38403,64005,"ZAF",51204
1,126.0,"South-Eastern Asia",478301,0,478301,358812,598021,"IDN",478417
1,126.0,"Caribbean",148668,0,148668,111500,185833,"CUB",148667
1,127.0,"Pakistan",1368198,1198408,169790,1049896,1749827,"PAK",1399862
1,127.0,"India",4799794,4799516,278,3612177,6020296,"IND",4816237
1,127.0,"Western Europe",2395577,2395273,304,1805272,3008787,"NLD",2407030
1,127.0,"China",8622442,7747903,874539,6760551,11267586,"CPR",9014069
1,127.0,"United States of America",2422379,2422379,0,1816783,3027972,"USA",2422378
1,127.0,"Northern Africa",1057658,0,1057658,796191,1326986,"EGY",1061589
1,127.0,"Russian Federation",5121972,3396377,1725595,3834593,6390988,"RUS",5112791
1,127.0,"Western Africa",162140,0,162140,122456,204093,"NGA",163275
1,127.0,"South America",1574477,1351709,222768,1174207,1957012,"BRA",1565610
1,127.0,"Northern Europe",1446693,1446693,0,1112810,1854683,"GBR",1483747
1,127.0,"Northern America",612231,612231,0,459172,765287,"CAN",612230
1,127.0,"Oceania",336024,336024,0,252018,420031,"NZL",336025
1,127.0,"Eastern Africa",144868,0,144868,108552,180921,"ETH",144737
1,127.0,"Middle Africa",57719,0,57719,43566,72610,"AGO",58088
1,127.0,"Eastern Europe",3764033,3759718,4315,2795976,4659960,"POL",3727968
1,127.0,"Central Asia",1331111,1327126,3985,1013631,1689386,"UZB",1351509
1,127.0,"Southern Europe",286108,0,286108,215748,359581,"ITA",287665
1,127.0,"Central America",166829,0,166829,125121,208535,"MEX",166828
1,127.0,"Southern Asia",394195,0,394195,295667,492778,"IRN",394223
1,127.0,"Western Asia",203551,0,203551,151525,252542,"IRQ",202034
1,127.0,"Eastern Asia",777580,0,777580,582291,970485,"JPN",776388
1,127.0,"Southern Africa",51008,0,51008,38403,64005,"ZAF",51204
1,127.0,"South-Eastern Asia",478298,0,478298,358812,598021,"IDN",478417
1,127.0,"Caribbean",148668,0,148668,111500,185833,"CUB",148667
1,128.0,"Pakistan",1394906,1197576,197330,1049896,1749827,"PAK",1399862
1,128.0,"India",4787368,4786430,938,3612177,6020296,"IND",4816237
1,128.0,"Western Europe",2385796,2385312,484,1805272,3008787,"NLD",2407030
1,128.0,"China",8703137,7756321,946816,6760551,11267586,"CPR",9014069
1,128.0,"United States of America",2422379,2422379,0,1816783,3027972,"USA",2422378
1,128.0,"Northern Africa",1055177,0,1055177,796191,1326986,"EGY",1061589
1,128.0,"Russian Federation",5110982,3392667,1718315,3834593,6390988,"RUS",5112791
1,128.0,"Western Africa",164822,0,164822,122456,204093,"NGA",163275
1,128.0,"South America",1561004,1349023,211981,1174207,1957012,"BRA",1565610
1,128.0,"Northern Europe",1511860,1502719,9141,1112810,1854683,"GBR",1483747
1,128.0,"Northern America",612231,612231,0,459172,765287,"CAN",612230
1,128.0,"Oceania",336024,336024,0,252018,420031,"NZL",336025
1,128.0,"Eastern Africa",145870,0,145870,108552,180921,"ETH",144737
1,128.0,"Middle Africa",58640,0,58640,43566,72610,"AGO",58088
1,128.0,"Eastern Europe",3737159,3736075,1084,2795976,4659960,"POL",3727968
1,128.0,"Central Asia",1373462,1363106,10356,1013631,1689386,"UZB",1351509
1,128.0,"Southern Europe",290349,0,290349,215748,359581,"ITA",287665
1,128.0,"Central America",166829,0,166829,125121,208535,"MEX",166828
1,128.0,"Southern Asia",397498,0,397498,295667,492778,"IRN",394223
1,128.0,"Western Asia",202890,0,202890,151525,252542,"IRQ",202034
1,128.0,"Eastern Asia",777625,0,777625,582291,970485,"JPN",776388
1,128.0,"Southern Africa",51511,0,51511,38403,64005,"ZAF",51204
1,128.0,"South-Eastern Asia",478208,0,478208,358812,598021,"IDN",478417
1,128.0,"Caribbean",148668,0,148668,111500,185833,"CUB",148667
1,129.0,"Pakistan",1418054,1196953,221101,1049896,1749827,"PAK",1399862
1,129.0,"India",4796408,4792483,3925,3612177,6020296,"IND",4816237
1,129.0,"Western Europe",2432223,2428682,3541,1805272,3008787,"NLD",2407030
1,129.0,"China",8794543,7751839,1042704,6760551,11267586,"CPR",9014069
1,129.0,"United States of America",2422379,2422379,0,1816783,3027972,"USA",2422378
1,129.0,"Northern Africa",1071120,0,1071120,796191,1326986,"EGY",1061589
1,129.0,"Russian Federation",4735327,3385103,1350224,3834593,6390988,"RUS",5112791
1,129.0,"Western Africa",163816,0,163816,122456,204093,"NGA",163275
1,129.0,"South America",1560919,1348292,212627,1174207,1957012,"BRA",1565610
1,129.0,"Northern Europe",1490954,1488623,2331,1112810,1854683,"GBR",1483747
1,129.0,"Northern America",612231,612231,0,459172,765287,"CAN",612230
1,129.0,"Oceania",336024,336024,0,252018,420031,"NZL",336025
1,129.0,"Eastern Africa",144921,0,144921,108552,180921,"ETH",144737
1,129.0,"Middle Africa",58250,0,58250,43566,72610,"AGO",58088
1,129.0,"Eastern Europe",3730283,3729807,476,2795976,4659960,"POL",3727968
1,129.0,"Central Asia",1353671,1351093,2578,1013631,1689386,"UZB",1351509
1,129.0,"Southern Europe",288522,0,288522,215748,359581,"ITA",287665
1,129.0,"Central America",166829,0,166829,125121,208535,"MEX",166828
1,129.0,"Southern Asia",394756,0,394756,295667,492778,"IRN",394223
1,129.0,"Western Asia",202238,0,202238,151525,252542,"IRQ",202034
1,129.0,"Eastern Asia",776666,0,776666,582291,970485,"JPN",776388
1,129.0,"Southern Africa",51240,0,51240,38403,64005,"ZAF",51204
1,129.0,"South-Eastern Asia",478274,0,478274,358812,598021,"IDN",478417
1,129.0,"Caribbean",148668,0,148668,111500,185833,"CUB",148667
1,130.0,"Pakistan",1417069,1190588,226481,1049896,1749827,"PAK",1399862
1,130.0,"India",4774033,4765418,8615,3612177,6020296,"IND",4816237
1,130.0,"Western Europe",2413320,2412017,1303,1805272,3008787,"NLD",2407030
1,130.0,"China",8883674,7754971,1128703,6760551,11267586,"CPR",9014069
1,130.0,"United States of America",2422379,2422379,0,1816783,3027972,"USA",2422378
1,130.0,"Northern Africa",1063575,0,1063575,796191,1326986,"EGY",1061589
1,130.0,"Russian Federation",4912575,3397523,1515052,3834593,6390988,"RUS",5112791
1,130.0,"Western Africa",163415,0,163415,122456,204093,"NGA",163275
1,130.0,"South America",1557562,1341554,216008,1174207,1957012,"BRA",1565610
1,130.0,"Northern Europe",1485513,1484995,518,1112810,1854683,"GBR",1483747
1,130.0,"Northern America",612231,612231,0,459172,765287,"CAN",612230
1,130.0,"Oceania",336024,336024,0,252018,420031,"NZL",336025
1,130.0,"Eastern Africa",144460,0,144460,108552,180921,"ETH",144737
1,130.0,"Middle Africa",58132,0,58132,43566,72610,"AGO",58088
1,130.0,"Eastern Europe",3728560,3728084,476,2795976,4659960,"POL",3727968
1,130.0,"Central Asia",1338306,1336947,1359,1013631,1689386,"UZB",1351509
1,130.0,"Southern Europe",287885,0,287885,215748,359581,"ITA",287665
1,130.0,"Central America",166829,0,166829,125121,208535,"MEX",166828
1,130.0,"Southern Asia",393050,0,393050,295667,492778,"IRN",394223
1,130.0,"Western Asia",202006,0,202006,151525,252542,"IRQ",202034
1,130.0,"Eastern Asia",776140,0,776140,582291,970485,"JPN",776388
1,130.0,"Southern Africa",51035,0,51035,38403,64005,"ZAF",51204
1,130.0,"South-Eastern Asia",478114,0,478114,358812,598021,"IDN",478417
1,130.0,"Caribbean",148668,0,148668,111500,185833,"CUB",148667
1,131.0,"Pakistan",1370386,1183677,186709,1049896,1749827,"PAK",1399862
1,131.0,"India",4792549,4774723,17826,3612177,6020296,"IND",4816237
1,131.0,"Western Europe",2408635,2407756,879,1805272,3008787,"NLD",2407030
1,131.0,"China",8978939,7762364,1216575,6760551,11267586,"CPR",9014069
1,131.0,"United States of America",2422379,2422379,0,1816783,3027972,"USA",2422378
1,131.0,"Northern Africa",1062187,0,1062187,796191,1326986,"EGY",1061589
1,131.0,"Russian Federation",5059444,3396307,1663137,3834593,6390988,"RUS",5112791
1,131.0,"Western Africa",163096,0,163096,122456,204093,"NGA",163275
1,131.0,"South America",1560119,1337502,222617,1174207,1957012,"BRA",1565610
1,131.0,"Northern Europe",1484066,1484066,0,1112810,1854683,"GBR",1483747
1,131.0,"Northern America",612231,612231,0,459172,765287,"CAN",612230
1,131.0,"Oceania",336024,336024,0,252018,420031,"NZL",336025
1,131.0,"Eastern Africa",144799,0,144799,108552,180921,"ETH",144737
1,131.0,"Middle Africa",58013,0,58013,43566,72610,"AGO",58088
1,131.0,"Eastern Europe",3718736,3718260,476,2795976,4659960,"POL",3727968
1,131.0,"Central Asia",1365217,1360775,4442,1013631,1689386,"UZB",1351509
1,131.0,"Southern Europe",287295,0,287295,215748,359581,"ITA",287665
1,131.0,"Central America",166829,0,166829,125121,208535,"MEX",166828
1,131.0,"Southern Asia",394829,0,394829,295667,492778,"IRN",394223
1,131.0,"Western Asia",201639,0,201639,151525,252542,"IRQ",202034
1,131.0,"Eastern Asia",775802,0,775802,582291,970485,"JPN",776388
1,131.0,"Southern Africa",51343,0,51343,38403,64005,"ZAF",51204
1,131.0,"South-Eastern Asia",478249,0,478249,358812,598021,"IDN",478417
1,131.0,"Caribbean",148668,0,148668,111500,185833,"CUB",148667
1,132.0,"Pakistan",1392010,1179682,212328,1049896,1749827,"PAK",1399862
1,132.0,"India",4772596,4744490,28106,3612177,6020296,"IND",4816237
1,132.0,"Western Europe",2407392,2406669,723,1805272,3008787,"NLD",2407030
1,132.0,"China",9053862,7757767,1296095,6760551,11267586,"CPR",9014069
1,132.0,"United States of America",2422379,2422379,0,1816783,3027972,"USA",2422378
1,132.0,"Northern Africa",1061422,0,1061422,796191,1326986,"EGY",1061589
1,132.0,"Russian Federation",5177289,3397550,1779739,3834593,6390988,"RUS",5112791
1,132.0,"Western Africa",162292,0,162292,122456,204093,"NGA",163275
1,132.0,"South America",1560863,1330610,230253,1174207,1957012,"BRA",1565610
1,132.0,"Northern Europe",1461423,1461423,0,1112810,1854683,"GBR",1483747
1,132.0,"Northern America",612231,612231,0,459172,765287,"CAN",612230
1,132.0,"Oceania",336024,336024,0,252018,420031,"NZL",336025
1,132.0,"Eastern Africa",144447,0,144447,108552,180921,"ETH",144737
1,132.0,"Middle Africa",57761,0,57761,43566,72610,"AGO",58088
1,132.0,"Eastern Europe",3734989,3734069,920,2795976,4659960,"POL",3727968
1,132.0,"Central Asia",1331164,1330032,1132,1013631,1689386,"UZB",1351509
1,132.0,"Southern Europe",286025,0,286025,215748,359581,"ITA",287665
1,132.0,"Central America",166829,0,166829,125121,208535,"MEX",166828
1,132.0,"Southern Asia",393027,0,393027,295667,492778,"IRN",394223
1,132.0,"Western Asia",202280,0,202280,151525,252542,"IRQ",202034
1,132.0,"Eastern Asia",776579,0,776579,582291,970485,"JPN",776388
1,132.0,"Southern Africa",50968,0,50968,38403,64005,"ZAF",51204
1,132.0,"South-Eastern Asia",478106,0,478106,358812,598021,"IDN",478417
1,132.0,"Caribbean",148668,0,148668,111500,185833,"CUB",148667
1,133.0,"Pakistan",1406969,1173692,233277,1049896,1749827,"PAK",1399862
1,133.0,"India",4766706,4724297,42409,3612177,6020296,"IND",4816237
1,133.0,"Western Europe",2407132,2406938,194,1805272,3008787,"NLD",2407030
1,133.0,"China",9092812,7735873,1356939,6760551,11267586,"CPR",9014069
1,133.0,"United States of America",2422379,2422379,0,1816783,3027972,"USA",2422378
1,133.0,"Northern Africa",1058310,0,1058310,796191,1326986,"EGY",1061589
1,133.0,"Russian Federation",5235592,3396667,1838925,3834593,6390988,"RUS",5112791
1,133.0,"Western Africa",161637,0,161637,122456,204093,"NGA",163275
1,133.0,"South America",1564367,1327303,237064,1174207,1957012,"BRA",1565610
1,133.0,"Northern Europe",1493084,1488782,4302,1112810,1854683,"GBR",1483747
1,133.0,"Northern America",612231,612231,0,459172,765287,"CAN",612230
1,133.0,"Oceania",336024,336024,0,252018,420031,"NZL",336025
1,133.0,"Eastern Africa",142218,0,142218,108552,180921,"ETH",144737
1,133.0,"Middle Africa",57385,0,57385,43566,72610,"AGO",58088
1,133.0,"Eastern Europe",3635912,3635309,603,2795976,4659960,"POL",3727968
1,133.0,"Central Asia",1370264,1363997,6267,1013631,1689386,"UZB",1351509
1,133.0,"Southern Europe",284312,0,284312,215748,359581,"ITA",287665
1,133.0,"Central America",166829,0,166829,125121,208535,"MEX",166828
1,133.0,"Southern Asia",388112,0,388112,295667,492778,"IRN",394223
1,133.0,"Western Asia",197349,0,197349,151525,252542,"IRQ",202034
1,133.0,"Eastern Asia",767355,0,767355,582291,970485,"JPN",776388
1,133.0,"Southern Africa",50972,0,50972,38403,64005,"ZAF",51204
1,133.0,"South-Eastern Asia",478070,0,478070,358812,598021,"IDN",478417
1,133.0,"Caribbean",148668,0,148668,111500,185833,"CUB",148667
1,134.0,"Pakistan",1405593,1170566,235027,1049896,1749827,"PAK",1399862
1,134.0,"India",4790411,4730774,59637,3612177,6020296,"IND",4816237
1,134.0,"Western Europe",2407008,2407008,0,1805272,3008787,"NLD",2407030
1,134.0,"China",9177682,7762707,1414975,6760551,11267586,"CPR",9014069
1,134.0,"United States of America",2422379,2422379,0,1816783,3027972,"USA",2422378
1,134.0,"Northern Africa",1062105,0,1062105,796191,1326986,"EGY",1061589
1,134.0,"Russian Federation",5266463,3397705,1868758,3834593,6390988,"RUS",5112791
1,134.0,"Western Africa",164244,0,164244,122456,204093,"NGA",163275
1,134.0,"South America",1562094,1321857,240237,1174207,1957012,"BRA",1565610
1,134.0,"Northern Europe",1467441,1464758,2683,1112810,1854683,"GBR",1483747
1,134.0,"Northern America",612231,612231,0,459172,765287,"CAN",612230
1,134.0,"Oceania",336024,336024,0,252018,420031,"NZL",336025
1,134.0,"Eastern Africa",145636,0,145636,108552,180921,"ETH",144737
1,134.0,"Middle Africa",58520,0,58520,43566,72610,"AGO",58088
1,134.0,"Eastern Europe",3798466,3789020,9446,2795976,4659960,"POL",3727968
1,134.0,"Central Asia",1298377,1296752,1625,1013631,1689386,"UZB",1351509
1,134.0,"Southern Europe",289772,0,289772,215748,359581,"ITA",287665
1,134.0,"Central America",166829,0,166829,125121,208535,"MEX",166828
1,134.0,"Southern Asia",395517,0,395517,295667,492778,"IRN",394223
1,134.0,"Western Asia",204712,0,204712,151525,252542,"IRQ",202034
1,134.0,"Eastern Asia",782813,0,782813,582291,970485,"JPN",776388
1,134.0,"Southern Africa",50857,0,50857,38403,64005,"ZAF",51204
1,134.0,"South-Eastern Asia",478239,0,478239,358812,598021,"IDN",478417
1,134.0,"Caribbean",148668,0,148668,111500,185833,"CUB",148667
1,135.0,"Pakistan",1401563,1167066,234497,1049896,1749827,"PAK",1399862
1,135.0,"India",4809262,4733634,75628,3612177,6020296,"IND",4816237
1,135.0,"Western Europe",2407024,2407024,0,1805272,3008787,"NLD",2407030
1,135.0,"China",9211971,7766615,1445356,6760551,11267586,"CPR",9014069
1,135.0,"United States of America",2422379,2422379,0,1816783,3027972,"USA",2422378
1,135.0,"Northern Africa",1062586,0,1062586,796191,1326986,"EGY",1061589
1,135.0,"Russian Federation",5249644,3393583,1856061,3834593,6390988,"RUS",5112791
1,135.0,"Western Africa",162764,0,162764,122456,204093,"NGA",163275
1,135.0,"South America",1571646,1322700,248946,1174207,1957012,"BRA",1565610
1,135.0,"Northern Europe",1502030,1493915,8115,1112810,1854683,"GBR",1483747
1,135.0,"Northern America",612231,612231,0,459172,765287,"CAN",612230
1,135.0,"Oceania",336024,336024,0,252018,420031,"NZL",336025
1,135.0,"Eastern Africa",143953,0,143953,108552,180921,"ETH",144737
1,135.0,"Middle Africa",57826,0,57826,43566,72610,"AGO",58088
1,135.0,"Eastern Europe",3670646,3665513,5133,2795976,4659960,"POL",3727968
1,135.0,"Central Asia",1392411,1369712,22699,1013631,1689386,"UZB",1351509
1,135.0,"Southern Europe",286409,0,286409,215748,359581,"ITA",287665
1,135.0,"Central America",166829,0,166829,125121,208535,"MEX",166828
1,135.0,"Southern Asia",392991,0,392991,295667,492778,"IRN",394223
1,135.0,"Western Asia",199771,0,199771,151525,252542,"IRQ",202034
1,135.0,"Eastern Asia",771286,0,771286,582291,970485,"JPN",776388
1,135.0,"Southern Africa",51454,0,51454,38403,64005,"ZAF",51204
1,135.0,"South-Eastern Asia",478370,0,478370,358812,598021,"IDN",478417
1,135.0,"Caribbean",148668,0,148668,111500,185833,"CUB",148667
1,136.0,"Pakistan",1422046,1176901,245145,1049896,1749827,"PAK",1399862
1,136.0,"India",4865271,4770027,95244,3612177,6020296,"IND",4816237
1,136.0,"Western Europe",2394911,2394911,0,1805272,3008787,"NLD",2407030
1,136.0,"China",9222496,7758633,1463863,6760551,11267586,"CPR",9014069
1,136.0,"United States of America",2422379,2422379,0,1816783,3027972,"USA",2422378
1,136.0,"Northern Africa",1056594,0,1056594,796191,1326986,"EGY",1061589
1,136.0,"Russian Federation",5167195,3389745,1777450,3834593,6390988,"RUS",5112791
1,136.0,"Western Africa",164338,0,164338,122456,204093,"NGA",163275
1,136.0,"South America",1581917,1332576,249341,1174207,1957012,"BRA",1565610
1,136.0,"Northern Europe",1477246,1472276,4970,1112810,1854683,"GBR",1483747
1,136.0,"Northern America",612231,612231,0,459172,765287,"CAN",612230
1,136.0,"Oceania",336024,336024,0,252018,420031,"NZL",336025
1,136.0,"Eastern Africa",145636,0,145636,108552,180921,"ETH",144737
1,136.0,"Middle Africa",58560,0,58560,43566,72610,"AGO",58088
1,136.0,"Eastern Europe",3788576,3777314,11262,2795976,4659960,"POL",3727968
1,136.0,"Central Asia",1310723,1304989,5734,1013631,1689386,"UZB",1351509
1,136.0,"Southern Europe",289872,0,289872,215748,359581,"ITA",287665
1,136.0,"Central America",166829,0,166829,125121,208535,"MEX",166828
1,136.0,"Southern Asia",395761,0,395761,295667,492778,"IRN",394223
1,136.0,"Western Asia",204459,0,204459,151525,252542,"IRQ",202034
1,136.0,"Eastern Asia",781817,0,781817,582291,970485,"JPN",776388
1,136.0,"Southern Africa",51175,0,51175,38403,64005,"ZAF",51204
1,136.0,"South-Eastern Asia",478760,0,478760,358812,598021,"IDN",478417
1,136.0,"Caribbean",148668,0,148668,111500,185833,"CUB",148667
1,137.0,"Pakistan",1386118,1176082,210036,1049896,1749827,"PAK",1399862
1,137.0,"India",4891685,4786481,105204,3612177,6020296,"IND",4816237
1,137.0,"Western Europe",2403920,2403457,463,1805272,3008787,"NLD",2407030
1,137.0,"China",9212831,7752115,1460716,6760551,11267586,"CPR",9014069
1,137.0,"United States of America",2422379,2422379,0,1816783,3027972,"USA",2422378
1,137.0,"Northern Africa",1060611,0,1060611,796191,1326986,"EGY",1061589
1,137.0,"Russian Federation",5127160,3393567,1733593,3834593,6390988,"RUS",5112791
1,137.0,"Western Africa",162091,0,162091,122456,204093,"NGA",163275
1,137.0,"South America",1573141,1334038,239103,1174207,1957012,"BRA",1565610
1,137.0,"Northern Europe",1496920,1491179,5741,1112810,1854683,"GBR",1483747
1,137.0,"Northern America",612231,612231,0,459172,765287,"CAN",612230
1,137.0,"Oceania",336024,336024,0,252018,420031,"NZL",336025
1,137.0,"Eastern Africa",143622,0,143622,108552,180921,"ETH",144737
1,137.0,"Middle Africa",57583,0,57583,43566,72610,"AGO",58088
1,137.0,"Eastern Europe",3658782,3655863,2919,2795976,4659960,"POL",3727968
1,137.0,"Central Asia",1395791,1370224,25567,1013631,1689386,"UZB",1351509
1,137.0,"Southern Europe",285213,0,285213,215748,359581,"ITA",287665
1,137.0,"Central America",166829,0,166829,125121,208535,"MEX",166828
1,137.0,"Southern Asia",392197,0,392197,295667,492778,"IRN",394223
1,137.0,"Western Asia",199185,0,199185,151525,252542,"IRQ",202034
1,137.0,"Eastern Asia",770250,0,770250,582291,970485,"JPN",776388
1,137.0,"Southern Africa",51328,0,51328,38403,64005,"ZAF",51204
1,137.0,"South-Eastern Asia",478948,0,478948,358812,598021,"IDN",478417
1,137.0,"Caribbean",148668,0,148668,111500,185833,"CUB",148667
1,138.0,"Pakistan",1412750,1190325,222425,1049896,1749827,"PAK",1399862
1,138.0,"India",4861438,4779226,82212,3612177,6020296,"IND",4816237
1,138.0,"Western Europe",2412359,2411931,428,1805272,3008787,"NLD",2407030
1,138.0,"China",9195133,7767209,1427924,6760551,11267586,"CPR",9014069
1,138.0,"United States of America",2422379,2422379,0,1816783,3027972,"USA",2422378
1,138.0,"Northern Africa",1063663,0,1063663,796191,1326986,"EGY",1061589
1,138.0,"Russian Federation",5144822,3396502,1748320,3834593,6390988,"RUS",5112791
1,138.0,"Western Africa",163058,0,163058,122456,204093,"NGA",163275
1,138.0,"South America",1581100,1344626,236474,1174207,1957012,"BRA",1565610
1,138.0,"Northern Europe",1431081,1429570,1511,1112810,1854683,"GBR",1483747
1,138.0,"Northern America",612231,612231,0,459172,765287,"CAN",612230
1,138.0,"Oceania",336024,336024,0,252018,420031,"NZL",336025
1,138.0,"Eastern Africa",147211,0,147211,108552,180921,"ETH",144737
1,138.0,"Middle Africa",58114,0,58114,43566,72610,"AGO",58088
1,138.0,"Eastern Europe",3795043,3785054,9989,2795976,4659960,"POL",3727968
1,138.0,"Central Asia",1362993,1356446,6547,1013631,1689386,"UZB",1351509
1,138.0,"Southern Europe",287854,0,287854,215748,359581,"ITA",287665
1,138.0,"Central America",166829,0,166829,125121,208535,"MEX",166828
1,138.0,"Southern Asia",400129,0,400129,295667,492778,"IRN",394223
1,138.0,"Western Asia",205721,0,205721,151525,252542,"IRQ",202034
1,138.0,"Eastern Asia",782412,0,782412,582291,970485,"JPN",776388
1,138.0,"Southern Africa",51685,0,51685,38403,64005,"ZAF",51204
1,138.0,"South-Eastern Asia",478732,0,478732,358812,598021,"IDN",478417
1,138.0,"Caribbean",148668,0,148668,111500,185833,"CUB",148667
1,139.0,"Pakistan",1415337,1195708,219629,1049896,1749827,"PAK",1399862
1,139.0,"India",4926195,4859820,66375,3612177,6020296,"IND",4816237
1,139.0,"Western Europe",2408323,2408195,128,1805272,3008787,"NLD",2407030
1,139.0,"China",8833004,7754223,1078781,6760551,11267586,"CPR",9014069
1,139.0,"United States of America",2422379,2422379,0,1816783,3027972,"USA",2422378
1,139.0,"Northern Africa",1063560,0,1063560,796191,1326986,"EGY",1061589
1,139.0,"Russian Federation",5127671,3398865,1728806,3834593,6390988,"RUS",5112791
1,139.0,"Western Africa",164537,0,164537,122456,204093,"NGA",163275
1,139.0,"South America",1463636,1344720,118916,1174207,1957012,"BRA",1565610
1,139.0,"Northern Europe",1526683,1503280,23403,1112810,1854683,"GBR",1483747
1,139.0,"Northern America",612231,612231,0,459172,765287,"CAN",612230
1,139.0,"Oceania",336024,336024,0,252018,420031,"NZL",336025
1,139.0,"Eastern Africa",144455,0,144455,108552,180921,"ETH",144737
1,139.0,"Middle Africa",58499,0,58499,43566,72610,"AGO",58088
1,139.0,"Eastern Europe",3716848,3714307,2541,2795976,4659960,"POL",3727968
1,139.0,"Central Asia",1350911,1349377,1534,1013631,1689386,"UZB",1351509
1,139.0,"Southern Europe",289608,0,289608,215748,359581,"ITA",287665
1,139.0,"Central America",166829,0,166829,125121,208535,"MEX",166828
1,139.0,"Southern Asia",393998,0,393998,295667,492778,"IRN",394223
1,139.0,"Western Asia",201493,0,201493,151525,252542,"IRQ",202034
1,139.0,"Eastern Asia",775971,0,775971,582291,970485,"JPN",776388
1,139.0,"Southern Africa",50986,0,50986,38403,64005,"ZAF",51204
1,139.0,"South-Eastern Asia",479207,0,479207,358812,598021,"IDN",478417
1,139.0,"Caribbean",148668,0,148668,111500,185833,"CUB",148667
1,140.0,"Pakistan",1307321,1192246,115075,1049896,1749827,"PAK",1399862
1,140.0,"India",4795696,4779039,16657,3612177,6020296,"IND",4816237
1,140.0,"Western Europe",2377051,2376833,218,1805272,3008787,"NLD",2407030
1,140.0,"China",8875587,7759147,1116440,6760551,11267586,"CPR",9014069
1,140.0,"United States of America",2422379,2422379,0,1816783,3027972,"USA",2422378
1,140.0,"Northern Africa",1049496,0,1049496,796191,1326986,"EGY",1061589
1,140.0,"Russian Federation",5125307,3389389,1735918,3834593,6390988,"RUS",5112791
1,140.0,"Western Africa",163824,0,163824,122456,204093,"NGA",163275
1,140.0,"South America",1526157,1348608,177549,1174207,1957012,"BRA",1565610
1,140.0,"Northern Europe",1494744,1488860,5884,1112810,1854683,"GBR",1483747
1,140.0,"Northern America",612231,612231,0,459172,765287,"CAN",612230
1,140.0,"Oceania",336024,336024,0,252018,420031,"NZL",336025
1,140.0,"Eastern Africa",144456,0,144456,108552,180921,"ETH",144737
1,140.0,"Middle Africa",58353,0,58353,43566,72610,"AGO",58088
1,140.0,"Eastern Europe",3753275,3750295,2980,2795976,4659960,"POL",3727968
1,140.0,"Central Asia",1313619,1313465,154,1013631,1689386,"UZB",1351509
1,140.0,"Southern Europe",288759,0,288759,215748,359581,"ITA",287665
1,140.0,"Central America",166829,0,166829,125121,208535,"MEX",166828
1,140.0,"Southern Asia",392364,0,392364,295667,492778,"IRN",394223
1,140.0,"Western Asia",203071,0,203071,151525,252542,"IRQ",202034
1,140.0,"Eastern Asia",777255,0,777255,582291,970485,"JPN",776388
1,140.0,"Southern Africa",51038,0,51038,38403,64005,"ZAF",51204
1,140.0,"South-Eastern Asia",478266,0,478266,358812,598021,"IDN",478417
1,140.0,"Caribbean",148668,0,148668,111500,185833,"CUB",148667
1,141.0,"Pakistan",1383412,1196343,187069,1049896,1749827,"PAK",1399862
1,141.0,"India",4786420,4779417,7003,3612177,6020296,"IND",4816237
1,141.0,"Western Europe",2429817,2425731,4086,1805272,3008787,"NLD",2407030
1,141.0,"China",8919007,7752895,1166112,6760551,11267586,"CPR",9014069
1,141.0,"United States of America",2422379,2422379,0,1816783,3027972,"USA",2422378
1,141.0,"Northern Africa",1071579,0,1071579,796191,1326986,"EGY",1061589
1,141.0,"Russian Federation",5118899,3385373,1733526,3834593,6390988,"RUS",5112791
1,141.0,"Western Africa",163672,0,163672,122456,204093,"NGA",163275
1,141.0,"South America",1582985,1349343,233642,1174207,1957012,"BRA",1565610
1,141.0,"Northern Europe",1486464,1485061,1403,1112810,1854683,"GBR",1483747
1,141.0,"Northern America",612231,612231,0,459172,765287,"CAN",612230
1,141.0,"Oceania",336024,336024,0,252018,420031,"NZL",336025
1,141.0,"Eastern Africa",145383,0,145383,108552,180921,"ETH",144737
1,141.0,"Middle Africa",58194,0,58194,43566,72610,"AGO",58088
1,141.0,"Eastern Europe",3725034,3723670,1364,2795976,4659960,"POL",3727968
1,141.0,"Central Asia",1383125,1367929,15196,1013631,1689386,"UZB",1351509
1,141.0,"Southern Europe",288275,0,288275,215748,359581,"ITA",287665
1,141.0,"Central America",166829,0,166829,125121,208535,"MEX",166828
1,141.0,"Southern Asia",397235,0,397235,295667,492778,"IRN",394223
1,141.0,"Western Asia",202130,0,202130,151525,252542,"IRQ",202034
1,141.0,"Eastern Asia",777402,0,777402,582291,970485,"JPN",776388
1,141.0,"Southern Africa",51661,0,51661,38403,64005,"ZAF",51204
1,141.0,"South-Eastern Asia",478202,0,478202,358812,598021,"IDN",478417
1,141.0,"Caribbean",148668,0,148668,111500,185833,"CUB",148667
1,142.0,"Pakistan",1442924,1196845,246079,1049896,1749827,"PAK",1399862
1,142.0,"India",4795940,4788993,6947,3612177,6020296,"IND",4816237
1,142.0,"Western Europe",2418963,2417058,1905,1805272,3008787,"NLD",2407030
1,142.0,"China",8967563,7751726,1215837,6760551,11267586,"CPR",9014069
1,142.0,"United States of America",2422379,2422379,0,1816783,3027972,"USA",2422378
1,142.0,"Northern Africa",1066000,0,1066000,796191,1326986,"EGY",1061589
1,142.0,"Russian Federation",5114042,3373846,1740196,3834593,6390988,"RUS",5112791
1,142.0,"Western Africa",162668,0,162668,122456,204093,"NGA",163275
1,142.0,"South America",1618431,1349687,268744,1174207,1957012,"BRA",1565610
1,142.0,"Northern Europe",1472982,1472879,103,1112810,1854683,"GBR",1483747
1,142.0,"Northern America",612231,612231,0,459172,765287,"CAN",612230
1,142.0,"Oceania",336024,336024,0,252018,420031,"NZL",336025
1,142.0,"Eastern Africa",144669,0,144669,108552,180921,"ETH",144737
1,142.0,"Middle Africa",57850,0,57850,43566,72610,"AGO",58088
1,142.0,"Eastern Europe",3717772,3716447,1325,2795976,4659960,"POL",3727968
1,142.0,"Central Asia",1356112,1352354,3758,1013631,1689386,"UZB",1351509
1,142.0,"Southern Europe",286751,0,286751,215748,359581,"ITA",287665
1,142.0,"Central America",166829,0,166829,125121,208535,"MEX",166828
1,142.0,"Southern Asia",393983,0,393983,295667,492778,"IRN",394223
1,142.0,"Western Asia",201549,0,201549,151525,252542,"IRQ",202034
1,142.0,"Eastern Asia",775869,0,775869,582291,970485,"JPN",776388
1,142.0,"Southern Africa",51245,0,51245,38403,64005,"ZAF",51204
1,142.0,"South-Eastern Asia",478272,0,478272,358812,598021,"IDN",478417
1,142.0,"Caribbean",148668,0,148668,111500,185833,"CUB",148667
1,143.0,"Pakistan",1453941,1197196,256745,1049896,1749827,"PAK",1399862
1,143.0,"India",4810662,4802028,8634,3612177,6020296,"IND",4816237
1,143.0,"Western Europe",2373648,2373205,443,1805272,3008787,"NLD",2407030
1,143.0,"China",9016363,7760267,1256096,6760551,11267586,"CPR",9014069
1,143.0,"United States of America",2422379,2422379,0,1816783,3027972,"USA",2422378
1,143.0,"Northern Africa",1048706,0,1048706,796191,1326986,"EGY",1061589
1,143.0,"Russian Federation",5111152,3372772,1738380,3834593,6390988,"RUS",5112791
1,143.0,"Western Africa",163693,0,163693,122456,204093,"NGA",163275
1,143.0,"South America",1603924,1351333,252591,1174207,1957012,"BRA",1565610
1,143.0,"Northern Europe",1492261,1491536,725,1112810,1854683,"GBR",1483747
1,143.0,"Northern America",612231,612231,0,459172,765287,"CAN",612230
1,143.0,"Oceania",336024,336024,0,252018,420031,"NZL",336025
1,143.0,"Eastern Africa",143665,0,143665,108552,180921,"ETH",144737
1,143.0,"Middle Africa",58282,0,58282,43566,72610,"AGO",58088
1,143.0,"Eastern Europe",3744105,3742841,1264,2795976,4659960,"POL",3727968
1,143.0,"Central Asia",1304646,1303982,664,1013631,1689386,"UZB",1351509
1,143.0,"Southern Europe",288369,0,288369,215748,359581,"ITA",287665
1,143.0,"Central America",166829,0,166829,125121,208535,"MEX",166828
1,143.0,"Southern Asia",390156,0,390156,295667,492778,"IRN",394223
1,143.0,"Western Asia",202802,0,202802,151525,252542,"IRQ",202034
1,143.0,"Eastern Asia",776310,0,776310,582291,970485,"JPN",776388
1,143.0,"Southern Africa",50672,0,50672,38403,64005,"ZAF",51204
1,143.0,"South-Eastern Asia",478380,0,478380,358812,598021,"IDN",478417
1,143.0,"Caribbean",148668,0,148668,111500,185833,"CUB",148667
1,144.0,"Pakistan",1321163,1171920,149243,1049896,1749827,"PAK",1399862
1,144.0,"India",4814703,4805624,9079,3612177,6020296,"IND",4816237
1,144.0,"Western Europe",2434884,2430696,4188,1805272,3008787,"NLD",2407030
1,144.0,"China",9058739,7762471,1296268,6760551,11267586,"CPR",9014069
1,144.0,"United States of America",2422379,2422379,0,1816783,3027972,"USA",2422378
1,144.0,"Northern Africa",1068215,0,1068215,796191,1326986,"EGY",1061589
1,144.0,"Russian Federation",5112351,3382273,1730078,3834593,6390988,"RUS",5112791
1,144.0,"Western Africa",160956,0,160956,122456,204093,"NGA",163275
1,144.0,"South America",1568260,1350549,217711,1174207,1957012,"BRA",1565610
1,144.0,"Northern Europe",1485932,1485737,195,1112810,1854683,"GBR",1483747
1,144.0,"Northern America",612231,612231,0,459172,765287,"CAN",612230
1,144.0,"Oceania",336024,336024,0,252018,420031,"NZL",336025
1,144.0,"Eastern Africa",143123,0,143123,108552,180921,"ETH",144737
1,144.0,"Middle Africa",57253,0,57253,43566,72610,"AGO",58088
1,144.0,"Eastern Europe",3628793,3628274,519,2795976,4659960,"POL",3727968
1,144.0,"Central Asia",1390838,1368693,22145,1013631,1689386,"UZB",1351509
1,144.0,"Southern Europe",283186,0,283186,215748,359581,"ITA",287665
1,144.0,"Central America",166829,0,166829,125121,208535,"MEX",166828
1,144.0,"Southern Asia",391235,0,391235,295667,492778,"IRN",394223
1,144.0,"Western Asia",196957,0,196957,151525,252542,"IRQ",202034
1,144.0,"Eastern Asia",768327,0,768327,582291,970485,"JPN",776388
1,144.0,"Southern Africa",51155,0,51155,38403,64005,"ZAF",51204
1,144.0,"South-Eastern Asia",478406,0,478406,358812,598021,"IDN",478417
1,144.0,"Caribbean",148668,0,148668,111500,185833,"CUB",148667
1,145.0,"Pakistan",1404969,1189304,215665,1049896,1749827,"PAK",1399862
1,145.0,"India",4791189,4785557,5632,3612177,6020296,"IND",4816237
1,145.0,"Western Europe",2414161,2412279,1882,1805272,3008787,"NLD",2407030
1,145.0,"China",9074885,7747281,1327604,6760551,11267586,"CPR",9014069
1,145.0,"United States of America",2422379,2422379,0,1816783,3027972,"USA",2422378
1,145.0,"Northern Africa",1065074,0,1065074,796191,1326986,"EGY",1061589
1,145.0,"Russian Federation",4772807,3374667,1398140,3834593,6390988,"RUS",5112791
1,145.0,"Western Africa",162836,0,162836,122456,204093,"NGA",163275
1,145.0,"South America",1545274,1347592,197682,1174207,1957012,"BRA",1565610
1,145.0,"Northern Europe",1424485,1424485,0,1112810,1854683,"GBR",1483747
1,145.0,"Northern America",612231,612231,0,459172,765287,"CAN",612230
1,145.0,"Oceania",336024,336024,0,252018,420031,"NZL",336025
1,145.0,"Eastern Africa",146210,0,146210,108552,180921,"ETH",144737
1,145.0,"Middle Africa",57944,0,57944,43566,72610,"AGO",58088
1,145.0,"Eastern Europe",3806187,3794836,11351,2795976,4659960,"POL",3727968
1,145.0,"Central Asia",1327678,1321891,5787,1013631,1689386,"UZB",1351509
1,145.0,"Southern Europe",287884,0,287884,215748,359581,"ITA",287665
1,145.0,"Central America",166829,0,166829,125121,208535,"MEX",166828
1,145.0,"Southern Asia",396980,0,396980,295667,492778,"IRN",394223
1,145.0,"Western Asia",205711,0,205711,151525,252542,"IRQ",202034
1,145.0,"Eastern Asia",782825,0,782825,582291,970485,"JPN",776388
1,145.0,"Southern Africa",51357,0,51357,38403,64005,"ZAF",51204
1,145.0,"South-Eastern Asia",478236,0,478236,358812,598021,"IDN",478417
1,145.0,"Caribbean",148668,0,148668,111500,185833,"CUB",148667
1,146.0,"Pakistan",1431884,1188380,243504,1049896,1749827,"PAK",1399862
1,146.0,"India",4784877,4775577,9300,3612177,6020296,"IND",4816237
1,146.0,"Western Europe",2408840,2408371,469,1805272,3008787,"NLD",2407030
1,146.0,"China",9055024,7730871,1324153,6760551,11267586,"CPR",9014069
1,146.0,"United States of America",2422379,2422379,0,1816783,3027972,"USA",2422378
1,146.0,"Northern Africa",1064694,0,1064694,796191,1326986,"EGY",1061589
1,146.0,"Russian Federation",4946451,3386895,1559556,3834593,6390988,"RUS",5112791
1,146.0,"Western Africa",165247,0,165247,122456,204093,"NGA",163275
1,146.0,"South America",1549799,1346864,202935,1174207,1957012,"BRA",1565610
1,146.0,"Northern Europe",1513469,1493698,19771,1112810,1854683,"GBR",1483747
1,146.0,"Northern America",612231,612231,0,459172,765287,"CAN",612230
1,146.0,"Oceania",336024,336024,0,252018,420031,"NZL",336025
1,146.0,"Eastern Africa",146276,0,146276,108552,180921,"ETH",144737
1,146.0,"Middle Africa",58764,0,58764,43566,72610,"AGO",58088
1,146.0,"Eastern Europe",3747943,3742247,5696,2795976,4659960,"POL",3727968
1,146.0,"Central Asia",1379528,1365595,13933,1013631,1689386,"UZB",1351509
1,146.0,"Southern Europe",290891,0,290891,215748,359581,"ITA",287665
1,146.0,"Central America",166829,0,166829,125121,208535,"MEX",166828
1,146.0,"Southern Asia",398998,0,398998,295667,492778,"IRN",394223
1,146.0,"Western Asia",203359,0,203359,151525,252542,"IRQ",202034
1,146.0,"Eastern Asia",779269,0,779269,582291,970485,"JPN",776388
1,146.0,"Southern Africa",51659,0,51659,38403,64005,"ZAF",51204
1,146.0,"South-Eastern Asia",478194,0,478194,358812,598021,"IDN",478417
1,146.0,"Caribbean",148668,0,148668,111500,185833,"CUB",148667
1,147.0,"Pakistan",1436747,1185630,251117,1049896,1749827,"PAK",1399862
1,147.0,"India",4783101,4764829,18272,3612177,6020296,"IND",4816237
1,147.0,"Western Europe",2407372,2407372,0,1805272,3008787,"NLD",2407030
1,147.0,"China",9067188,7725211,1341977,6760551,11267586,"CPR",9014069
1,147.0,"United States of America",2422379,2422379,0,1816783,3027972,"USA",2422378
1,147.0,"Northern Africa",1062941,0,1062941,796191,1326986,"EGY",1061589
1,147.0,"Russian Federation",5101380,3395731,1705649,3834593,6390988,"RUS",5112791
1,147.0,"Western Africa",164318,0,164318,122456,204093,"NGA",163275
1,147.0,"South America",1568947,1345784,223163,1174207,1957012,"BRA",1565610
1,147.0,"Northern Europe",1506528,1489387,17141,1112810,1854683,"GBR",1483747
1,147.0,"Northern America",612231,612231,0,459172,765287,"CAN",612230
1,147.0,"Oceania",336024,336024,0,252018,420031,"NZL",336025
1,147.0,"Eastern Africa",144693,0,144693,108552,180921,"ETH",144737
1,147.0,"Middle Africa",58447,0,58447,43566,72610,"AGO",58088
1,147.0,"Eastern Europe",3732855,3728807,4048,2795976,4659960,"POL",3727968
1,147.0,"Central Asia",1341501,1338106,3395,1013631,1689386,"UZB",1351509
1,147.0,"Southern Europe",289264,0,289264,215748,359581,"ITA",287665
1,147.0,"Central America",166829,0,166829,125121,208535,"MEX",166828
1,147.0,"Southern Asia",393875,0,393875,295667,492778,"IRN",394223
1,147.0,"Western Asia",202296,0,202296,151525,252542,"IRQ",202034
1,147.0,"Eastern Asia",776935,0,776935,582291,970485,"JPN",776388
1,147.0,"Southern Africa",51058,0,51058,38403,64005,"ZAF",51204
1,147.0,"South-Eastern Asia",478180,0,478180,358812,598021,"IDN",478417
1,147.0,"Caribbean",148668,0,148668,111500,185833,"CUB",148667
1,148.0,"Pakistan",1362466,1183139,179327,1049896,1749827,"PAK",1399862
1,148.0,"India",4807453,4776356,31097,3612177,6020296,"IND",4816237
1,148.0,"Western Europe",2401060,2401060,0,1805272,3008787,"NLD",2407030
1,148.0,"China",9069997,7713155,1356842,6760551,11267586,"CPR",9014069
1,148.0,"United States of America",2422379,2422379,0,1816783,3027972,"USA",2422378
1,148.0,"Northern Africa",1059546,0,1059546,796191,1326986,"EGY",1061589
1,148.0,"Russian Federation",5205461,3395514,1809947,3834593,6390988,"RUS",5112791
1,148.0,"Western Africa",163519,0,163519,122456,204093,"NGA",163275
1,148.0,"South America",1580961,1342862,238099,1174207,1957012,"BRA",1565610
1,148.0,"Northern Europe",1489475,1485238,4237,1112810,1854683,"GBR",1483747
1,148.0,"Northern America",612231,612231,0,459172,765287,"CAN",612230
1,148.0,"Oceania",336024,336024,0,252018,420031,"NZL",336025
1,148.0,"Eastern Africa",145180,0,145180,108552,180921,"ETH",144737
1,148.0,"Middle Africa",58171,0,58171,43566,72610,"AGO",58088
1,148.0,"Eastern Europe",3729167,3725283,3884,2795976,4659960,"POL",3727968
1,148.0,"Central Asia",1365903,1360350,5553,1013631,1689386,"UZB",1351509
1,148.0,"Southern Europe",288022,0,288022,215748,359581,"ITA",287665
1,148.0,"Central America",166829,0,166829,125121,208535,"MEX",166828
1,148.0,"Southern Asia",395756,0,395756,295667,492778,"IRN",394223
1,148.0,"Western Asia",202161,0,202161,151525,252542,"IRQ",202034
1,148.0,"Eastern Asia",776771,0,776771,582291,970485,"JPN",776388
1,148.0,"Southern Africa",51340,0,51340,38403,64005,"ZAF",51204
1,148.0,"South-Eastern Asia",478356,0,478356,358812,598021,"IDN",478417
1,148.0,"Caribbean",148668,0,148668,111500,185833,"CUB",148667
1,149.0,"Pakistan",1399040,1186149,212891,1049896,1749827,"PAK",1399862
1,149.0,"India",4814012,4771102,42910,3612177,6020296,"IND",4816237
1,149.0,"Western Europe",2405574,2405365,209,1805272,3008787,"NLD",2407030
1,149.0,"China",9067144,7703488,1363656,6760551,11267586,"CPR",9014069
1,149.0,"United States of America",2422379,2422379,0,1816783,3027972,"USA",2422378
1,149.0,"Northern Africa",1060463,0,1060463,796191,1326986,"EGY",1061589
1,149.0,"Russian Federation",5266029,3400457,1865572,3834593,6390988,"RUS",5112791
1,149.0,"Western Africa",162211,0,162211,122456,204093,"NGA",163275
1,149.0,"South America",1586831,1342016,244815,1174207,1957012,"BRA",1565610
1,149.0,"Northern Europe",1485103,1484131,972,1112810,1854683,"GBR",1483747
1,149.0,"Northern America",612231,612231,0,459172,765287,"CAN",612230
1,149.0,"Oceania",336024,336024,0,252018,420031,"NZL",336025
1,149.0,"Eastern Africa",143583,0,143583,108552,180921,"ETH",144737
1,149.0,"Middle Africa",57716,0,57716,43566,72610,"AGO",58088
1,149.0,"Eastern Europe",3690760,3689669,1091,2795976,4659960,"POL",3727968
1,149.0,"Central Asia",1351734,1350372,1362,1013631,1689386,"UZB",1351509
1,149.0,"Southern Europe",285621,0,285621,215748,359581,"ITA",287665
1,149.0,"Central America",166829,0,166829,125121,208535,"MEX",166828
1,149.0,"Southern Asia",391487,0,391487,295667,492778,"IRN",394223
1,149.0,"Western Asia",200112,0,200112,151525,252542,"IRQ",202034
1,149.0,"Eastern Asia",771842,0,771842,582291,970485,"JPN",776388
1,149.0,"Southern Africa",50954,0,50954,38403,64005,"ZAF",51204
1,149.0,"South-Eastern Asia",478398,0,478398,358812,598021,"IDN",478417
1,149.0,"Caribbean",148668,0,148668,111500,185833,"CUB",148667
1,150.0,"Pakistan",1421365,1186672,234693,1049896,1749827,"PAK",1399862
1,150.0,"India",4865262,4812215,53047,3612177,6020296,"IND",4816237
1,150.0,"Western Europe",2400566,2400246,320,1805272,3008787,"NLD",2407030
1,150.0,"China",9008554,7688754,1319800,6760551,11267586,"CPR",9014069
1,150.0,"United States of America",2422379,2422379,0,1816783,3027972,"USA",2422378
1,150.0,"Northern Africa",1054170,0,1054170,796191,1326986,"EGY",1061589
1,150.0,"Russian Federation",5265371,3393406,1871965,3834593,6390988,"RUS",5112791
1,150.0,"Western Africa",161318,0,161318,122456,204093,"NGA",163275
1,150.0,"South America",1563934,1340046,223888,1174207,1957012,"BRA",1565610
1,150.0,"Northern Europe",1405540,1405421,119,1112810,1854683,"GBR",1483747
1,150.0,"Northern America",612231,612231,0,459172,765287,"CAN",612230
1,150.0,"Oceania",336024,336024,0,252018,420031,"NZL",336025
1,150.0,"Eastern Africa",144315,0,144315,108552,180921,"ETH",144737
1,150.0,"Middle Africa",57431,0,57431,43566,72610,"AGO",58088
1,150.0,"Eastern Europe",3756037,3753166,2871,2795976,4659960,"POL",3727968
1,150.0,"Central Asia",1303815,1303488,327,1013631,1689386,"UZB",1351509
1,150.0,"Southern Europe",285204,0,285204,215748,359581,"ITA",287665
1,150.0,"Central America",166829,0,166829,125121,208535,"MEX",166828
1,150.0,"Southern Asia",391029,0,391029,295667,492778,"IRN",394223
1,150.0,"Western Asia",202850,0,202850,151525,252542,"IRQ",202034
1,150.0,"Eastern Asia",777836,0,777836,582291,970485,"JPN",776388
1,150.0,"Southern Africa",50684,0,50684,38403,64005,"ZAF",51204
1,150.0,"South-Eastern Asia",478766,0,478766,358812,598021,"IDN",478417
1,150.0,"Caribbean",148668,0,148668,111500,185833,"CUB",148667
1,151.0,"Pakistan",1398572,1185985,212587,1049896,1749827,"PAK",1399862
1,151.0,"India",4853956,4803284,50672,3612177,6020296,"IND",4816237
1,151.0,"Western Europe",2374994,2374424,570,1805272,3008787,"NLD",2407030
1,151.0,"China",9021674,7746533,1275141,6760551,11267586,"CPR",9014069
1,151.0,"United States of America",2422379,2422379,0,1816783,3027972,"USA",2422378
1,151.0,"Northern Africa",1051903,0,1051903,796191,1326986,"EGY",1061589
1,151.0,"Russian Federation",5148220,3396558,1751662,3834593,6390988,"RUS",5112791
1,151.0,"Western Africa",163407,0,163407,122456,204093,"NGA",163275
1,151.0,"South America",1568561,1346351,222210,1174207,1957012,"BRA",1565610
1,151.0,"Northern Europe",1542482,1511612,30870,1112810,1854683,"GBR",1483747
1,151.0,"Northern America",612231,612231,0,459172,765287,"CAN",612230
1,151.0,"Oceania",336024,336024,0,252018,420031,"NZL",336025
1,151.0,"Eastern Africa",143833,0,143833,108552,180921,"ETH",144737
1,151.0,"Middle Africa",58081,0,58081,43566,72610,"AGO",58088
1,151.0,"Eastern Europe",3669293,3668611,682,2795976,4659960,"POL",3727968
1,151.0,"Central Asia",1390510,1371742,18768,1013631,1689386,"UZB",1351509
1,151.0,"Southern Europe",286998,0,286998,215748,359581,"ITA",287665
1,151.0,"Central America",166829,0,166829,125121,208535,"MEX",166828
1,151.0,"Southern Asia",393987,0,393987,295667,492778,"IRN",394223
1,151.0,"Western Asia",199547,0,199547,151525,252542,"IRQ",202034
1,151.0,"Eastern Asia",770954,0,770954,582291,970485,"JPN",776388
1,151.0,"Southern Africa",51323,0,51323,38403,64005,"ZAF",51204
1,151.0,"South-Eastern Asia",478685,0,478685,358812,598021,"IDN",478417
1,151.0,"Caribbean",148668,0,148668,111500,185833,"CUB",148667
1,152.0,"Pakistan",1420566,1196035,224531,1049896,1749827,"PAK",1399862
1,152.0,"India",4826454,4803012,23442,3612177,6020296,"IND",4816237
1,152.0,"Western Europe",2441577,2438460,3117,1805272,3008787,"NLD",2407030
1,152.0,"China",9051863,7751538,1300325,6760551,11267586,"CPR",9014069
1,152.0,"United States of America",2422379,2422379,0,1816783,3027972,"USA",2422378
1,152.0,"Northern Africa",1077195,0,1077195,796191,1326986,"EGY",1061589
1,152.0,"Russian Federation",5141811,3395226,1746585,3834593,6390988,"RUS",5112791
1,152.0,"Western Africa",165376,0,165376,122456,204093,"NGA",163275
1,152.0,"South America",1556070,1350784,205286,1174207,1957012,"BRA",1565610
1,152.0,"Northern Europe",1495334,1487335,7999,1112810,1854683,"GBR",1483747
1,152.0,"Northern America",612231,612231,0,459172,765287,"CAN",612230
1,152.0,"Oceania",336024,336024,0,252018,420031,"NZL",336025
1,152.0,"Eastern Africa",146640,0,146640,108552,180921,"ETH",144737
1,152.0,"Middle Africa",58840,0,58840,43566,72610,"AGO",58088
1,152.0,"Eastern Europe",3779021,3775466,3555,2795976,4659960,"POL",3727968
1,152.0,"Central Asia",1361676,1356778,4898,1013631,1689386,"UZB",1351509
1,152.0,"Southern Europe",291460,0,291460,215748,359581,"ITA",287665
1,152.0,"Central America",166829,0,166829,125121,208535,"MEX",166828
1,152.0,"Southern Asia",399141,0,399141,295667,492778,"IRN",394223
1,152.0,"Western Asia",204967,0,204967,151525,252542,"IRQ",202034
1,152.0,"Eastern Asia",782780,0,782780,582291,970485,"JPN",776388
1,152.0,"Southern Africa",51812,0,51812,38403,64005,"ZAF",51204
1,152.0,"South-Eastern Asia",478487,0,478487,358812,598021,"IDN",478417
1,152.0,"Caribbean",148668,0,148668,111500,185833,"CUB",148667
1,153.0,"Pakistan",1394661,1195575,199086,1049896,1749827,"PAK",1399862
1,153.0,"India",4843442,4820142,23300,3612177,6020296,"IND",4816237
1,153.0,"Western Europe",2415813,2415059,754,1805272,3008787,"NLD",2407030
1,153.0,"China",9059996,7754255,1305741,6760551,11267586,"CPR",9014069
1,153.0,"United States of America",2422379,2422379,0,1816783,3027972,"USA",2422378
1,153.0,"Northern Africa",1063095,0,1063095,796191,1326986,"EGY",1061589
1,153.0,"Russian Federation",5144575,3394255,1750320,3834593,6390988,"RUS",5112791
1,153.0,"Western Africa",162130,0,162130,122456,204093,"NGA",163275
1,153.0,"South America",1563196,1349624,213572,1174207,1957012,"BRA",1565610
1,153.0,"Northern Europe",1490188,1487267,2921,1112810,1854683,"GBR",1483747
1,153.0,"Northern America",612231,612231,0,459172,765287,"CAN",612230
1,153.0,"Oceania",336024,336024,0,252018,420031,"NZL",336025
1,153.0,"Eastern Africa",143570,0,143570,108552,180921,"ETH",144737
1,153.0,"Middle Africa",57679,0,57679,43566,72610,"AGO",58088
1,153.0,"Eastern Europe",3684517,3683515,1002,2795976,4659960,"POL",3727968
1,153.0,"Central Asia",1354024,1352862,1162,1013631,1689386,"UZB",1351509
1,153.0,"Southern Europe",285381,0,285381,215748,359581,"ITA",287665
1,153.0,"Central America",166829,0,166829,125121,208535,"MEX",166828
1,153.0,"Southern Asia",391703,0,391703,295667,492778,"IRN",394223
1,153.0,"Western Asia",199767,0,199767,151525,252542,"IRQ",202034
1,153.0,"Eastern Asia",772236,0,772236,582291,970485,"JPN",776388
1,153.0,"Southern Africa",50994,0,50994,38403,64005,"ZAF",51204
1,153.0,"South-Eastern Asia",478613,0,478613,358812,598021,"IDN",478417
1,153.0,"Caribbean",148668,0,148668,111500,185833,"CUB",148667
1,154.0,"Pakistan",1405655,1197743,207912,1049896,1749827,"PAK",1399862
1,154.0,"India",4823230,4807496,15734,3612177,6020296,"IND",4816237
1,154.0,"Western Europe",2409146,2408888,258,1805272,3008787,"NLD",2407030
1,154.0,"China",9071070,7757860,1313210,6760551,11267586,"CPR",9014069
1,154.0,"United States of America",2422379,2422379,0,1816783,3027972,"USA",2422378
1,154.0,"Northern Africa",1063284,0,1063284,796191,1326986,"EGY",1061589
1,154.0,"Russian Federation",5150433,3398859,1751574,3834593,6390988,"RUS",5112791
1,154.0,"Western Africa",164798,0,164798,122456,204093,"NGA",163275
1,154.0,"South America",1568531,1351554,216977,1174207,1957012,"BRA",1565610
1,154.0,"Northern Europe",1485302,1484648,654,1112810,1854683,"GBR",1483747
1,154.0,"Northern America",612231,612231,0,459172,765287,"CAN",612230
1,154.0,"Oceania",335178,335178,0,252018,420031,"NZL",336025
1,154.0,"Eastern Africa",144105,0,144105,108552,180921,"ETH",144737
1,154.0,"Middle Africa",58634,0,58634,43566,72610,"AGO",58088
1,154.0,"Eastern Europe",3773324,3768257,5067,2795976,4659960,"POL",3727968
1,154.0,"Central Asia",1294130,1294016,114,1013631,1689386,"UZB",1351509
1,154.0,"Southern Europe",290530,0,290530,215748,359581,"ITA",287665
1,154.0,"Central America",166828,0,166828,125121,208535,"MEX",166828
1,154.0,"Southern Asia",391263,0,391263,295667,492778,"IRN",394223
1,154.0,"Western Asia",203517,0,203517,151525,252542,"IRQ",202034
1,154.0,"Eastern Asia",778449,0,778449,582291,970485,"JPN",776388
1,154.0,"Southern Africa",50565,0,50565,38403,64005,"ZAF",51204
1,154.0,"South-Eastern Asia",477361,0,477361,358812,598021,"IDN",478417
1,154.0,"Caribbean",148666,0,148666,111500,185833,"CUB",148667
1,155.0,"Pakistan",1404847,1197418,207429,1049896,1749827,"PAK",1399862
1,155.0,"India",4818153,4807782,10371,3612177,6020296,"IND",4816237
1,155.0,"Western Europe",2407569,2407311,258,1805272,3008787,"NLD",2407030
1,155.0,"China",9050135,7749646,1300489,6760551,11267586,"CPR",9014069
1,155.0,"United States of America",2422379,2422379,0,1816783,3027972,"USA",2422378
1,155.0,"Northern Africa",1063264,0,1063264,796191,1326986,"EGY",1061589
1,155.0,"Russian Federation",5132081,3392112,1739969,3834593,6390988,"RUS",5112791
1,155.0,"Western Africa",163668,0,163668,122456,204093,"NGA",163275
1,155.0,"South America",1573430,1351337,222093,1174207,1957012,"BRA",1565610
1,155.0,"Northern Europe",1484081,1483978,103,1112810,1854683,"GBR",1483747
1,155.0,"Northern America",612231,612231,0,459172,765287,"CAN",612230
1,155.0,"Oceania",336652,336652,0,252018,420031,"NZL",336025
1,155.0,"Eastern Africa",146561,0,146561,108552,180921,"ETH",144737
1,155.0,"Middle Africa",58231,0,58231,43566,72610,"AGO",58088
1,155.0,"Eastern Europe",3739576,3735940,3636,2795976,4659960,"POL",3727968
1,155.0,"Central Asia",1394971,1361694,33277,1013631,1689386,"UZB",1351509
1,155.0,"Southern Europe",288400,0,288400,215748,359581,"ITA",287665
1,155.0,"Central America",166829,0,166829,125121,208535,"MEX",166828
1,155.0,"Southern Asia",399615,0,399615,295667,492778,"IRN",394223
1,155.0,"Western Asia",203321,0,203321,151525,252542,"IRQ",202034
1,155.0,"Eastern Asia",779638,0,779638,582291,970485,"JPN",776388
1,155.0,"Southern Africa",51990,0,51990,38403,64005,"ZAF",51204
1,155.0,"South-Eastern Asia",479252,0,479252,358812,598021,"IDN",478417
1,155.0,"Caribbean",148668,0,148668,111500,185833,"CUB",148667
1,156.0,"Pakistan",1404302,1197362,206940,1049896,1749827,"PAK",1399862
1,156.0,"India",4853456,4843129,10327,3612177,6020296,"IND",4816237
1,156.0,"Western Europe",2407169,2406911,258,1805272,3008787,"NLD",2407030
1,156.0,"China",9063622,7766731,1296891,6760551,11267586,"CPR",9014069
1,156.0,"United States of America",2422379,2422379,0,1816783,3027972,"USA",2422378
1,156.0,"Northern Africa",1062017,0,1062017,796191,1326986,"EGY",1061589
1,156.0,"Russian Federation",5100282,3399203,1701079,3834593,6390988,"RUS",5112791
1,156.0,"Western Africa",163380,0,163380,122456,204093,"NGA",163275
1,156.0,"South America",1574555,1350569,223986,1174207,1957012,"BRA",1565610
1,156.0,"Northern Europe",1483807,1483807,0,1112810,1854683,"GBR",1483747
1,156.0,"Northern America",612231,612231,0,459172,765287,"CAN",612230
1,156.0,"Oceania",336188,336188,0,252018,420031,"NZL",336025
1,156.0,"Eastern Africa",145209,0,145209,108552,180921,"ETH",144737
1,156.0,"Middle Africa",58128,0,58128,43566,72610,"AGO",58088
1,156.0,"Eastern Europe",3730796,3727693,3103,2795976,4659960,"POL",3727968
1,156.0,"Central Asia",1362748,1354309,8439,1013631,1689386,"UZB",1351509
1,156.0,"Southern Europe",287856,0,287856,215748,359581,"ITA",287665
1,156.0,"Central America",166829,0,166829,125121,208535,"MEX",166828
1,156.0,"Southern Asia",395606,0,395606,295667,492778,"IRN",394223
1,156.0,"Western Asia",202365,0,202365,151525,252542,"IRQ",202034
1,156.0,"Eastern Asia",777219,0,777219,582291,970485,"JPN",776388
1,156.0,"Southern Africa",51411,0,51411,38403,64005,"ZAF",51204
1,156.0,"South-Eastern Asia",478898,0,478898,358812,598021,"IDN",478417
1,156.0,"Caribbean",148668,0,148668,111500,185833,"CUB",148667
1,157.0,"Pakistan",1397869,1199545,198324,1049896,1749827,"PAK",1399862
1,157.0,"India",4850139,4846740,3399,3612177,6020296,"IND",4816237
1,157.0,"Western Europe",2407066,2406808,258,1805272,3008787,"NLD",2407030
1,157.0,"China",8945849,7749190,1196659,6760551,11267586,"CPR",9014069
1,157.0,"United States of America",2422379,2422379,0,1816783,3027972,"USA",2422378
1,157.0,"Northern Africa",1061630,0,1061630,796191,1326986,"EGY",1061589
1,157.0,"Russian Federation",5109755,3395501,1714254,3834593,6390988,"RUS",5112791
1,157.0,"Western Africa",163302,0,163302,122456,204093,"NGA",163275
1,157.0,"South America",1571358,1349910,221448,1174207,1957012,"BRA",1565610
1,157.0,"Northern Europe",1483763,1483763,0,1112810,1854683,"GBR",1483747
1,157.0,"Northern America",612231,612231,0,459172,765287,"CAN",612230
1,157.0,"Oceania",336067,336067,0,252018,420031,"NZL",336025
1,157.0,"Eastern Africa",144770,0,144770,108552,180921,"ETH",144737
1,157.0,"Middle Africa",58099,0,58099,43566,72610,"AGO",58088
1,157.0,"Eastern Europe",3728693,3725589,3104,2795976,4659960,"POL",3727968
1,157.0,"Central Asia",1350878,1348833,2045,1013631,1689386,"UZB",1351509
1,157.0,"Southern Europe",287716,0,287716,215748,359581,"ITA",287665
1,157.0,"Central America",166829,0,166829,125121,208535,"MEX",166828
1,157.0,"Southern Asia",394233,0,394233,295667,492778,"IRN",394223
1,157.0,"Western Asia",202105,0,202105,151525,252542,"IRQ",202034
1,157.0,"Eastern Asia",776512,0,776512,582291,970485,"JPN",776388
1,157.0,"Southern Africa",51215,0,51215,38403,64005,"ZAF",51204
1,157.0,"South-Eastern Asia",478717,0,478717,358812,598021,"IDN",478417
1,157.0,"Caribbean",148668,0,148668,111500,185833,"CUB",148667
1,158.0,"Pakistan",1399022,1197940,201082,1049896,1749827,"PAK",1399862
1,158.0,"India",4800524,4799742,782,3612177,6020296,"IND",4816237
1,158.0,"Western Europe",2407041,2406783,258,1805272,3008787,"NLD",2407030
1,158.0,"China",8974732,7761657,1213075,6760551,11267586,"CPR",9014069
1,158.0,"United States of America",2422379,2422379,0,1816783,3027972,"USA",2422378
1,158.0,"Northern Africa",1061448,0,1061448,796191,1326986,"EGY",1061589
1,158.0,"Russian Federation",5120278,3396299,1723979,3834593,6390988,"RUS",5112791
1,158.0,"Western Africa",163011,0,163011,122456,204093,"NGA",163275
1,158.0,"South America",1538903,1350265,188638,1174207,1957012,"BRA",1565610
1,158.0,"Northern Europe",1483752,1483752,0,1112810,1854683,"GBR",1483747
1,158.0,"Northern America",612231,612231,0,459172,765287,"CAN",612230
1,158.0,"Oceania",336037,336037,0,252018,420031,"NZL",336025
1,158.0,"Eastern Africa",144533,0,144533,108552,180921,"ETH",144737
1,158.0,"Middle Africa",57993,0,57993,43566,72610,"AGO",58088
1,158.0,"Eastern Europe",3718777,3715673,3104,2795976,4659960,"POL",3727968
1,158.0,"Central Asia",1354416,1353677,739,1013631,1689386,"UZB",1351509
1,158.0,"Southern Europe",287158,0,287158,215748,359581,"ITA",287665
1,158.0,"Central America",166829,0,166829,125121,208535,"MEX",166828
1,158.0,"Southern Asia",393936,0,393936,295667,492778,"IRN",394223
1,158.0,"Western Asia",201574,0,201574,151525,252542,"IRQ",202034
1,158.0,"Eastern Asia",775358,0,775358,582291,970485,"JPN",776388
1,158.0,"Southern Africa",51182,0,51182,38403,64005,"ZAF",51204
1,158.0,"South-Eastern Asia",478320,0,478320,358812,598021,"IDN",478417
1,158.0,"Caribbean",148668,0,148668,111500,185833,"CUB",148667
1,159.0,"Pakistan",1402870,1197379,205491,1049896,1749827,"PAK",1399862
1,159.0,"India",4812035,4811741,294,3612177,6020296,"IND",4816237
1,159.0,"Western Europe",2407033,2406775,258,1805272,3008787,"NLD",2407030
1,159.0,"China",8984271,7754514,1229757,6760551,11267586,"CPR",9014069
1,159.0,"United States of America",2422379,2422379,0,1816783,3027972,"USA",2422378
1,159.0,"Northern Africa",1061048,0,1061048,796191,1326986,"EGY",1061589
1,159.0,"Russian Federation",5123994,3394633,1729361,3834593,6390988,"RUS",5112791
1,159.0,"Western Africa",163478,0,163478,122456,204093,"NGA",163275
1,159.0,"South America",1551740,1349695,202045,1174207,1957012,"BRA",1565610
1,159.0,"Northern Europe",1483749,1483749,0,1112810,1854683,"GBR",1483747
1,159.0,"Northern America",612231,612231,0,459172,765287,"CAN",612230
1,159.0,"Oceania",336028,336028,0,252018,420031,"NZL",336025
1,159.0,"Eastern Africa",144095,0,144095,108552,180921,"ETH",144737
1,159.0,"Middle Africa",58160,0,58160,43566,72610,"AGO",58088
1,159.0,"Eastern Europe",3734997,3731440,3557,2795976,4659960,"POL",3727968
1,159.0,"Central Asia",1318156,1318035,121,1013631,1689386,"UZB",1351509
1,159.0,"Southern Europe",288056,0,288056,215748,359581,"ITA",287665
1,159.0,"Central America",166829,0,166829,125121,208535,"MEX",166828
1,159.0,"Southern Asia",391015,0,391015,295667,492778,"IRN",394223
1,159.0,"Western Asia",202257,0,202257,151525,252542,"IRQ",202034
1,159.0,"Eastern Asia",775808,0,775808,582291,970485,"JPN",776388
1,159.0,"Southern Africa",50746,0,50746,38403,64005,"ZAF",51204
1,159.0,"South-Eastern Asia",478390,0,478390,358812,598021,"IDN",478417
1,159.0,"Caribbean",148668,0,148668,111500,185833,"CUB",148667
1,160.0,"Pakistan",1400279,1195812,204467,1049896,1749827,"PAK",1399862
1,160.0,"India",4802893,4802893,0,3612177,6020296,"IND",4816237
1,160.0,"Western Europe",2400974,2400716,258,1805272,3008787,"NLD",2407030
1,160.0,"China",9003966,7765637,1238329,6760551,11267586,"CPR",9014069
1,160.0,"United States of America",2422379,2422379,0,1816783,3027972,"USA",2422378
1,160.0,"Northern Africa",1059645,0,1059645,796191,1326986,"EGY",1061589
1,160.0,"Russian Federation",5123042,3397853,1725189,3834593,6390988,"RUS",5112791
1,160.0,"Western Africa",163082,0,163082,122456,204093,"NGA",163275
1,160.0,"South America",1569204,1351667,217537,1174207,1957012,"BRA",1565610
1,160.0,"Northern Europe",1483748,1483748,0,1112810,1854683,"GBR",1483747
1,160.0,"Northern America",612231,612231,0,459172,765287,"CAN",612230
1,160.0,"Oceania",336026,336026,0,252018,420031,"NZL",336025
1,160.0,"Eastern Africa",145158,0,145158,108552,180921,"ETH",144737
1,160.0,"Middle Africa",58018,0,58018,43566,72610,"AGO",58088
1,160.0,"Eastern Europe",3720379,3716831,3548,2795976,4659960,"POL",3727968
1,160.0,"Central Asia",1377433,1362865,14568,1013631,1689386,"UZB",1351509
1,160.0,"Southern Europe",287286,0,287286,215748,359581,"ITA",287665
1,160.0,"Central America",166829,0,166829,125121,208535,"MEX",166828
1,160.0,"Southern Asia",396477,0,396477,295667,492778,"IRN",394223
1,160.0,"Western Asia",201750,0,201750,151525,252542,"IRQ",202034
1,160.0,"Eastern Asia",776620,0,776620,582291,970485,"JPN",776388
1,160.0,"Southern Africa",51521,0,51521,38403,64005,"ZAF",51204
1,160.0,"South-Eastern Asia",478320,0,478320,358812,598021,"IDN",478417
1,160.0,"Caribbean",148668,0,148668,111500,185833,"CUB",148667
1,161.0,"Pakistan",1400268,1195551,204717,1049896,1749827,"PAK",1399862
1,161.0,"India",4812835,4812637,198,3612177,6020296,"IND",4816237
1,161.0,"Western Europe",2411541,2411154,387,1805272,3008787,"NLD",2407030
1,161.0,"China",9013759,7758044,1255715,6760551,11267586,"CPR",9014069
1,161.0,"United States of America",2422379,2422379,0,1816783,3027972,"USA",2422378
1,161.0,"Northern Africa",1062869,0,1062869,796191,1326986,"EGY",1061589
1,161.0,"Russian Federation",5063049,3397645,1665404,3834593,6390988,"RUS",5112791
1,161.0,"Western Africa",163084,0,163084,122456,204093,"NGA",163275
1,161.0,"South America",1577260,1351198,226062,1174207,1957012,"BRA",1565610
1,161.0,"Northern Europe",1476280,1476280,0,1112810,1854683,"GBR",1483747
1,161.0,"Northern America",612231,612231,0,459172,765287,"CAN",612230
1,161.0,"Oceania",336026,336026,0,252018,420031,"NZL",336025
1,161.0,"Eastern Africa",144349,0,144349,108552,180921,"ETH",144737
1,161.0,"Middle Africa",58025,0,58025,43566,72610,"AGO",58088
1,161.0,"Eastern Europe",3735408,3731857,3551,2795976,4659960,"POL",3727968
1,161.0,"Central Asia",1327484,1323781,3703,1013631,1689386,"UZB",1351509
1,161.0,"Southern Europe",287490,0,287490,215748,359581,"ITA",287665
1,161.0,"Central America",166829,0,166829,125121,208535,"MEX",166828
1,161.0,"Southern Asia",392488,0,392488,295667,492778,"IRN",394223
1,161.0,"Western Asia",202318,0,202318,151525,252542,"IRQ",202034
1,161.0,"Eastern Asia",775767,0,775767,582291,970485,"JPN",776388
1,161.0,"Southern Africa",50838,0,50838,38403,64005,"ZAF",51204
1,161.0,"South-Eastern Asia",478390,0,478390,358812,598021,"IDN",478417
1,161.0,"Caribbean",148668,0,148668,111500,185833,"CUB",148667
1,162.0,"Pakistan",1398224,1195296,202928,1049896,1749827,"PAK",1399862
1,162.0,"India",4815300,4815300,0,3612177,6020296,"IND",4816237
1,162.0,"Western Europe",2402122,2402022,100,1805272,3008787,"NLD",2407030
1,162.0,"China",9026707,7767467,1259240,6760551,11267586,"CPR",9014069
1,162.0,"United States of America",2422379,2422379,0,1816783,3027972,"USA",2422378
1,162.0,"Northern Africa",1058789,0,1058789,796191,1326986,"EGY",1061589
1,162.0,"Russian Federation",5085980,3399382,1686598,3834593,6390988,"RUS",5112791
1,162.0,"Western Africa",161881,0,161881,122456,204093,"NGA",163275
1,162.0,"South America",1578986,1350168,228818,1174207,1957012,"BRA",1565610
1,162.0,"Northern Europe",1489333,1488988,345,1112810,1854683,"GBR",1483747
1,162.0,"Northern America",612231,612231,0,459172,765287,"CAN",612230
1,162.0,"Oceania",336026,336026,0,252018,420031,"NZL",336025
1,162.0,"Eastern Africa",143310,0,143310,108552,180921,"ETH",144737
1,162.0,"Middle Africa",57572,0,57572,43566,72610,"AGO",58088
1,162.0,"Eastern Europe",3664203,3661634,2569,2795976,4659960,"POL",3727968
1,162.0,"Central Asia",1375917,1361629,14288,1013631,1689386,"UZB",1351509
1,162.0,"Southern Europe",284687,0,284687,215748,359581,"ITA",287665
1,162.0,"Central America",166829,0,166829,125121,208535,"MEX",166828
1,162.0,"Southern Asia",391624,0,391624,295667,492778,"IRN",394223
1,162.0,"Western Asia",198787,0,198787,151525,252542,"IRQ",202034
1,162.0,"Eastern Asia",770095,0,770095,582291,970485,"JPN",776388
1,162.0,"Southern Africa",51011,0,51011,38403,64005,"ZAF",51204
1,162.0,"South-Eastern Asia",478409,0,478409,358812,598021,"IDN",478417
1,162.0,"Caribbean",148668,0,148668,111500,185833,"CUB",148667
1,163.0,"Pakistan",1331835,1195325,136510,1049896,1749827,"PAK",1399862
1,163.0,"India",4803834,4803658,176,3612177,6020296,"IND",4816237
1,163.0,"Western Europe",2399692,2399468,224,1805272,3008787,"NLD",2407030
1,163.0,"China",9022149,7759567,1262582,6760551,11267586,"CPR",9014069
1,163.0,"United States of America",2422379,2422379,0,1816783,3027972,"USA",2422378
1,163.0,"Northern Africa",1059606,0,1059606,796191,1326986,"EGY",1061589
1,163.0,"Russian Federation",5108601,3398618,1709983,3834593,6390988,"RUS",5112791
1,163.0,"Western Africa",162501,0,162501,122456,204093,"NGA",163275
1,163.0,"South America",1572385,1351140,221245,1174207,1957012,"BRA",1565610
1,163.0,"Northern Europe",1443972,1443972,0,1112810,1854683,"GBR",1483747
1,163.0,"Northern America",612231,612231,0,459172,765287,"CAN",612230
1,163.0,"Oceania",336026,336026,0,252018,420031,"NZL",336025
1,163.0,"Eastern Africa",146494,0,146494,108552,180921,"ETH",144737
1,163.0,"Middle Africa",57846,0,57846,43566,72610,"AGO",58088
1,163.0,"Eastern Europe",3777477,3769449,8028,2795976,4659960,"POL",3727968
1,163.0,"Central Asia",1357736,1354141,3595,1013631,1689386,"UZB",1351509
1,163.0,"Southern Europe",287302,0,287302,215748,359581,"ITA",287665
1,163.0,"Central America",166829,0,166829,125121,208535,"MEX",166828
1,163.0,"Southern Asia",398228,0,398228,295667,492778,"IRN",394223
1,163.0,"Western Asia",204655,0,204655,151525,252542,"IRQ",202034
1,163.0,"Eastern Asia",782236,0,782236,582291,970485,"JPN",776388
1,163.0,"Southern Africa",51689,0,51689,38403,64005,"ZAF",51204
1,163.0,"South-Eastern Asia",478327,0,478327,358812,598021,"IDN",478417
1,163.0,"Caribbean",148668,0,148668,111500,185833,"CUB",148667
1,164.0,"Pakistan",1396303,1198329,197974,1049896,1749827,"PAK",1399862
1,164.0,"India",4800812,4799898,914,3612177,6020296,"IND",4816237
1,164.0,"Western Europe",2417274,2416803,471,1805272,3008787,"NLD",2407030
1,164.0,"China",9018257,7755397,1262860,6760551,11267586,"CPR",9014069
1,164.0,"United States of America",2422379,2422379,0,1816783,3027972,"USA",2422378
1,164.0,"Northern Africa",1065715,0,1065715,796191,1326986,"EGY",1061589
1,164.0,"Russian Federation",5104509,3390921,1713588,3834593,6390988,"RUS",5112791
1,164.0,"Western Africa",164968,0,164968,122456,204093,"NGA",163275
1,164.0,"South America",1557062,1348960,208102,1174207,1957012,"BRA",1565610
1,164.0,"Northern Europe",1515038,1502602,12436,1112810,1854683,"GBR",1483747
1,164.0,"Northern America",612231,612231,0,459172,765287,"CAN",612230
1,164.0,"Oceania",336026,336026,0,252018,420031,"NZL",336025
1,164.0,"Eastern Africa",144737,0,144737,108552,180921,"ETH",144737
1,164.0,"Middle Africa",58667,0,58667,43566,72610,"AGO",58088
1,164.0,"Eastern Europe",3731246,3729161,2085,2795976,4659960,"POL",3727968
1,164.0,"Central Asia",1346152,1345379,773,1013631,1689386,"UZB",1351509
1,164.0,"Southern Europe",290154,0,290154,215748,359581,"ITA",287665
1,164.0,"Central America",166829,0,166829,125121,208535,"MEX",166828
1,164.0,"Southern Asia",394436,0,394436,295667,492778,"IRN",394223
1,164.0,"Western Asia",202184,0,202184,151525,252542,"IRQ",202034
1,164.0,"Eastern Asia",777135,0,777135,582291,970485,"JPN",776388
1,164.0,"Southern Africa",51192,0,51192,38403,64005,"ZAF",51204
1,164.0,"South-Eastern Asia",478303,0,478303,358812,598021,"IDN",478417
1,164.0,"Caribbean",148668,0,148668,111500,185833,"CUB",148667
1,165.0,"Pakistan",1437595,1196827,240768,1049896,1749827,"PAK",1399862
1,165.0,"India",4787644,4786168,1476,3612177,6020296,"IND",4816237
1,165.0,"Western Europe",2391454,2391333,121,1805272,3008787,"NLD",2407030
1,165.0,"China",9012165,7743127,1269038,6760551,11267586,"CPR",9014069
1,165.0,"United States of America",2422379,2422379,0,1816783,3027972,"USA",2422378
1,165.0,"Northern Africa",1056258,0,1056258,796191,1326986,"EGY",1061589
1,165.0,"Russian Federation",5126421,3394901,1731520,3834593,6390988,"RUS",5112791
1,165.0,"Western Africa",163957,0,163957,122456,204093,"NGA",163275
1,165.0,"South America",1563374,1350560,212814,1174207,1957012,"BRA",1565610
1,165.0,"Northern Europe",1491705,1488607,3098,1112810,1854683,"GBR",1483747
1,165.0,"Northern America",612231,612231,0,459172,765287,"CAN",612230
1,165.0,"Oceania",336026,336026,0,252018,420031,"NZL",336025
1,165.0,"Eastern Africa",145193,0,145193,108552,180921,"ETH",144737
1,165.0,"Middle Africa",58331,0,58331,43566,72610,"AGO",58088
1,165.0,"Eastern Europe",3738036,3736177,1859,2795976,4659960,"POL",3727968
1,165.0,"Central Asia",1356877,1356376,501,1013631,1689386,"UZB",1351509
1,165.0,"Southern Europe",288794,0,288794,215748,359581,"ITA",287665
1,165.0,"Central America",166829,0,166829,125121,208535,"MEX",166828
1,165.0,"Southern Asia",395580,0,395580,295667,492778,"IRN",394223
1,165.0,"Western Asia",202599,0,202599,151525,252542,"IRQ",202034
1,165.0,"Eastern Asia",777836,0,777836,582291,970485,"JPN",776388
1,165.0,"Southern Africa",51367,0,51367,38403,64005,"ZAF",51204
1,165.0,"South-Eastern Asia",478210,0,478210,358812,598021,"IDN",478417
1,165.0,"Caribbean",148668,0,148668,111500,185833,"CUB",148667
1,166.0,"Pakistan",1431917,1199569,232348,1049896,1749827,"PAK",1399862
1,166.0,"India",4796451,4792019,4432,3612177,6020296,"IND",4816237
1,166.0,"Western Europe",2421304,2419860,1444,1805272,3008787,"NLD",2407030
1,166.0,"China",9035692,7755432,1280260,6760551,11267586,"CPR",9014069
1,166.0,"United States of America",2422379,2422379,0,1816783,3027972,"USA",2422378
1,166.0,"Northern Africa",1065619,0,1065619,796191,1326986,"EGY",1061589
1,166.0,"Russian Federation",5135715,3393921,1741794,3834593,6390988,"RUS",5112791
1,166.0,"Western Africa",163026,0,163026,122456,204093,"NGA",163275
1,166.0,"South America",1565041,1351404,213637,1174207,1957012,"BRA",1565610
1,166.0,"Northern Europe",1485578,1484990,588,1112810,1854683,"GBR",1483747
1,166.0,"Northern America",612231,612231,0,459172,765287,"CAN",612230
1,166.0,"Oceania",336026,336026,0,252018,420031,"NZL",336025
1,166.0,"Eastern Africa",143818,0,143818,108552,180921,"ETH",144737
1,166.0,"Middle Africa",57996,0,57996,43566,72610,"AGO",58088
1,166.0,"Eastern Europe",3711774,3710936,838,2795976,4659960,"POL",3727968
1,166.0,"Central Asia",1329020,1328920,100,1013631,1689386,"UZB",1351509
1,166.0,"Southern Europe",287080,0,287080,215748,359581,"ITA",287665
1,166.0,"Central America",166829,0,166829,125121,208535,"MEX",166828
1,166.0,"Southern Asia",390842,0,390842,295667,492778,"IRN",394223
1,166.0,"Western Asia",201084,0,201084,151525,252542,"IRQ",202034
1,166.0,"Eastern Asia",773775,0,773775,582291,970485,"JPN",776388
1,166.0,"Southern Africa",50814,0,50814,38403,64005,"ZAF",51204
1,166.0,"South-Eastern Asia",478274,0,478274,358812,598021,"IDN",478417
1,166.0,"Caribbean",148668,0,148668,111500,185833,"CUB",148667
1,167.0,"Pakistan",1322835,1195927,126908,1049896,1749827,"PAK",1399862
1,167.0,"India",4848094,4840955,7139,3612177,6020296,"IND",4816237
1,167.0,"Western Europe",2404597,2403905,692,1805272,3008787,"NLD",2407030
1,167.0,"China",9040811,7761898,1278913,6760551,11267586,"CPR",9014069
1,167.0,"United States of America",2422379,2422379,0,1816783,3027972,"USA",2422378
1,167.0,"Northern Africa",1061794,0,1061794,796191,1326986,"EGY",1061589
1,167.0,"Russian Federation",5119222,3395967,1723255,3834593,6390988,"RUS",5112791
1,167.0,"Western Africa",160282,0,160282,122456,204093,"NGA",163275
1,167.0,"South America",1565406,1349790,215616,1174207,1957012,"BRA",1565610
1,167.0,"Northern Europe",1428039,1428039,0,1112810,1854683,"GBR",1483747
1,167.0,"Northern America",612231,612231,0,459172,765287,"CAN",612230
1,167.0,"Oceania",336026,336026,0,252018,420031,"NZL",336025
1,167.0,"Eastern Africa",145207,0,145207,108552,180921,"ETH",144737
1,167.0,"Middle Africa",57061,0,57061,43566,72610,"AGO",58088
1,167.0,"Eastern Europe",3742580,3740870,1710,2795976,4659960,"POL",3727968
1,167.0,"Central Asia",1369854,1364327,5527,1013631,1689386,"UZB",1351509
1,167.0,"Southern Europe",283420,0,283420,215748,359581,"ITA",287665
1,167.0,"Central America",166829,0,166829,125121,208535,"MEX",166828
1,167.0,"Southern Asia",395917,0,395917,295667,492778,"IRN",394223
1,167.0,"Western Asia",202885,0,202885,151525,252542,"IRQ",202034
1,167.0,"Eastern Asia",778637,0,778637,582291,970485,"JPN",776388
1,167.0,"Southern Africa",51207,0,51207,38403,64005,"ZAF",51204
1,167.0,"South-Eastern Asia",478646,0,478646,358812,598021,"IDN",478417
1,167.0,"Caribbean",148668,0,148668,111500,185833,"CUB",148667
1,168.0,"Pakistan",1397228,1198847,198381,1049896,1749827,"PAK",1399862
1,168.0,"India",4836798,4830283,6515,3612177,6020296,"IND",4816237
1,168.0,"Western Europe",2412486,2412106,380,1805272,3008787,"NLD",2407030
1,168.0,"China",9020162,7743586,1276576,6760551,11267586,"CPR",9014069
1,168.0,"United States of America",2422379,2422379,0,1816783,3027972,"USA",2422378
1,168.0,"Northern Africa",1062370,0,1062370,796191,1326986,"EGY",1061589
1,168.0,"Russian Federation",5113807,3389803,1724004,3834593,6390988,"RUS",5112791
1,168.0,"Western Africa",164026,0,164026,122456,204093,"NGA",163275
1,168.0,"South America",1565661,1348052,217609,1174207,1957012,"BRA",1565610
1,168.0,"Northern Europe",1503250,1482031,21219,1112810,1854683,"GBR",1483747
1,168.0,"Northern America",612231,612231,0,459172,765287,"CAN",612230
1,168.0,"Oceania",336026,336026,0,252018,420031,"NZL",336025
1,168.0,"Eastern Africa",144195,0,144195,108552,180921,"ETH",144737
1,168.0,"Middle Africa",58334,0,58334,43566,72610,"AGO",58088
1,168.0,"Eastern Europe",3703551,3703088,463,2795976,4659960,"POL",3727968
1,168.0,"Central Asia",1356205,1354796,1409,1013631,1689386,"UZB",1351509
1,168.0,"Southern Europe",288523,0,288523,215748,359581,"ITA",287665
1,168.0,"Central America",166829,0,166829,125121,208535,"MEX",166828
1,168.0,"Southern Asia",393620,0,393620,295667,492778,"IRN",394223
1,168.0,"Western Asia",200773,0,200773,151525,252542,"IRQ",202034
1,168.0,"Eastern Asia",773930,0,773930,582291,970485,"JPN",776388
1,168.0,"Southern Africa",51252,0,51252,38403,64005,"ZAF",51204
1,168.0,"South-Eastern Asia",478566,0,478566,358812,598021,"IDN",478417
1,168.0,"Caribbean",148668,0,148668,111500,185833,"CUB",148667
1,169.0,"Pakistan",1443898,1196715,247183,1049896,1749827,"PAK",1399862
1,169.0,"India",4821498,4819200,2298,3612177,6020296,"IND",4816237
1,169.0,"Western Europe",2365897,2365897,0,1805272,3008787,"NLD",2407030
1,169.0,"China",9008989,7735737,1273252,6760551,11267586,"CPR",9014069
1,169.0,"United States of America",2422379,2422379,0,1816783,3027972,"USA",2422378
1,169.0,"Northern Africa",1047510,0,1047510,796191,1326986,"EGY",1061589
1,169.0,"Russian Federation",5117139,3391271,1725868,3834593,6390988,"RUS",5112791
1,169.0,"Western Africa",165078,0,165078,122456,204093,"NGA",163275
1,169.0,"South America",1569061,1349950,219111,1174207,1957012,"BRA",1565610
1,169.0,"Northern Europe",1511313,1489806,21507,1112810,1854683,"GBR",1483747
1,169.0,"Northern America",612231,612231,0,459172,765287,"CAN",612230
1,169.0,"Oceania",336026,336026,0,252018,420031,"NZL",336025
1,169.0,"Eastern Africa",145297,0,145297,108552,180921,"ETH",144737
1,169.0,"Middle Africa",58715,0,58715,43566,72610,"AGO",58088
1,169.0,"Eastern Europe",3749886,3748395,1491,2795976,4659960,"POL",3727968
1,169.0,"Central Asia",1332159,1331927,232,1013631,1689386,"UZB",1351509
1,169.0,"Southern Europe",290516,0,290516,215748,359581,"ITA",287665
1,169.0,"Central America",166829,0,166829,125121,208535,"MEX",166828
1,169.0,"Southern Asia",393980,0,393980,295667,492778,"IRN",394223
1,169.0,"Western Asia",202866,0,202866,151525,252542,"IRQ",202034
1,169.0,"Eastern Asia",778077,0,778077,582291,970485,"JPN",776388
1,169.0,"Southern Africa",51177,0,51177,38403,64005,"ZAF",51204
1,169.0,"South-Eastern Asia",478456,0,478456,358812,598021,"IDN",478417
1,169.0,"Caribbean",148668,0,148668,111500,185833,"CUB",148667
1,170.0,"Pakistan",1439586,1197462,242124,1049896,1749827,"PAK",1399862
1,170.0,"India",4817570,4815657,1913,3612177,6020296,"IND",4816237
1,170.0,"Western Europe",2439117,2434047,5070,1805272,3008787,"NLD",2407030
1,170.0,"China",8632442,7742470,889972,6760551,11267586,"CPR",9014069
1,170.0,"United States of America",2422379,2422379,0,1816783,3027972,"USA",2422378
1,170.0,"Northern Africa",1071253,0,1071253,796191,1326986,"EGY",1061589
1,170.0,"Russian Federation",4857435,3399262,1458173,3834593,6390988,"RUS",5112791
1,170.0,"Western Africa",162883,0,162883,122456,204093,"NGA",163275
1,170.0,"South America",1570017,1351568,218449,1174207,1957012,"BRA",1565610
1,170.0,"Northern Europe",1490821,1485370,5451,1112810,1854683,"GBR",1483747
1,170.0,"Northern America",612231,612231,0,459172,765287,"CAN",612230
1,170.0,"Oceania",336026,336026,0,252018,420031,"NZL",336025
1,170.0,"Eastern Africa",143638,0,143638,108552,180921,"ETH",144737
1,170.0,"Middle Africa",57941,0,57941,43566,72610,"AGO",58088
1,170.0,"Eastern Europe",3686529,3686203,326,2795976,4659960,"POL",3727968
1,170.0,"Central Asia",1367058,1363556,3502,1013631,1689386,"UZB",1351509
1,170.0,"Southern Europe",286573,0,286573,215748,359581,"ITA",287665
1,170.0,"Central America",166829,0,166829,125121,208535,"MEX",166828
1,170.0,"Southern Asia",393068,0,393068,295667,492778,"IRN",394223
1,170.0,"Western Asia",200103,0,200103,151525,252542,"IRQ",202034
1,170.0,"Eastern Asia",772593,0,772593,582291,970485,"JPN",776388
1,170.0,"Southern Africa",51122,0,51122,38403,64005,"ZAF",51204
1,170.0,"South-Eastern Asia",478427,0,478427,358812,598021,"IDN",478417
1,170.0,"Caribbean",148668,0,148668,111500,185833,"CUB",148667
1,171.0,"Pakistan",1329973,1193915,136058,1049896,1749827,"PAK",1399862
1,171.0,"India",4816681,4815580,1101,3612177,6020296,"IND",4816237
1,171.0,"Western Europe",2415223,2413232,1991,1805272,3008787,"NLD",2407030
1,171.0,"China",8713866,7746320,967546,6760551,11267586,"CPR",9014069
1,171.0,"United States of America",2422379,2422379,0,1816783,3027972,"USA",2422378
1,171.0,"Northern Africa",1065467,0,1065467,796191,1326986,"EGY",1061589
1,171.0,"Russian Federation",4986676,3401596,1585080,3834593,6390988,"RUS",5112791
1,171.0,"Western Africa",161925,0,161925,122456,204093,"NGA",163275
1,171.0,"South America",1566777,1347963,218814,1174207,1957012,"BRA",1565610
1,171.0,"Northern Europe",1440717,1439344,1373,1112810,1854683,"GBR",1483747
1,171.0,"Northern America",612231,612231,0,459172,765287,"CAN",612230
1,171.0,"Oceania",336026,336026,0,252018,420031,"NZL",336025
1,171.0,"Eastern Africa",145794,0,145794,108552,180921,"ETH",144737
1,171.0,"Middle Africa",57644,0,57644,43566,72610,"AGO",58088
1,171.0,"Eastern Europe",3764581,3761015,3566,2795976,4659960,"POL",3727968
1,171.0,"Central Asia",1345224,1344364,860,1013631,1689386,"UZB",1351509
1,171.0,"Southern Europe",286256,0,286256,215748,359581,"ITA",287665
1,171.0,"Central America",166829,0,166829,125121,208535,"MEX",166828
1,171.0,"Southern Asia",395618,0,395618,295667,492778,"IRN",394223
1,171.0,"Western Asia",203843,0,203843,151525,252542,"IRQ",202034
1,171.0,"Eastern Asia",779668,0,779668,582291,970485,"JPN",776388
1,171.0,"Southern Africa",51383,0,51383,38403,64005,"ZAF",51204
1,171.0,"South-Eastern Asia",478421,0,478421,358812,598021,"IDN",478417
1,171.0,"Caribbean",148668,0,148668,111500,185833,"CUB",148667
1,172.0,"Pakistan",1375537,1193480,182057,1049896,1749827,"PAK",1399862
1,172.0,"India",4779576,4778578,998,3612177,6020296,"IND",4816237
1,172.0,"Western Europe",2409056,2408615,441,1805272,3008787,"NLD",2407030
1,172.0,"China",8788466,7741355,1047111,6760551,11267586,"CPR",9014069
1,172.0,"United States of America",2422379,2422379,0,1816783,3027972,"USA",2422378
1,172.0,"Northern Africa",1061845,0,1061845,796191,1326986,"EGY",1061589
1,172.0,"Russian Federation",5086971,3400437,1686534,3834593,6390988,"RUS",5112791
1,172.0,"Western Africa",163835,0,163835,122456,204093,"NGA",163275
1,172.0,"South America",1562460,1343091,219369,1174207,1957012,"BRA",1565610
1,172.0,"Northern Europe",1510015,1494285,15730,1112810,1854683,"GBR",1483747
1,172.0,"Northern America",612231,612231,0,459172,765287,"CAN",612230
1,172.0,"Oceania",336026,336026,0,252018,420031,"NZL",336025
1,172.0,"Eastern Africa",143666,0,143666,108552,180921,"ETH",144737
1,172.0,"Middle Africa",58259,0,58259,43566,72610,"AGO",58088
1,172.0,"Eastern Europe",3690238,3687972,2266,2795976,4659960,"POL",3727968
1,172.0,"Central Asia",1360080,1358265,1815,1013631,1689386,"UZB",1351509
1,172.0,"Southern Europe",287967,0,287967,215748,359581,"ITA",287665
1,172.0,"Central America",166829,0,166829,125121,208535,"MEX",166828
1,172.0,"Southern Asia",392861,0,392861,295667,492778,"IRN",394223
1,172.0,"Western Asia",200193,0,200193,151525,252542,"IRQ",202034
1,172.0,"Eastern Asia",773110,0,773110,582291,970485,"JPN",776388
1,172.0,"Southern Africa",51048,0,51048,38403,64005,"ZAF",51204
1,172.0,"South-Eastern Asia",478153,0,478153,358812,598021,"IDN",478417
1,172.0,"Caribbean",148668,0,148668,111500,185833,"CUB",148667
1,173.0,"Pakistan",1417158,1188516,228642,1049896,1749827,"PAK",1399862
1,173.0,"India",4757266,4755389,1877,3612177,6020296,"IND",4816237
1,173.0,"Western Europe",2407435,2407435,0,1805272,3008787,"NLD",2407030
1,173.0,"China",8907626,7766289,1141337,6760551,11267586,"CPR",9014069
1,173.0,"United States of America",2422379,2422379,0,1816783,3027972,"USA",2422378
1,173.0,"Northern Africa",1061378,0,1061378,796191,1326986,"EGY",1061589
1,173.0,"Russian Federation",5161305,3399531,1761774,3834593,6390988,"RUS",5112791
1,173.0,"Western Africa",164349,0,164349,122456,204093,"NGA",163275
1,173.0,"South America",1557900,1336195,221705,1174207,1957012,"BRA",1565610
1,173.0,"Northern Europe",1486760,1479555,7205,1112810,1854683,"GBR",1483747
1,173.0,"Northern America",612231,612231,0,459172,765287,"CAN",612230
1,173.0,"Oceania",336026,336026,0,252018,420031,"NZL",336025
1,173.0,"Eastern Africa",144922,0,144922,108552,180921,"ETH",144737
1,173.0,"Middle Africa",58479,0,58479,43566,72610,"AGO",58088
1,173.0,"Eastern Europe",3765374,3760387,4987,2795976,4659960,"POL",3727968
1,173.0,"Central Asia",1295728,1295339,389,1013631,1689386,"UZB",1351509
1,173.0,"Southern Europe",289755,0,289755,215748,359581,"ITA",287665
1,173.0,"Central America",166829,0,166829,125121,208535,"MEX",166828
1,173.0,"Southern Asia",390776,0,390776,295667,492778,"IRN",394223
1,173.0,"Western Asia",203107,0,203107,151525,252542,"IRQ",202034
1,173.0,"Eastern Asia",779552,0,779552,582291,970485,"JPN",776388
1,173.0,"Southern Africa",50602,0,50602,38403,64005,"ZAF",51204
1,173.0,"South-Eastern Asia",477995,0,477995,358812,598021,"IDN",478417
1,173.0,"Caribbean",148668,0,148668,111500,185833,"CUB",148667
1,174.0,"Pakistan",1442835,1187428,255407,1049896,1749827,"PAK",1399862
1,174.0,"India",4738342,4728873,9469,3612177,6020296,"IND",4816237
1,174.0,"Western Europe",2407133,2407133,0,1805272,3008787,"NLD",2407030
1,174.0,"China",8978664,7760437,1218227,6760551,11267586,"CPR",9014069
1,174.0,"United States of America",2422379,2422379,0,1816783,3027972,"USA",2422378
1,174.0,"Northern Africa",1061589,0,1061589,796191,1326986,"EGY",1061589
1,174.0,"Russian Federation",5200467,3398118,1802349,3834593,6390988,"RUS",5112791
1,174.0,"Western Africa",162527,0,162527,122456,204093,"NGA",163275
1,174.0,"South America",1560290,1332309,227981,1174207,1957012,"BRA",1565610
1,174.0,"Northern Europe",1495616,1488771,6845,1112810,1854683,"GBR",1483747
1,174.0,"Northern America",612231,612231,0,459172,765287,"CAN",612230
1,174.0,"Oceania",336026,336026,0,252018,420031,"NZL",336025
1,174.0,"Eastern Africa",143428,0,143428,108552,180921,"ETH",144737
1,174.0,"Middle Africa",57806,0,57806,43566,72610,"AGO",58088
1,174.0,"Eastern Europe",3671699,3667849,3850,2795976,4659960,"POL",3727968
1,174.0,"Central Asia",1374521,1350810,23711,1013631,1689386,"UZB",1351509
1,174.0,"Southern Europe",285767,0,285767,215748,359581,"ITA",287665
1,174.0,"Central America",166829,0,166829,125121,208535,"MEX",166828
1,174.0,"Southern Asia",393223,0,393223,295667,492778,"IRN",394223
1,174.0,"Western Asia",199671,0,199671,151525,252542,"IRQ",202034
1,174.0,"Eastern Asia",771309,0,771309,582291,970485,"JPN",776388
1,174.0,"Southern Africa",51153,0,51153,38403,64005,"ZAF",51204
1,174.0,"South-Eastern Asia",477866,0,477866,358812,598021,"IDN",478417
1,174.0,"Caribbean",148668,0,148668,111500,185833,"CUB",148667
1,175.0,"Pakistan",1416928,1183374,233554,1049896,1749827,"PAK",1399862
1,175.0,"India",4769569,4745487,24082,3612177,6020296,"IND",4816237
1,175.0,"Western Europe",2407058,2407058,0,1805272,3008787,"NLD",2407030
1,175.0,"China",9059443,7756737,1302706,6760551,11267586,"CPR",9014069
1,175.0,"United States of America",2422379,2422379,0,1816783,3027972,"USA",2422378
1,175.0,"Northern Africa",1060432,0,1060432,796191,1326986,"EGY",1061589
1,175.0,"Russian Federation",5217030,3392345,1824685,3834593,6390988,"RUS",5112791
1,175.0,"Western Africa",160167,0,160167,122456,204093,"NGA",163275
1,175.0,"South America",1564243,1331226,233017,1174207,1957012,"BRA",1565610
1,175.0,"Northern Europe",1385818,1384128,1690,1112810,1854683,"GBR",1483747
1,175.0,"Northern America",612231,612231,0,459172,765287,"CAN",612230
1,175.0,"Oceania",332644,332644,0,252018,420031,"NZL",336025
1,175.0,"Eastern Africa",146080,0,146080,108552,180921,"ETH",144737
1,175.0,"Middle Africa",57052,0,57052,43566,72610,"AGO",58088
1,175.0,"Eastern Europe",3779386,3771107,8279,2795976,4659960,"POL",3727968
1,175.0,"Central Asia",1374703,1356081,18622,1013631,1689386,"UZB",1351509
1,175.0,"Southern Europe",284176,0,284176,215748,359581,"ITA",287665
1,175.0,"Central America",166825,0,166825,125121,208535,"MEX",166828
1,175.0,"Southern Asia",397858,0,397858,295667,492778,"IRN",394223
1,175.0,"Western Asia",203967,0,203967,151525,252542,"IRQ",202034
1,175.0,"Eastern Asia",776003,0,776003,582291,970485,"JPN",776388
1,175.0,"Southern Africa",51716,0,51716,38403,64005,"ZAF",51204
1,175.0,"South-Eastern Asia",473661,0,473661,358812,598021,"IDN",478417
1,175.0,"Caribbean",148663,0,148663,111500,185833,"CUB",148667
1,176.0,"Pakistan",1383450,1176395,207055,1049896,1749827,"PAK",1399862
1,176.0,"India",4815938,4773511,42427,3612177,6020296,"IND",4816237
1,176.0,"Western Europe",2407038,2407038,0,1805272,3008787,"NLD",2407030
1,176.0,"China",9113178,7751977,1361201,6760551,11267586,"CPR",9014069
1,176.0,"United States of America",2422379,2422379,0,1816783,3027972,"USA",2422378
1,176.0,"Northern Africa",1062074,0,1062074,796191,1326986,"EGY",1061589
1,176.0,"Russian Federation",5153954,3388846,1765108,3834593,6390988,"RUS",5112791
1,176.0,"Western Africa",164511,0,164511,122456,204093,"NGA",163275
1,176.0,"South America",1568842,1329496,239346,1174207,1957012,"BRA",1565610
1,176.0,"Northern Europe",1548225,1504605,43620,1112810,1854683,"GBR",1483747
1,176.0,"Northern America",612231,612231,0,459172,765287,"CAN",612230
1,176.0,"Oceania",338539,338539,0,252018,420031,"NZL",336025
1,176.0,"Eastern Africa",142871,0,142871,108552,180921,"ETH",144737
1,176.0,"Middle Africa",58469,0,58469,43566,72610,"AGO",58088
1,176.0,"Eastern Europe",3656563,3650114,6449,2795976,4659960,"POL",3727968
1,176.0,"Central Asia",1350746,1344468,6278,1013631,1689386,"UZB",1351509
1,176.0,"Southern Europe",288306,0,288306,215748,359581,"ITA",287665
1,176.0,"Central America",166831,0,166831,125121,208535,"MEX",166828
1,176.0,"Southern Asia",391253,0,391253,295667,492778,"IRN",394223
1,176.0,"Western Asia",199071,0,199071,151525,252542,"IRQ",202034
1,176.0,"Eastern Asia",773592,0,773592,582291,970485,"JPN",776388
1,176.0,"Southern Africa",50796,0,50796,38403,64005,"ZAF",51204
1,176.0,"South-Eastern Asia",481711,0,481711,358812,598021,"IDN",478417
1,176.0,"Caribbean",148671,0,148671,111500,185833,"CUB",148667
1,177.0,"Pakistan",1395942,1176199,219743,1049896,1749827,"PAK",1399862
1,177.0,"India",4841922,4784604,57318,3612177,6020296,"IND",4816237
1,177.0,"Western Europe",2407032,2407032,0,1805272,3008787,"NLD",2407030
1,177.0,"China",9188997,7764997,1424000,6760551,11267586,"CPR",9014069
1,177.0,"United States of America",2422379,2422379,0,1816783,3027972,"USA",2422378
1,177.0,"Northern Africa",1061846,0,1061846,796191,1326986,"EGY",1061589
1,177.0,"Russian Federation",5149339,3387091,1762248,3834593,6390988,"RUS",5112791
1,177.0,"Western Africa",165991,0,165991,122456,204093,"NGA",163275
1,177.0,"South America",1576747,1335334,241413,1174207,1957012,"BRA",1565610
1,177.0,"Northern Europe",1512036,1493167,18869,1112810,1854683,"GBR",1483747
1,177.0,"Northern America",612231,612231,0,459172,765287,"CAN",612230
1,177.0,"Oceania",336671,336671,0,252018,420031,"NZL",336025
1,177.0,"Eastern Africa",146761,0,146761,108552,180921,"ETH",144737
1,177.0,"Middle Africa",59051,0,59051,43566,72610,"AGO",58088
1,177.0,"Eastern Europe",3794451,3780889,13562,2795976,4659960,"POL",3727968
1,177.0,"Central Asia",1299942,1296916,3026,1013631,1689386,"UZB",1351509
1,177.0,"Southern Europe",292408,0,292408,215748,359581,"ITA",287665
1,177.0,"Central America",166829,0,166829,125121,208535,"MEX",166828
1,177.0,"Southern Asia",394574,0,394574,295667,492778,"IRN",394223
1,177.0,"Western Asia",205755,0,205755,151525,252542,"IRQ",202034
1,177.0,"Eastern Asia",782034,0,782034,582291,970485,"JPN",776388
1,177.0,"Southern Africa",51158,0,51158,38403,64005,"ZAF",51204
1,177.0,"South-Eastern Asia",479446,0,479446,358812,598021,"IDN",478417
1,177.0,"Caribbean",148668,0,148668,111500,185833,"CUB",148667
1,178.0,"Pakistan",1405362,1182767,222595,1049896,1749827,"PAK",1399862
1,178.0,"India",4848812,4781452,67360,3612177,6020296,"IND",4816237
1,178.0,"Western Europe",2407031,2407031,0,1805272,3008787,"NLD",2407030
1,178.0,"China",9214816,7760123,1454693,6760551,11267586,"CPR",9014069
1,178.0,"United States of America",2422379,2422379,0,1816783,3027972,"USA",2422378
1,178.0,"Northern Africa",1063657,0,1063657,796191,1326986,"EGY",1061589
1,178.0,"Russian Federation",5120634,3381286,1739348,3834593,6390988,"RUS",5112791
1,178.0,"Western Africa",163228,0,163228,122456,204093,"NGA",163275
1,178.0,"South America",1575319,1334189,241130,1174207,1957012,"BRA",1565610
1,178.0,"Northern Europe",1490798,1486218,4580,1112810,1854683,"GBR",1483747
1,178.0,"Northern America",612231,612231,0,459172,765287,"CAN",612230
1,178.0,"Oceania",336192,336192,0,252018,420031,"NZL",336025
1,178.0,"Eastern Africa",144581,0,144581,108552,180921,"ETH",144737
1,178.0,"Middle Africa",58067,0,58067,43566,72610,"AGO",58088
1,178.0,"Eastern Europe",3707317,3696666,10651,2795976,4659960,"POL",3727968
1,178.0,"Central Asia",1400009,1371916,28093,1013631,1689386,"UZB",1351509
1,178.0,"Southern Europe",287317,0,287317,215748,359581,"ITA",287665
1,178.0,"Central America",166829,0,166829,125121,208535,"MEX",166828
1,178.0,"Southern Asia",397437,0,397437,295667,492778,"IRN",394223
1,178.0,"Western Asia",201110,0,201110,151525,252542,"IRQ",202034
1,178.0,"Eastern Asia",776334,0,776334,582291,970485,"JPN",776388
1,178.0,"Southern Africa",51677,0,51677,38403,64005,"ZAF",51204
1,178.0,"South-Eastern Asia",478861,0,478861,358812,598021,"IDN",478417
1,178.0,"Caribbean",148668,0,148668,111500,185833,"CUB",148667
1,179.0,"Pakistan",1416880,1183347,233533,1049896,1749827,"PAK",1399862
1,179.0,"India",4862768,4785093,77675,3612177,6020296,"IND",4816237
1,179.0,"Western Europe",2407031,2407031,0,1805272,3008787,"NLD",2407030
1,179.0,"China",9222641,7748929,1473712,6760551,11267586,"CPR",9014069
1,179.0,"United States of America",2422379,2422379,0,1816783,3027972,"USA",2422378
1,179.0,"Northern Africa",1061347,0,1061347,796191,1326986,"EGY",1061589
1,179.0,"Russian Federation",5136113,3380195,1755918,3834593,6390988,"RUS",5112791
1,179.0,"Western Africa",161717,0,161717,122456,204093,"NGA",163275
1,179.0,"South America",1550823,1332295,218528,1174207,1957012,"BRA",1565610
1,179.0,"Northern Europe",1433076,1432081,995,1112810,1854683,"GBR",1483747
1,179.0,"Northern America",612231,612231,0,459172,765287,"CAN",612230
1,179.0,"Oceania",335222,335222,0,252018,420031,"NZL",336025
1,179.0,"Eastern Africa",145679,0,145679,108552,180921,"ETH",144737
1,179.0,"Middle Africa",57572,0,57572,43566,72610,"AGO",58088
1,179.0,"Eastern Europe",3760155,3747976,12179,2795976,4659960,"POL",3727968
1,179.0,"Central Asia",1346651,1339828,6823,1013631,1689386,"UZB",1351509
1,179.0,"Southern Europe",285981,0,285981,215748,359581,"ITA",287665
1,179.0,"Central America",166828,0,166828,125121,208535,"MEX",166828
1,179.0,"Southern Asia",394310,0,394310,295667,492778,"IRN",394223
1,179.0,"Western Asia",203487,0,203487,151525,252542,"IRQ",202034
1,179.0,"Eastern Asia",778106,0,778106,582291,970485,"JPN",776388
1,179.0,"Southern Africa",51386,0,51386,38403,64005,"ZAF",51204
1,179.0,"South-Eastern Asia",477689,0,477689,358812,598021,"IDN",478417
1,179.0,"Caribbean",148666,0,148666,111500,185833,"CUB",148667
1,180.0,"Pakistan",1410629,1183113,227516,1049896,1749827,"PAK",1399862
1,180.0,"India",4853629,4772960,80669,3612177,6020296,"IND",4816237
1,180.0,"Western Europe",2407031,2407031,0,1805272,3008787,"NLD",2407030
1,180.0,"China",9193829,7754453,1439376,6760551,11267586,"CPR",9014069
1,180.0,"United States of America",2422379,2422379,0,1816783,3027972,"USA",2422378
1,180.0,"Northern Africa",1062611,0,1062611,796191,1326986,"EGY",1061589
1,180.0,"Russian Federation",5135777,3381286,1754491,3834593,6390988,"RUS",5112791
1,180.0,"Western Africa",164788,0,164788,122456,204093,"NGA",163275
1,180.0,"South America",1572046,1346799,225247,1174207,1957012,"BRA",1565610
1,180.0,"Northern Europe",1523327,1505851,17476,1112810,1854683,"GBR",1483747
1,180.0,"Northern America",612231,612231,0,459172,765287,"CAN",612230
1,180.0,"Oceania",336665,336665,0,252018,420031,"NZL",336025
1,180.0,"Eastern Africa",144645,0,144645,108552,180921,"ETH",144737
1,180.0,"Middle Africa",58598,0,58598,43566,72610,"AGO",58088
1,180.0,"Eastern Europe",3717461,3706979,10482,2795976,4659960,"POL",3727968
1,180.0,"Central Asia",1367368,1360503,6865,1013631,1689386,"UZB",1351509
1,180.0,"Southern Europe",289604,0,289604,215748,359581,"ITA",287665
1,180.0,"Central America",166829,0,166829,125121,208535,"MEX",166828
1,180.0,"Southern Asia",396204,0,396204,295667,492778,"IRN",394223
1,180.0,"Western Asia",201708,0,201708,151525,252542,"IRQ",202034
1,180.0,"Eastern Asia",776983,0,776983,582291,970485,"JPN",776388
1,180.0,"Southern Africa",51359,0,51359,38403,64005,"ZAF",51204
1,180.0,"South-Eastern Asia",479514,0,479514,358812,598021,"IDN",478417
1,180.0,"Caribbean",148668,0,148668,111500,185833,"CUB",148667
1,181.0,"Pakistan",1371306,1180861,190445,1049896,1749827,"PAK",1399862
1,181.0,"India",4850659,4776977,73682,3612177,6020296,"IND",4816237
1,181.0,"Western Europe",2407031,2407031,0,1805272,3008787,"NLD",2407030
1,181.0,"China",9164855,7749068,1415787,6760551,11267586,"CPR",9014069
1,181.0,"United States of America",2422379,2422379,0,1816783,3027972,"USA",2422378
1,181.0,"Northern Africa",1060879,0,1060879,796191,1326986,"EGY",1061589
1,181.0,"Russian Federation",5155715,3393290,1762425,3834593,6390988,"RUS",5112791
1,181.0,"Western Africa",164043,0,164043,122456,204093,"NGA",163275
1,181.0,"South America",1574197,1349181,225016,1174207,1957012,"BRA",1565610
1,181.0,"Northern Europe",1493723,1489475,4248,1112810,1854683,"GBR",1483747
1,181.0,"Northern America",612231,612231,0,459172,765287,"CAN",612230
1,181.0,"Oceania",336189,336189,0,252018,420031,"NZL",336025
1,181.0,"Eastern Africa",145010,0,145010,108552,180921,"ETH",144737
1,181.0,"Middle Africa",58362,0,58362,43566,72610,"AGO",58088
1,181.0,"Eastern Europe",3744035,3732517,11518,2795976,4659960,"POL",3727968
1,181.0,"Central Asia",1328232,1326563,1669,1013631,1689386,"UZB",1351509
1,181.0,"Southern Europe",288951,0,288951,215748,359581,"ITA",287665
1,181.0,"Central America",166829,0,166829,125121,208535,"MEX",166828
1,181.0,"Southern Asia",393602,0,393602,295667,492778,"IRN",394223
1,181.0,"Western Asia",202605,0,202605,151525,252542,"IRQ",202034
1,181.0,"Eastern Asia",777897,0,777897,582291,970485,"JPN",776388
1,181.0,"Southern Africa",51033,0,51033,38403,64005,"ZAF",51204
1,181.0,"South-Eastern Asia",478878,0,478878,358812,598021,"IDN",478417
1,181.0,"Caribbean",148668,0,148668,111500,185833,"CUB",148667
1,182.0,"Pakistan",1414668,1194407,220261,1049896,1749827,"PAK",1399862
1,182.0,"India",4898264,4835811,62453,3612177,6020296,"IND",4816237
1,182.0,"Western Europe",2407031,2407031,0,1805272,3008787,"NLD",2407030
1,182.0,"China",8911881,7744520,1167361,6760551,11267586,"CPR",9014069
1,182.0,"United States of America",2422379,2422379,0,1816783,3027972,"USA",2422378
1,182.0,"Northern Africa",1062477,0,1062477,796191,1326986,"EGY",1061589
1,182.0,"Russian Federation",5141674,3394863,1746811,3834593,6390988,"RUS",5112791
1,182.0,"Western Africa",163475,0,163475,122456,204093,"NGA",163275
1,182.0,"South America",1567656,1351297,216359,1174207,1957012,"BRA",1565610
1,182.0,"Northern Europe",1486247,1485216,1031,1112810,1854683,"GBR",1483747
1,182.0,"Northern America",612231,612231,0,459172,765287,"CAN",612230
1,182.0,"Oceania",336068,336068,0,252018,420031,"NZL",336025
1,182.0,"Eastern Africa",145156,0,145156,108552,180921,"ETH",144737
1,182.0,"Middle Africa",58158,0,58158,43566,72610,"AGO",58088
1,182.0,"Eastern Europe",3732000,3720778,11222,2795976,4659960,"POL",3727968
1,182.0,"Central Asia",1372894,1363413,9481,1013631,1689386,"UZB",1351509
1,182.0,"Southern Europe",287996,0,287996,215748,359581,"ITA",287665
1,182.0,"Central America",166829,0,166829,125121,208535,"MEX",166828
1,182.0,"Southern Asia",396404,0,396404,295667,492778,"IRN",394223
1,182.0,"Western Asia",202512,0,202512,151525,252542,"IRQ",202034
1,182.0,"Eastern Asia",777157,0,777157,582291,970485,"JPN",776388
1,182.0,"Southern Africa",51533,0,51533,38403,64005,"ZAF",51204
1,182.0,"South-Eastern Asia",479068,0,479068,358812,598021,"IDN",478417
1,182.0,"Caribbean",148668,0,148668,111500,185833,"CUB",148667
1,183.0,"Pakistan",1419208,1195022,224186,1049896,1749827,"PAK",1399862
1,183.0,"India",4825026,4809295,15731,3612177,6020296,"IND",4816237
1,183.0,"Western Europe",2407031,2407031,0,1805272,3008787,"NLD",2407030
1,183.0,"China",8945608,7748116,1197492,6760551,11267586,"CPR",9014069
1,183.0,"United States of America",2422379,2422379,0,1816783,3027972,"USA",2422378
1,183.0,"Northern Africa",1061816,0,1061816,796191,1326986,"EGY",1061589
1,183.0,"Russian Federation",5102457,3390674,1711783,3834593,6390988,"RUS",5112791
1,183.0,"Western Africa",163330,0,163330,122456,204093,"NGA",163275
1,183.0,"South America",1566128,1351822,214306,1174207,1957012,"BRA",1565610
1,183.0,"Northern Europe",1484123,1484123,0,1112810,1854683,"GBR",1483747
1,183.0,"Northern America",612231,612231,0,459172,765287,"CAN",612230
1,183.0,"Oceania",336037,336037,0,252018,420031,"NZL",336025
1,183.0,"Eastern Africa",144849,0,144849,108552,180921,"ETH",144737
1,183.0,"Middle Africa",58109,0,58109,43566,72610,"AGO",58088
1,183.0,"Eastern Europe",3728999,3717785,11214,2795976,4659960,"POL",3727968
1,183.0,"Central Asia",1356900,1354577,2323,1013631,1689386,"UZB",1351509
1,183.0,"Southern Europe",287750,0,287750,215748,359581,"ITA",287665
1,183.0,"Central America",166829,0,166829,125121,208535,"MEX",166828
1,183.0,"Southern Asia",394785,0,394785,295667,492778,"IRN",394223
1,183.0,"Western Asia",202159,0,202159,151525,252542,"IRQ",202034
1,183.0,"Eastern Asia",776542,0,776542,582291,970485,"JPN",776388
1,183.0,"Southern Africa",51290,0,51290,38403,64005,"ZAF",51204
1,183.0,"South-Eastern Asia",478496,0,478496,358812,598021,"IDN",478417
1,183.0,"Caribbean",148668,0,148668,111500,185833,"CUB",148667
1,184.0,"Pakistan",1395419,1191376,204043,1049896,1749827,"PAK",1399862
1,184.0,"India",4806191,4802313,3878,3612177,6020296,"IND",4816237
1,184.0,"Western Europe",2407031,2407031,0,1805272,3008787,"NLD",2407030
1,184.0,"China",8995498,7766670,1228828,6760551,11267586,"CPR",9014069
1,184.0,"United States of America",2422379,2422379,0,1816783,3027972,"USA",2422378
1,184.0,"Northern Africa",1061113,0,1061113,796191,1326986,"EGY",1061589
1,184.0,"Russian Federation",5118934,3396701,1722233,3834593,6390988,"RUS",5112791
1,184.0,"Western Africa",163290,0,163290,122456,204093,"NGA",163275
1,184.0,"South America",1565683,1351959,213724,1174207,1957012,"BRA",1565610
1,184.0,"Northern Europe",1483844,1483844,0,1112810,1854683,"GBR",1483747
1,184.0,"Northern America",612231,612231,0,459172,765287,"CAN",612230
1,184.0,"Oceania",336028,336028,0,252018,420031,"NZL",336025
1,184.0,"Eastern Africa",144702,0,144702,108552,180921,"ETH",144737
1,184.0,"Middle Africa",58094,0,58094,43566,72610,"AGO",58088
1,184.0,"Eastern Europe",3728231,3717019,11212,2795976,4659960,"POL",3727968
1,184.0,"Central Asia",1339116,1338680,436,1013631,1689386,"UZB",1351509
1,184.0,"Southern Europe",287688,0,287688,215748,359581,"ITA",287665
1,184.0,"Central America",166829,0,166829,125121,208535,"MEX",166828
1,184.0,"Southern Asia",392906,0,392906,295667,492778,"IRN",394223
1,184.0,"Western Asia",201903,0,201903,151525,252542,"IRQ",202034
1,184.0,"Eastern Asia",775932,0,775932,582291,970485,"JPN",776388
1,184.0,"Southern Africa",51079,0,51079,38403,64005,"ZAF",51204
1,184.0,"South-Eastern Asia",478351,0,478351,358812,598021,"IDN",478417
1,184.0,"Caribbean",148668,0,148668,111500,185833,"CUB",148667
1,185.0,"Pakistan",1395434,1191099,204335,1049896,1749827,"PAK",1399862
1,185.0,"India",4825727,4824805,922,3612177,6020296,"IND",4816237
1,185.0,"Western Europe",2407031,2407031,0,1805272,3008787,"NLD",2407030
1,185.0,"China",9004838,7755038,1249800,6760551,11267586,"CPR",9014069
1,185.0,"United States of America",2422379,2422379,0,1816783,3027972,"USA",2422378
1,185.0,"Northern Africa",1061802,0,1061802,796191,1326986,"EGY",1061589
1,185.0,"Russian Federation",5110846,3393701,1717145,3834593,6390988,"RUS",5112791
1,185.0,"Western Africa",162656,0,162656,122456,204093,"NGA",163275
1,185.0,"South America",1565604,1351988,213616,1174207,1957012,"BRA",1565610
1,185.0,"Northern Europe",1483772,1483772,0,1112810,1854683,"GBR",1483747
1,185.0,"Northern America",612231,612231,0,459172,765287,"CAN",612230
1,185.0,"Oceania",336026,336026,0,252018,420031,"NZL",336025
1,185.0,"Eastern Africa",143397,0,143397,108552,180921,"ETH",144737
1,185.0,"Middle Africa",57861,0,57861,43566,72610,"AGO",58088
1,185.0,"Eastern Europe",3690618,3679406,11212,2795976,4659960,"POL",3727968
1,185.0,"Central Asia",1362018,1358932,3086,1013631,1689386,"UZB",1351509
1,185.0,"Southern Europe",286326,0,286326,215748,359581,"ITA",287665
1,185.0,"Central America",166829,0,166829,125121,208535,"MEX",166828
1,185.0,"Southern Asia",392642,0,392642,295667,492778,"IRN",394223
1,185.0,"Western Asia",200297,0,200297,151525,252542,"IRQ",202034
1,185.0,"Eastern Asia",772760,0,772760,582291,970485,"JPN",776388
1,185.0,"Southern Africa",50956,0,50956,38403,64005,"ZAF",51204
1,185.0,"South-Eastern Asia",478486,0,478486,358812,598021,"IDN",478417
1,185.0,"Caribbean",148668,0,148668,111500,185833,"CUB",148667
1,186.0,"Pakistan",1402230,1191363,210867,1049896,1749827,"PAK",1399862
1,186.0,"India",4818560,4818440,120,3612177,6020296,"IND",4816237
1,186.0,"Western Europe",2407031,2407031,0,1805272,3008787,"NLD",2407030
1,186.0,"China",9036850,7758840,1278010,6760551,11267586,"CPR",9014069
1,186.0,"United States of America",2422379,2422379,0,1816783,3027972,"USA",2422378
1,186.0,"Northern Africa",1061030,0,1061030,796191,1326986,"EGY",1061589
1,186.0,"Russian Federation",5106995,3385955,1721040,3834593,6390988,"RUS",5112791
1,186.0,"Western Africa",162963,0,162963,122456,204093,"NGA",163275
1,186.0,"South America",1565607,1351991,213616,1174207,1957012,"BRA",1565610
1,186.0,"Northern Europe",1468816,1468816,0,1112810,1854683,"GBR",1483747
1,186.0,"Northern America",612231,612231,0,459172,765287,"CAN",612230
1,186.0,"Oceania",334335,334335,0,252018,420031,"NZL",336025
1,186.0,"Eastern Africa",145617,0,145617,108552,180921,"ETH",144737
1,186.0,"Middle Africa",57989,0,57989,43566,72610,"AGO",58088
1,186.0,"Eastern Europe",3755910,3742387,13523,2795976,4659960,"POL",3727968
1,186.0,"Central Asia",1337097,1336378,719,1013631,1689386,"UZB",1351509
1,186.0,"Southern Europe",287550,0,287550,215748,359581,"ITA",287665
1,186.0,"Central America",166827,0,166827,125121,208535,"MEX",166828
1,186.0,"Southern Asia",394639,0,394639,295667,492778,"IRN",394223
1,186.0,"Western Asia",203053,0,203053,151525,252542,"IRQ",202034
1,186.0,"Eastern Asia",777231,0,777231,582291,970485,"JPN",776388
1,186.0,"Southern Africa",51310,0,51310,38403,64005,"ZAF",51204
1,186.0,"South-Eastern Asia",476222,0,476222,358812,598021,"IDN",478417
1,186.0,"Caribbean",148665,0,148665,111500,185833,"CUB",148667
1,187.0,"Pakistan",1399857,1191389,208468,1049896,1749827,"PAK",1399862
1,187.0,"India",4804650,4804650,0,3612177,6020296,"IND",4816237
1,187.0,"Western Europe",2407031,2407031,0,1805272,3008787,"NLD",2407030
1,187.0,"China",9055851,7764970,1290881,6760551,11267586,"CPR",9014069
1,187.0,"United States of America",2422379,2422379,0,1816783,3027972,"USA",2422378
1,187.0,"Northern Africa",1062011,0,1062011,796191,1326986,"EGY",1061589
1,187.0,"Russian Federation",5106933,3388777,1718156,3834593,6390988,"RUS",5112791
1,187.0,"Western Africa",163186,0,163186,122456,204093,"NGA",163275
1,187.0,"South America",1565608,1351992,213616,1174207,1957012,"BRA",1565610
1,187.0,"Northern Europe",1495033,1493031,2002,1112810,1854683,"GBR",1483747
1,187.0,"Northern America",612231,612231,0,459172,765287,"CAN",612230
1,187.0,"Oceania",337283,337283,0,252018,420031,"NZL",336025
1,187.0,"Eastern Africa",143386,0,143386,108552,180921,"ETH",144737
1,187.0,"Middle Africa",58041,0,58041,43566,72610,"AGO",58088
1,187.0,"Eastern Europe",3688265,3676031,12234,2795976,4659960,"POL",3727968
1,187.0,"Central Asia",1364827,1360309,4518,1013631,1689386,"UZB",1351509
1,187.0,"Southern Europe",287065,0,287065,215748,359581,"ITA",287665
1,187.0,"Central America",166829,0,166829,125121,208535,"MEX",166828
1,187.0,"Southern Asia",392825,0,392825,295667,492778,"IRN",394223
1,187.0,"Western Asia",200314,0,200314,151525,252542,"IRQ",202034
1,187.0,"Eastern Asia",773789,0,773789,582291,970485,"JPN",776388
1,187.0,"Southern Africa",50972,0,50972,38403,64005,"ZAF",51204
1,187.0,"South-Eastern Asia",479978,0,479978,358812,598021,"IDN",478417
1,187.0,"Caribbean",148669,0,148669,111500,185833,"CUB",148667
1,188.0,"Pakistan",1358593,1191763,166830,1049896,1749827,"PAK",1399862
1,188.0,"India",4801062,4801062,0,3612177,6020296,"IND",4816237
1,188.0,"Western Europe",2407031,2407031,0,1805272,3008787,"NLD",2407030
1,188.0,"China",9071825,7764731,1307094,6760551,11267586,"CPR",9014069
1,188.0,"United States of America",2422379,2422379,0,1816783,3027972,"USA",2422378
1,188.0,"Northern Africa",1060887,0,1060887,796191,1326986,"EGY",1061589
1,188.0,"Russian Federation",5115492,3391632,1723860,3834593,6390988,"RUS",5112791
1,188.0,"Western Africa",162671,0,162671,122456,204093,"NGA",163275
1,188.0,"South America",1565609,1351993,213616,1174207,1957012,"BRA",1565610
1,188.0,"Northern Europe",1460461,1459939,522,1112810,1854683,"GBR",1483747
1,188.0,"Northern America",612231,612231,0,459172,765287,"CAN",612230
1,188.0,"Oceania",336347,336347,0,252018,420031,"NZL",336025
1,188.0,"Eastern Africa",145916,0,145916,108552,180921,"ETH",144737
1,188.0,"Middle Africa",57897,0,57897,43566,72610,"AGO",58088
1,188.0,"Eastern Europe",3764737,3749419,15318,2795976,4659960,"POL",3727968
1,188.0,"Central Asia",1334496,1333323,1173,1013631,1689386,"UZB",1351509
1,188.0,"Southern Europe",287238,0,287238,215748,359581,"ITA",287665
1,188.0,"Central America",166829,0,166829,125121,208535,"MEX",166828
1,188.0,"Southern Asia",394849,0,394849,295667,492778,"IRN",394223
1,188.0,"Western Asia",203447,0,203447,151525,252542,"IRQ",202034
1,188.0,"Eastern Asia",780210,0,780210,582291,970485,"JPN",776388
1,188.0,"Southern Africa",51362,0,51362,38403,64005,"ZAF",51204
1,188.0,"South-Eastern Asia",478731,0,478731,358812,598021,"IDN",478417
1,188.0,"Caribbean",148668,0,148668,111500,185833,"CUB",148667
1,189.0,"Pakistan",1402044,1194936,207108,1049896,1749827,"PAK",1399862
1,189.0,"India",4800077,4800077,0,3612177,6020296,"IND",4816237
1,189.0,"Western Europe",2407031,2407031,0,1805272,3008787,"NLD",2407030
1,189.0,"China",9047717,7755753,1291964,6760551,11267586,"CPR",9014069
1,189.0,"United States of America",2422379,2422379,0,1816783,3027972,"USA",2422378
1,189.0,"Northern Africa",1062369,0,1062369,796191,1326986,"EGY",1061589
1,189.0,"Russian Federation",5103185,3381609,1721576,3834593,6390988,"RUS",5112791
1,189.0,"Western Africa",164165,0,164165,122456,204093,"NGA",163275
1,189.0,"South America",1562181,1348565,213616,1174207,1957012,"BRA",1565610
1,189.0,"Northern Europe",1504059,1497972,6087,1112810,1854683,"GBR",1483747
1,189.0,"Northern America",612231,612231,0,459172,765287,"CAN",612230
1,189.0,"Oceania",336108,336108,0,252018,420031,"NZL",336025
1,189.0,"Eastern Africa",144493,0,144493,108552,180921,"ETH",144737
1,189.0,"Middle Africa",58386,0,58386,43566,72610,"AGO",58088
1,189.0,"Eastern Europe",3718565,3704748,13817,2795976,4659960,"POL",3727968
1,189.0,"Central Asia",1367626,1362012,5614,1013631,1689386,"UZB",1351509
1,189.0,"Southern Europe",288837,0,288837,215748,359581,"ITA",287665
1,189.0,"Central America",166829,0,166829,125121,208535,"MEX",166828
1,189.0,"Southern Asia",395428,0,395428,295667,492778,"IRN",394223
1,189.0,"Western Asia",201943,0,201943,151525,252542,"IRQ",202034
1,189.0,"Eastern Asia",776036,0,776036,582291,970485,"JPN",776388
1,189.0,"Southern Africa",51203,0,51203,38403,64005,"ZAF",51204
1,189.0,"South-Eastern Asia",478408,0,478408,358812,598021,"IDN",478417
1,189.0,"Caribbean",148668,0,148668,111500,185833,"CUB",148667
1,190.0,"Pakistan",1428815,1197153,231662,1049896,1749827,"PAK",1399862
1,190.0,"India",4799826,4799519,307,3612177,6020296,"IND",4816237
1,190.0,"Western Europe",2407031,2407031,0,1805272,3008787,"NLD",2407030
1,190.0,"China",9045534,7755287,1290247,6760551,11267586,"CPR",9014069
1,190.0,"United States of America",2422379,2422379,0,1816783,3027972,"USA",2422378
1,190.0,"Northern Africa",1061050,0,1061050,796191,1326986,"EGY",1061589
1,190.0,"Russian Federation",5120773,3387297,1733476,3834593,6390988,"RUS",5112791
1,190.0,"Western Africa",163625,0,163625,122456,204093,"NGA",163275
1,190.0,"South America",1564715,1350368,214347,1174207,1957012,"BRA",1565610
1,190.0,"Northern Europe",1485200,1483651,1549,1112810,1854683,"GBR",1483747
1,190.0,"Northern America",612231,612231,0,459172,765287,"CAN",612230
1,190.0,"Oceania",336048,336048,0,252018,420031,"NZL",336025
1,190.0,"Eastern Africa",145151,0,145151,108552,180921,"ETH",144737
1,190.0,"Middle Africa",58214,0,58214,43566,72610,"AGO",58088
1,190.0,"Eastern Europe",3744304,3729448,14856,2795976,4659960,"POL",3727968
1,190.0,"Central Asia",1335139,1333756,1383,1013631,1689386,"UZB",1351509
1,190.0,"Southern Europe",288363,0,288363,215748,359581,"ITA",287665
1,190.0,"Central America",166829,0,166829,125121,208535,"MEX",166828
1,190.0,"Southern Asia",393854,0,393854,295667,492778,"IRN",394223
1,190.0,"Western Asia",202510,0,202510,151525,252542,"IRQ",202034
1,190.0,"Eastern Asia",778031,0,778031,582291,970485,"JPN",776388
1,190.0,"Southern Africa",51156,0,51156,38403,64005,"ZAF",51204
1,190.0,"South-Eastern Asia",478327,0,478327,358812,598021,"IDN",478417
1,190.0,"Caribbean",148668,0,148668,111500,185833,"CUB",148667
1,191.0,"Pakistan",1416885,1198052,218833,1049896,1749827,"PAK",1399862
1,191.0,"India",4799597,4798694,903,3612177,6020296,"IND",4816237
1,191.0,"Western Europe",2407031,2407031,0,1805272,3008787,"NLD",2407030
1,191.0,"China",9042764,7752038,1290726,6760551,11267586,"CPR",9014069
1,191.0,"United States of America",2422379,2422379,0,1816783,3027972,"USA",2422378
1,191.0,"Northern Africa",1062287,0,1062287,796191,1326986,"EGY",1061589
1,191.0,"Russian Federation",5123683,3392106,1731577,3834593,6390988,"RUS",5112791
1,191.0,"Western Africa",163562,0,163562,122456,204093,"NGA",163275
1,191.0,"South America",1565380,1350558,214822,1174207,1957012,"BRA",1565610
1,191.0,"Northern Europe",1487773,1487052,721,1112810,1854683,"GBR",1483747
1,191.0,"Northern America",612231,612231,0,459172,765287,"CAN",612230
1,191.0,"Oceania",336031,336031,0,252018,420031,"NZL",336025
1,191.0,"Eastern Africa",145066,0,145066,108552,180921,"ETH",144737
1,191.0,"Middle Africa",58191,0,58191,43566,72610,"AGO",58088
1,191.0,"Eastern Europe",3732068,3717918,14150,2795976,4659960,"POL",3727968
1,191.0,"Central Asia",1367846,1362520,5326,1013631,1689386,"UZB",1351509
1,191.0,"Southern Europe",288124,0,288124,215748,359581,"ITA",287665
1,191.0,"Central America",166829,0,166829,125121,208535,"MEX",166828
1,191.0,"Southern Asia",396164,0,396164,295667,492778,"IRN",394223
1,191.0,"Western Asia",202590,0,202590,151525,252542,"IRQ",202034
1,191.0,"Eastern Asia",777071,0,777071,582291,970485,"JPN",776388
1,191.0,"Southern Africa",51419,0,51419,38403,64005,"ZAF",51204
1,191.0,"South-Eastern Asia",478303,0,478303,358812,598021,"IDN",478417
1,191.0,"Caribbean",148668,0,148668,111500,185833,"CUB",148667
1,192.0,"Pakistan",1388924,1197620,191304,1049896,1749827,"PAK",1399862
1,192.0,"India",4836715,4833084,3631,3612177,6020296,"IND",4816237
1,192.0,"Western Europe",2407031,2407031,0,1805272,3008787,"NLD",2407030
1,192.0,"China",9041979,7753896,1288083,6760551,11267586,"CPR",9014069
1,192.0,"United States of America",2422379,2422379,0,1816783,3027972,"USA",2422378
1,192.0,"Northern Africa",1061771,0,1061771,796191,1326986,"EGY",1061589
1,192.0,"Russian Federation",5124466,3395475,1728991,3834593,6390988,"RUS",5112791
1,192.0,"Western Africa",163349,0,163349,122456,204093,"NGA",163275
1,192.0,"South America",1565553,1350324,215229,1174207,1957012,"BRA",1565610
1,192.0,"Northern Europe",1484734,1484591,143,1112810,1854683,"GBR",1483747
1,192.0,"Northern America",612231,612231,0,459172,765287,"CAN",612230
1,192.0,"Oceania",336027,336027,0,252018,420031,"NZL",336025
1,192.0,"Eastern Africa",144823,0,144823,108552,180921,"ETH",144737
1,192.0,"Middle Africa",58115,0,58115,43566,72610,"AGO",58088
1,192.0,"Eastern Europe",3729015,3714876,14139,2795976,4659960,"POL",3727968
1,192.0,"Central Asia",1355623,1354335,1288,1013631,1689386,"UZB",1351509
1,192.0,"Southern Europe",287784,0,287784,215748,359581,"ITA",287665
1,192.0,"Central America",166829,0,166829,125121,208535,"MEX",166828
1,192.0,"Southern Asia",394724,0,394724,295667,492778,"IRN",394223
1,192.0,"Western Asia",202178,0,202178,151525,252542,"IRQ",202034
1,192.0,"Eastern Asia",776577,0,776577,582291,970485,"JPN",776388
1,192.0,"Southern Africa",51263,0,51263,38403,64005,"ZAF",51204
1,192.0,"South-Eastern Asia",478563,0,478563,358812,598021,"IDN",478417
1,192.0,"Caribbean",148668,0,148668,111500,185833,"CUB",148667
1,193.0,"Pakistan",1397357,1196825,200532,1071323,1785538,"PAK",1428431
1,193.0,"India",4833755,4830203,3552,3685896,6143160,"IND",4914528
1,193.0,"Western Europe",2413089,2413089,0,1842115,3070192,"NLD",2456154
1,193.0,"China",9003713,7753075,1250638,6898522,11497537,"CPR",9198030
1,193.0,"United States of America",2428476,2428476,0,1853861,3089768,"USA",2471815
1,193.0,"Northern Africa",1063775,0,1063775,812441,1354068,"EGY",1083255
1,193.0,"Russian Federation",5128901,3398432,1730469,3912850,6521417,"RUS",5217134
1,193.0,"Western Africa",163706,0,163706,124956,208260,"NGA",166608
1,193.0,"South America",1566140,1349979,216161,1198171,1996952,"BRA",1597562
1,193.0,"Northern Europe",1487698,1487698,0,1135521,1892535,"GBR",1514028
1,193.0,"Northern America",613772,613772,0,468543,780906,"CAN",624725
1,193.0,"Oceania",336872,336872,0,257162,428603,"NZL",342883
1,193.0,"Eastern Africa",145086,0,145086,110768,184613,"ETH",147691
1,193.0,"Middle Africa",58241,0,58241,44455,74092,"AGO",59274
1,193.0,"Eastern Europe",3737620,3723448,14172,2853036,4755061,"POL",3804049
1,193.0,"Central Asia",1342319,1342021,298,1034318,1723863,"UZB",1379091
1,193.0,"Southern Europe",288419,0,288419,220152,366920,"ITA",293536
1,193.0,"Central America",167249,0,167249,127674,212791,"MEX",170233
1,193.0,"Southern Asia",394084,0,394084,301701,502836,"IRN",402269
1,193.0,"Western Asia",202445,0,202445,154618,257697,"IRQ",206158
1,193.0,"Eastern Asia",777914,0,777914,594174,990291,"JPN",792233
1,193.0,"Southern Africa",51236,0,51236,39186,65311,"ZAF",52249
1,193.0,"South-Eastern Asia",479662,0,479662,366135,610226,"IDN",488181
1,193.0,"Caribbean",149041,0,149041,113776,189627,"CUB",151702
1,194.0,"Pakistan",1407937,1197743,210194,1071323,1785538,"PAK",1428431
1,194.0,"India",4832985,4829716,3269,3685896,6143160,"IND",4914528
1,194.0,"Western Europe",2402519,2402519,0,1842115,3070192,"NLD",2456154
1,194.0,"China",8984048,7752723,1231325,6898522,11497537,"CPR",9198030
1,194.0,"United States of America",2417838,2417838,0,1853861,3089768,"USA",2471815
1,194.0,"Northern Africa",1059960,0,1059960,812441,1354068,"EGY",1083255
1,194.0,"Russian Federation",5120403,3399183,1721220,3912850,6521417,"RUS",5217134
1,194.0,"Western Africa",162820,0,162820,124956,208260,"NGA",166608
1,194.0,"South America",1568776,1351679,217097,1198171,1996952,"BRA",1597562
1,194.0,"Northern Europe",1481020,1481020,0,1135521,1892535,"GBR",1514028
1,194.0,"Northern America",611084,611084,0,468543,780906,"CAN",624725
1,194.0,"Oceania",267869,267869,0,257162,428603,"NZL",342883
1,194.0,"Eastern Africa",144157,0,144157,110768,184613,"ETH",147691
1,194.0,"Middle Africa",57926,0,57926,44455,74092,"AGO",59274
1,194.0,"Eastern Europe",3711719,3697608,14111,2853036,4755061,"POL",3804049
1,194.0,"Central Asia",1359396,1356858,2538,1034318,1723863,"UZB",1379091
1,194.0,"Southern Europe",286802,0,286802,220152,366920,"ITA",293536
1,194.0,"Central America",166442,0,166442,127674,212791,"MEX",170233
1,194.0,"Southern Asia",393710,0,393710,301701,502836,"IRN",402269
1,194.0,"Western Asia",201295,0,201295,154618,257697,"IRQ",206158
1,194.0,"Eastern Asia",700649,0,700649,594174,990291,"JPN",792233
1,194.0,"Southern Africa",51099,0,51099,39186,65311,"ZAF",52249
1,194.0,"South-Eastern Asia",389321,0,389321,366135,610226,"IDN",488181
1,194.0,"Caribbean",148301,0,148301,113776,189627,"CUB",151702
1,195.0,"Pakistan",1409480,1198595,210885,1071323,1785538,"PAK",1428431
1,195.0,"India",4819142,4818157,985,3685896,6143160,"IND",4914528
1,195.0,"Western Europe",2448612,2448612,0,1842115,3070192,"NLD",2456154
1,195.0,"China",8963250,7767179,1196071,6898522,11497537,"CPR",9198030
1,195.0,"United States of America",2464226,2464226,0,1853861,3089768,"USA",2471815
1,195.0,"Northern Africa",1076651,0,1076651,812441,1354068,"EGY",1083255
1,195.0,"Russian Federation",4746911,3397657,1349254,3912850,6521417,"RUS",5217134
1,195.0,"Western Africa",164922,0,164922,124956,208260,"NGA",166608
1,195.0,"South America",1562622,1342799,219823,1198171,1996952,"BRA",1597562
1,195.0,"Northern Europe",1501812,1501812,0,1135521,1892535,"GBR",1514028
1,195.0,"Northern America",622799,622799,0,468543,780906,"CAN",624725
1,195.0,"Oceania",330328,300450,29878,257162,428603,"NZL",342883
1,195.0,"Eastern Africa",144343,0,144343,110768,184613,"ETH",147691
1,195.0,"Middle Africa",58660,0,58660,44455,74092,"AGO",59274
1,195.0,"Eastern Europe",3732855,3717993,14862,2853036,4755061,"POL",3804049
1,195.0,"Central Asia",1301398,1300821,577,1034318,1723863,"UZB",1379091
1,195.0,"Southern Europe",290310,0,290310,220152,366920,"ITA",293536
1,195.0,"Central America",169692,0,169692,127674,212791,"MEX",170233
1,195.0,"Southern Asia",390627,0,390627,301701,502836,"IRN",402269
1,195.0,"Western Asia",201762,0,201762,154618,257697,"IRQ",206158
1,195.0,"Eastern Asia",778645,0,778645,594174,990291,"JPN",792233
1,195.0,"Southern Africa",50897,0,50897,39186,65311,"ZAF",52249
1,195.0,"South-Eastern Asia",470312,0,470312,366135,610226,"IDN",488181
1,195.0,"Caribbean",151216,0,151216,113776,189627,"CUB",151702
1,196.0,"Pakistan",1394119,1192229,201890,1071323,1785538,"PAK",1428431
1,196.0,"India",4800957,4798740,2217,3685896,6143160,"IND",4914528
1,196.0,"Western Europe",2386469,2386469,0,1842115,3070192,"NLD",2456154
1,196.0,"China",8911447,7732534,1178913,6898522,11497537,"CPR",9198030
1,196.0,"United States of America",2451289,2451289,0,1853861,3089768,"USA",2471815
1,196.0,"Northern Africa",1055208,0,1055208,812441,1354068,"EGY",1083255
1,196.0,"Russian Federation",4926259,3401246,1525013,3912850,6521417,"RUS",5217134
1,196.0,"Western Africa",163528,0,163528,124956,208260,"NGA",166608
1,196.0,"South America",1569116,1338892,230224,1198171,1996952,"BRA",1597562
1,196.0,"Northern Europe",1491858,1491509,349,1135521,1892535,"GBR",1514028
1,196.0,"Northern America",619534,619534,0,468543,780906,"CAN",624725
1,196.0,"Oceania",375969,319628,56341,257162,428603,"NZL",342883
1,196.0,"Eastern Africa",145505,0,145505,110768,184613,"ETH",147691
1,196.0,"Middle Africa",58169,0,58169,44455,74092,"AGO",59274
1,196.0,"Eastern Europe",3736653,3717698,18955,2853036,4755061,"POL",3804049
1,196.0,"Central Asia",1396363,1363590,32773,1034318,1723863,"UZB",1379091
1,196.0,"Southern Europe",288038,0,288038,220152,366920,"ITA",293536
1,196.0,"Central America",168851,0,168851,127674,212791,"MEX",170233
1,196.0,"Southern Asia",398433,0,398433,301701,502836,"IRN",402269
1,196.0,"Western Asia",202919,0,202919,154618,257697,"IRQ",206158
1,196.0,"Eastern Asia",820584,0,820584,594174,990291,"JPN",792233
1,196.0,"Southern Africa",51610,0,51610,39186,65311,"ZAF",52249
1,196.0,"South-Eastern Asia",530451,0,530451,366135,610226,"IDN",488181
1,196.0,"Caribbean",150479,0,150479,113776,189627,"CUB",151702
1,197.0,"Pakistan",1403985,1190524,213461,1071323,1785538,"PAK",1428431
1,197.0,"India",4665576,4661025,4551,3685896,6143160,"IND",4914528
1,197.0,"Western Europe",2418379,2415790,2589,1842115,3070192,"NLD",2456154
1,197.0,"China",8933710,7722341,1211369,6898522,11497537,"CPR",9198030
1,197.0,"United States of America",2460261,2460261,0,1853861,3089768,"USA",2471815
1,197.0,"Northern Africa",1065975,0,1065975,812441,1354068,"EGY",1083255
1,197.0,"Russian Federation",5093119,3400840,1692279,3912850,6521417,"RUS",5217134
1,197.0,"Western Africa",161745,0,161745,124956,208260,"NGA",166608
1,197.0,"South America",1578487,1338422,240065,1198171,1996952,"BRA",1597562
1,197.0,"Northern Europe",1434808,1434808,0,1135521,1892535,"GBR",1514028
1,197.0,"Northern America",621801,621801,0,468543,780906,"CAN",624725
1,197.0,"Oceania",372843,297839,75004,257162,428603,"NZL",342883
1,197.0,"Eastern Africa",146722,0,146722,110768,184613,"ETH",147691
1,197.0,"Middle Africa",57642,0,57642,44455,74092,"AGO",59274
1,197.0,"Eastern Europe",3765837,3743391,22446,2853036,4755061,"POL",3804049
1,197.0,"Central Asia",1408335,1389288,19047,1034318,1723863,"UZB",1379091
1,197.0,"Southern Europe",285997,0,285997,220152,366920,"ITA",293536
1,197.0,"Central America",169465,0,169465,127674,212791,"MEX",170233
1,197.0,"Southern Asia",401693,0,401693,301701,502836,"IRN",402269
1,197.0,"Western Asia",204667,0,204667,154618,257697,"IRQ",206158
1,197.0,"Eastern Asia",816057,0,816057,594174,990291,"JPN",792233
1,197.0,"Southern Africa",52124,0,52124,39186,65311,"ZAF",52249
1,197.0,"South-Eastern Asia",525638,0,525638,366135,610226,"IDN",488181
1,197.0,"Caribbean",151026,0,151026,113776,189627,"CUB",151702
1,198.0,"Pakistan",1463035,1247695,215340,1071323,1785538,"PAK",1428431
1,198.0,"India",4732534,4698984,33550,3685896,6143160,"IND",4914528
1,198.0,"Western Europe",2445631,2439580,6051,1842115,3070192,"NLD",2456154
1,198.0,"China",8982618,7716868,1265750,6898522,11497537,"CPR",9198030
1,198.0,"United States of America",2450019,2450019,0,1853861,3089768,"USA",2471815
1,198.0,"Northern Africa",1079325,0,1079325,812441,1354068,"EGY",1083255
1,198.0,"Russian Federation",5219111,3401319,1817792,3912850,6521417,"RUS",5217134
1,198.0,"Western Africa",166666,0,166666,124956,208260,"NGA",166608
1,198.0,"South America",1587175,1338009,249166,1198171,1996952,"BRA",1597562
1,198.0,"Northern Europe",1534592,1513319,21273,1135521,1892535,"GBR",1514028
1,198.0,"Northern America",619212,619212,0,468543,780906,"CAN",624725
1,198.0,"Oceania",348587,301722,46865,257162,428603,"NZL",342883
1,198.0,"Eastern Africa",146231,0,146231,110768,184613,"ETH",147691
1,198.0,"Middle Africa",59335,0,59335,44455,74092,"AGO",59274
1,198.0,"Eastern Europe",3796475,3770739,25736,2853036,4755061,"POL",3804049
1,198.0,"Central Asia",1264258,1259186,5072,1034318,1723863,"UZB",1379091
1,198.0,"Southern Europe",293180,0,293180,220152,366920,"ITA",293536
1,198.0,"Central America",168735,0,168735,127674,212791,"MEX",170233
1,198.0,"Southern Asia",392841,0,392841,301701,502836,"IRN",402269
1,198.0,"Western Asia",204278,0,204278,154618,257697,"IRQ",206158
1,198.0,"Eastern Asia",791013,0,791013,594174,990291,"JPN",792233
1,198.0,"Southern Africa",51249,0,51249,39186,65311,"ZAF",52249
1,198.0,"South-Eastern Asia",491167,0,491167,366135,610226,"IDN",488181
1,198.0,"Caribbean",150370,0,150370,113776,189627,"CUB",151702
1,199.0,"Pakistan",1272705,1160844,111861,1071323,1785538,"PAK",1428431
1,199.0,"India",4817225,4746082,71143,3685896,6143160,"IND",4914528
1,199.0,"Western Europe",2504190,2497489,6701,1842115,3070192,"NLD",2456154
1,199.0,"China",8978390,7693933,1284457,6898522,11497537,"CPR",9198030
1,199.0,"United States of America",2472308,2472308,0,1853861,3089768,"USA",2471815
1,199.0,"Northern Africa",1103423,0,1103423,812441,1354068,"EGY",1083255
1,199.0,"Russian Federation",5308861,3401117,1907744,3912850,6521417,"RUS",5217134
1,199.0,"Western Africa",169544,0,169544,124956,208260,"NGA",166608
1,199.0,"South America",1595632,1336545,259087,1198171,1996952,"BRA",1597562
1,199.0,"Northern Europe",1543634,1525701,17933,1135521,1892535,"GBR",1514028
1,199.0,"Northern America",624845,624845,0,468543,780906,"CAN",624725
1,199.0,"Oceania",345413,323786,21627,257162,428603,"NZL",342883
1,199.0,"Eastern Africa",145949,0,145949,110768,184613,"ETH",147691
1,199.0,"Middle Africa",59774,0,59774,44455,74092,"AGO",59274
1,199.0,"Eastern Europe",3763384,3736858,26526,2853036,4755061,"POL",3804049
1,199.0,"Central Asia",1456577,1410220,46357,1034318,1723863,"UZB",1379091
1,199.0,"Southern Europe",297912,0,297912,220152,366920,"ITA",293536
1,199.0,"Central America",170263,0,170263,127674,212791,"MEX",170233
1,199.0,"Southern Asia",404648,0,404648,301701,502836,"IRN",402269
1,199.0,"Western Asia",203568,0,203568,154618,257697,"IRQ",206158
1,199.0,"Eastern Asia",791190,0,791190,594174,990291,"JPN",792233
1,199.0,"Southern Africa",52713,0,52713,39186,65311,"ZAF",52249
1,199.0,"South-Eastern Asia",495245,0,495245,366135,610226,"IDN",488181
1,199.0,"Caribbean",151728,0,151728,113776,189627,"CUB",151702
1,200.0,"Pakistan",1406513,1225440,181073,1071323,1785538,"PAK",1428431
1,200.0,"India",4848851,4742249,106602,3685896,6143160,"IND",4914528
1,200.0,"Western Europe",2424775,2423097,1678,1842115,3070192,"NLD",2456154
1,200.0,"China",9292426,8171650,1120776,6898522,11497537,"CPR",9198030
1,200.0,"United States of America",2478247,2478247,0,1853861,3089768,"USA",2471815
1,200.0,"Northern Africa",1070189,0,1070189,812441,1354068,"EGY",1083255
1,200.0,"Russian Federation",5378849,3617852,1760997,3912850,6521417,"RUS",5217134
1,200.0,"Western Africa",161121,0,161121,124956,208260,"NGA",166608
1,200.0,"South America",1601285,1330547,270738,1198171,1996952,"BRA",1597562
1,200.0,"Northern Europe",1517789,1510118,7671,1135521,1892535,"GBR",1514028
1,200.0,"Northern America",626351,626351,0,468543,780906,"CAN",624725
1,200.0,"Oceania",344222,338728,5494,257162,428603,"NZL",342883
1,200.0,"Eastern Africa",102699,0,102699,110768,184613,"ETH",147691
1,200.0,"Middle Africa",56152,0,56152,44455,74092,"AGO",59274
1,200.0,"Eastern Europe",2340652,2304079,36573,2853036,4755061,"POL",3804049
1,200.0,"Central Asia",1314004,1297270,16734,1034318,1723863,"UZB",1379091
1,200.0,"Southern Europe",274226,0,274226,220152,366920,"ITA",293536
1,200.0,"Central America",170675,0,170675,127674,212791,"MEX",170233
1,200.0,"Southern Asia",305970,0,305970,301701,502836,"IRN",402269
1,200.0,"Western Asia",142963,0,142963,154618,257697,"IRQ",206158
1,200.0,"Eastern Asia",688476,0,688476,594174,990291,"JPN",792233
1,200.0,"Southern Africa",40810,0,40810,39186,65311,"ZAF",52249
1,200.0,"South-Eastern Asia",487723,0,487723,366135,610226,"IDN",488181
1,200.0,"Caribbean",152097,0,152097,113776,189627,"CUB",151702
1,201.0,"Pakistan",1430200,1223427,206773,1071323,1785538,"PAK",1428431
1,201.0,"India",4897834,4751294,146540,3685896,6143160,"IND",4914528
1,201.0,"Western Europe",2415808,2411749,4059,1842115,3070192,"NLD",2456154
1,201.0,"China",9058018,8127836,930182,6898522,11497537,"CPR",9198030
1,201.0,"United States of America",2467215,2467215,0,1853861,3089768,"USA",2471815
1,201.0,"Northern Africa",1070394,0,1070394,812441,1354068,"EGY",1083255
1,201.0,"Russian Federation",5079455,3580013,1499442,3912850,6521417,"RUS",5217134
1,201.0,"Western Africa",165418,0,165418,124956,208260,"NGA",166608
1,201.0,"South America",1605033,1327723,277310,1198171,1996952,"BRA",1597562
1,201.0,"Northern Europe",1483942,1479394,4548,1135521,1892535,"GBR",1514028
1,201.0,"Northern America",623563,623563,0,468543,780906,"CAN",624725
1,201.0,"Oceania",324072,322681,1391,257162,428603,"NZL",342883
1,201.0,"Eastern Africa",127398,0,127398,110768,184613,"ETH",147691
1,201.0,"Middle Africa",58836,0,58836,44455,74092,"AGO",59274
1,201.0,"Eastern Europe",2992666,2667736,324930,2853036,4755061,"POL",3804049
1,201.0,"Central Asia",1374520,1334795,39725,1034318,1723863,"UZB",1379091
1,201.0,"Southern Europe",292494,0,292494,220152,366920,"ITA",293536
1,201.0,"Central America",169897,0,169897,127674,212791,"MEX",170233
1,201.0,"Southern Asia",368170,0,368170,301701,502836,"IRN",402269
1,201.0,"Western Asia",177657,0,177657,154618,257697,"IRQ",206158
1,201.0,"Eastern Asia",760019,0,760019,594174,990291,"JPN",792233
1,201.0,"Southern Africa",48049,0,48049,39186,65311,"ZAF",52249
1,201.0,"South-Eastern Asia",469246,0,469246,366135,610226,"IDN",488181
1,201.0,"Caribbean",151397,0,151397,113776,189627,"CUB",151702
1,202.0,"Pakistan",1433015,1215288,217727,1071323,1785538,"PAK",1428431
1,202.0,"India",4908901,4741248,167653,3685896,6143160,"IND",4914528
1,202.0,"Western Europe",2406262,2398180,8082,1842115,3070192,"NLD",2456154
1,202.0,"China",8938442,8069976,868466,6898522,11497537,"CPR",9198030
1,202.0,"United States of America",2470598,2470598,0,1853861,3089768,"USA",2471815
1,202.0,"Northern Africa",1066975,0,1066975,812441,1354068,"EGY",1083255
1,202.0,"Russian Federation",5043720,3565971,1477749,3912850,6521417,"RUS",5217134
1,202.0,"Western Africa",166199,0,166199,124956,208260,"NGA",166608
1,202.0,"South America",1582217,1310742,271475,1198171,1996952,"BRA",1597562
1,202.0,"Northern Europe",1485797,1477828,7969,1135521,1892535,"GBR",1514028
1,202.0,"Northern America",624417,624417,0,468543,780906,"CAN",624725
1,202.0,"Oceania",332397,321635,10762,257162,428603,"NZL",342883
1,202.0,"Eastern Africa",140632,0,140632,110768,184613,"ETH",147691
1,202.0,"Middle Africa",58888,0,58888,44455,74092,"AGO",59274
1,202.0,"Eastern Europe",3463953,2875285,588668,2853036,4755061,"POL",3804049
1,202.0,"Central Asia",796400,748339,48061,1034318,1723863,"UZB",1379091
1,202.0,"Southern Europe",295254,0,295254,220152,366920,"ITA",293536
1,202.0,"Central America",170138,0,170138,127674,212791,"MEX",170233
1,202.0,"Southern Asia",345562,0,345562,301701,502836,"IRN",402269
1,202.0,"Western Asia",196805,0,196805,154618,257697,"IRQ",206158
1,202.0,"Eastern Asia",778403,0,778403,594174,990291,"JPN",792233
1,202.0,"Southern Africa",48145,0,48145,39186,65311,"ZAF",52249
1,202.0,"South-Eastern Asia",474345,0,474345,366135,610226,"IDN",488181
1,202.0,"Caribbean",151611,0,151611,113776,189627,"CUB",151702
1,203.0,"Pakistan",1424809,1204511,220298,1071323,1785538,"PAK",1428431
1,203.0,"India",4885980,4706504,179476,3685896,6143160,"IND",4914528
1,203.0,"Western Europe",2402212,2386648,15564,1842115,3070192,"NLD",2456154
1,203.0,"China",8884087,8053429,830658,6898522,11497537,"CPR",9198030
1,203.0,"United States of America",2490391,2490391,0,1853861,3089768,"USA",2471815
1,203.0,"Northern Africa",1045278,0,1045278,812441,1354068,"EGY",1083255
1,203.0,"Russian Federation",5009515,3549958,1459557,3912850,6521417,"RUS",5217134
1,203.0,"Western Africa",158650,0,158650,124956,208260,"NGA",166608
1,203.0,"South America",1565709,1286824,278885,1198171,1996952,"BRA",1597562
1,203.0,"Northern Europe",1457702,1443265,14437,1135521,1892535,"GBR",1514028
1,203.0,"Northern America",557774,557774,0,468543,780906,"CAN",624725
1,203.0,"Oceania",344113,321138,22975,257162,428603,"NZL",342883
1,203.0,"Eastern Africa",145484,0,145484,110768,184613,"ETH",147691
1,203.0,"Middle Africa",57616,0,57616,44455,74092,"AGO",59274
1,203.0,"Eastern Europe",3780214,2980548,799666,2853036,4755061,"POL",3804049
1,203.0,"Central Asia",989375,803614,185761,1034318,1723863,"UZB",1379091
1,203.0,"Southern Europe",282082,0,282082,220152,366920,"ITA",293536
1,203.0,"Central America",170748,0,170748,127674,212791,"MEX",170233
1,203.0,"Southern Asia",370714,0,370714,301701,502836,"IRN",402269
1,203.0,"Western Asia",203364,0,203364,154618,257697,"IRQ",206158
1,203.0,"Eastern Asia",784890,0,784890,594174,990291,"JPN",792233
1,203.0,"Southern Africa",51127,0,51127,39186,65311,"ZAF",52249
1,203.0,"South-Eastern Asia",477467,0,477467,366135,610226,"IDN",488181
1,203.0,"Caribbean",151748,0,151748,113776,189627,"CUB",151702
1,204.0,"Pakistan",1399780,1191091,208689,1071331,1785552,"PAK",1428442
1,204.0,"India",4838057,4664967,173090,3685909,6143182,"IND",4914546
1,204.0,"Western Europe",2335224,2314329,20895,1842117,3070196,"NLD",2456157
1,204.0,"China",8854599,8000138,854461,6898530,11497551,"CPR",9198041
1,204.0,"United States of America",2489155,2489155,0,1853877,3089795,"USA",2471836
1,204.0,"Northern Africa",1047839,0,1047839,812439,1354065,"EGY",1083252
1,204.0,"Russian Federation",5079468,3538655,1540813,3912858,6521430,"RUS",5217144
1,204.0,"Western Africa",163735,0,163735,124961,208268,"NGA",166615
1,204.0,"South America",1551397,1267594,283803,1198184,1996973,"BRA",1597579
1,204.0,"Northern Europe",1440498,1416930,23568,1135522,1892537,"GBR",1514030
1,204.0,"Northern America",628853,604037,24816,468549,780915,"CAN",624732
1,204.0,"Oceania",327816,302225,25591,257168,428613,"NZL",342891
1,204.0,"Eastern Africa",156879,0,156879,110770,184617,"ETH",147694
1,204.0,"Middle Africa",58218,0,58218,44459,74098,"AGO",59279
1,204.0,"Eastern Europe",4007446,3040368,967078,2853039,4755065,"POL",3804052
1,204.0,"Central Asia",1159241,837474,321767,1034328,1723880,"UZB",1379104
1,204.0,"Southern Europe",290353,0,290353,220144,366907,"ITA",293526
1,204.0,"Central America",171440,0,171440,127671,212786,"MEX",170229
1,204.0,"Southern Asia",416108,0,416108,301705,502842,"IRN",402274
1,204.0,"Western Asia",218926,0,218926,154614,257691,"IRQ",206153
1,204.0,"Eastern Asia",815655,0,815655,594185,990308,"JPN",792247
1,204.0,"Southern Africa",54061,0,54061,39189,65316,"ZAF",52253
1,204.0,"South-Eastern Asia",475543,0,475543,366147,610246,"IDN",488197
1,204.0,"Caribbean",152781,0,152781,113778,189631,"CUB",151705
1,205.0,"Pakistan",1409758,1183496,226262,1118961,1864936,"PAK",1491949
1,205.0,"India",4807589,4630929,176660,3694773,6157955,"IND",4926364
1,205.0,"Western Europe",2362953,2324289,38664,2106949,3511582,"NLD",2809266
1,205.0,"China",8862945,7978410,884535,7001106,11668510,"CPR",9334808
1,205.0,"United States of America",2482474,2482474,0,2032336,3387227,"USA",2709782
1,205.0,"Northern Africa",1057319,0,1057319,801744,1336241,"EGY",1068993
1,205.0,"Russian Federation",5121674,3534265,1587409,3015201,5025335,"RUS",4020268
1,205.0,"Western Africa",164494,0,164494,128324,213873,"NGA",171099
1,205.0,"South America",1559691,1254379,305312,1234981,2058302,"BRA",1646642
1,205.0,"Northern Europe",1478319,1434805,43514,1159842,1933071,"GBR",1546457
1,205.0,"Northern America",609250,577543,31707,565638,942730,"CAN",754184
1,205.0,"Oceania",345530,302262,43268,281766,469611,"NZL",375689
1,205.0,"Eastern Africa",160072,0,160072,101014,168357,"ETH",134686
1,205.0,"Middle Africa",58738,0,58738,32062,53437,"AGO",42750
1,205.0,"Eastern Europe",4186731,3102327,1084404,2748510,4580851,"POL",3664681
1,205.0,"Central Asia",1303345,859422,443923,958665,1597775,"UZB",1278220
1,205.0,"Southern Europe",290829,0,290829,254195,423658,"ITA",338927
1,205.0,"Central America",170782,0,170782,165388,275647,"MEX",220518
1,205.0,"Southern Asia",435372,0,435372,291489,485816,"IRN",388653
1,205.0,"Western Asia",223425,0,223425,385795,642992,"IRQ",514394
1,205.0,"Eastern Asia",821548,0,821548,689511,1149185,"JPN",919348
1,205.0,"Southern Africa",55543,0,55543,76278,127130,"ZAF",101704
1,205.0,"South-Eastern Asia",492098,0,492098,422969,704948,"IDN",563959
1,205.0,"Caribbean",152088,0,152088,108593,180988,"CUB",144791
1,206.0,"Pakistan",1367773,1188384,179389,1118961,1864936,"PAK",1491949
1,206.0,"India",4789628,4613644,175984,3694773,6157955,"IND",4926364
1,206.0,"Western Europe",2456691,2400576,56115,2106949,3511582,"NLD",2809266
1,206.0,"China",8913962,7979946,934016,7001106,11668510,"CPR",9334808
1,206.0,"United States of America",2313013,2313013,0,2032336,3387227,"USA",2709782
1,206.0,"Northern Africa",1076740,0,1076740,801744,1336241,"EGY",1068993
1,206.0,"Russian Federation",5138683,3529471,1609212,3015201,5025335,"RUS",4020268
1,206.0,"Western Africa",164447,0,164447,128324,213873,"NGA",171099
1,206.0,"South America",1559058,1252352,306706,1234981,2058302,"BRA",1646642
1,206.0,"Northern Europe",1475295,1417572,57723,1159842,1933071,"GBR",1546457
1,206.0,"Northern America",611838,568062,43776,565638,942730,"CAN",754184
1,206.0,"Oceania",372620,322841,49779,281766,469611,"NZL",375689
1,206.0,"Eastern Africa",160577,0,160577,101014,168357,"ETH",134686
1,206.0,"Middle Africa",58730,0,58730,32062,53437,"AGO",42750
1,206.0,"Eastern Europe",4302568,3170782,1131786,2748510,4580851,"POL",3664681
1,206.0,"Central Asia",1409353,876893,532460,958665,1597775,"UZB",1278220
1,206.0,"Southern Europe",290809,0,290809,254195,423658,"ITA",338927
1,206.0,"Central America",159632,0,159632,165388,275647,"MEX",220518
1,206.0,"Southern Asia",443090,0,443090,291489,485816,"IRN",388653
1,206.0,"Western Asia",228139,0,228139,385795,642992,"IRQ",514394
1,206.0,"Eastern Asia",826360,0,826360,689511,1149185,"JPN",919348
1,206.0,"Southern Africa",57333,0,57333,76278,127130,"ZAF",101704
1,206.0,"South-Eastern Asia",519735,0,519735,422969,704948,"IDN",563959
1,206.0,"Caribbean",142426,0,142426,108593,180988,"CUB",144791
1,207.0,"Pakistan",1394449,1192318,202131,1118961,1864936,"PAK",1491949
1,207.0,"India",4804805,4622608,182197,3694773,6157955,"IND",4926364
1,207.0,"Western Europe",2547334,2485353,61981,2106949,3511582,"NLD",2809266
1,207.0,"China",8975924,8012048,963876,7001106,11668510,"CPR",9334808
1,207.0,"United States of America",2360278,2359254,1024,2032336,3387227,"USA",2709782
1,207.0,"Northern Africa",1014372,0,1014372,801744,1336241,"EGY",1068993
1,207.0,"Russian Federation",4876132,3520442,1355690,3015201,5025335,"RUS",4020268
1,207.0,"Western Africa",163080,0,163080,128324,213873,"NGA",171099
1,207.0,"South America",1551418,1255164,296254,1234981,2058302,"BRA",1646642
1,207.0,"Northern Europe",1519960,1449932,70028,1159842,1933071,"GBR",1546457
1,207.0,"Northern America",709732,653718,56014,565638,942730,"CAN",754184
1,207.0,"Oceania",287270,265629,21641,281766,469611,"NZL",375689
1,207.0,"Eastern Africa",149154,0,149154,101014,168357,"ETH",134686
1,207.0,"Middle Africa",46357,0,46357,32062,53437,"AGO",42750
1,207.0,"Eastern Europe",4247770,3182214,1065556,2748510,4580851,"POL",3664681
1,207.0,"Central Asia",1446140,885769,560371,958665,1597775,"UZB",1278220
1,207.0,"Southern Europe",310987,0,310987,254195,423658,"ITA",338927
1,207.0,"Central America",183335,0,183335,165388,275647,"MEX",220518
1,207.0,"Southern Asia",425559,0,425559,291489,485816,"IRN",388653
1,207.0,"Western Asia",409141,0,409141,385795,642992,"IRQ",514394
1,207.0,"Eastern Asia",796835,0,796835,689511,1149185,"JPN",919348
1,207.0,"Southern Africa",82050,0,82050,76278,127130,"ZAF",101704
1,207.0,"South-Eastern Asia",445058,0,445058,422969,704948,"IDN",563959
1,207.0,"Caribbean",130961,0,130961,108593,180988,"CUB",144791
1,208.0,"Pakistan",1449526,1215168,234358,1118961,1864936,"PAK",1491949
1,208.0,"India",4865287,4698010,167277,3694773,6157955,"IND",4926364
1,208.0,"Western Europe",2765691,2688083,77608,2106949,3511582,"NLD",2809266
1,208.0,"China",9174095,8165928,1008167,7001106,11668510,"CPR",9334808
1,208.0,"United States of America",2552619,2544632,7987,2032336,3387227,"USA",2709782
1,208.0,"Northern Africa",1055757,0,1055757,801744,1336241,"EGY",1068993
1,208.0,"Russian Federation",4149540,3200846,948694,3015201,5025335,"RUS",4020268
1,208.0,"Western Africa",165554,0,165554,128324,213873,"NGA",171099
1,208.0,"South America",1475829,1272178,203651,1234981,2058302,"BRA",1646642
1,208.0,"Northern Europe",1444745,1409358,35387,1159842,1933071,"GBR",1546457
1,208.0,"Northern America",702713,680531,22182,565638,942730,"CAN",754184
1,208.0,"Oceania",379652,326513,53139,281766,469611,"NZL",375689
1,208.0,"Eastern Africa",139837,0,139837,101014,168357,"ETH",134686
1,208.0,"Middle Africa",43568,0,43568,32062,53437,"AGO",42750
1,208.0,"Eastern Europe",3910440,3139527,770913,2748510,4580851,"POL",3664681
1,208.0,"Central Asia",1495208,894868,600340,958665,1597775,"UZB",1278220
1,208.0,"Southern Europe",324451,0,324451,254195,423658,"ITA",338927
1,208.0,"Central America",206617,0,206617,165388,275647,"MEX",220518
1,208.0,"Southern Asia",404665,0,404665,291489,485816,"IRN",388653
1,208.0,"Western Asia",478307,0,478307,385795,642992,"IRQ",514394
1,208.0,"Eastern Asia",893407,0,893407,689511,1149185,"JPN",919348
1,208.0,"Southern Africa",96759,0,96759,76278,127130,"ZAF",101704
1,208.0,"South-Eastern Asia",561713,0,561713,422969,704948,"IDN",563959
1,208.0,"Caribbean",139317,0,139317,108593,180988,"CUB",144791
1,209.0,"Pakistan",1497100,1236907,260193,1118961,1864936,"PAK",1491949
1,209.0,"India",4874620,4772217,102403,3694773,6157955,"IND",4926364
1,209.0,"Western Europe",2721690,2684281,37409,2106949,3511582,"NLD",2809266
1,209.0,"China",9243802,8189230,1054572,7001106,11668510,"CPR",9334808
1,209.0,"United States of America",2918712,2911115,7597,2032336,3387227,"USA",2709782
1,209.0,"Northern Africa",1059134,0,1059134,801744,1336241,"EGY",1068993
1,209.0,"Russian Federation",3709548,3021786,687762,3015201,5025335,"RUS",4020268
1,209.0,"Western Africa",169923,0,169923,128324,213873,"NGA",171099
1,209.0,"South America",1590401,1307448,282953,1234981,2058302,"BRA",1646642
1,209.0,"Northern Europe",1589396,1529771,59625,1159842,1933071,"GBR",1546457
1,209.0,"Northern America",720611,709540,11071,565638,942730,"CAN",754184
1,209.0,"Oceania",360423,331245,29178,281766,469611,"NZL",375689
1,209.0,"Eastern Africa",132146,0,132146,101014,168357,"ETH",134686
1,209.0,"Middle Africa",43436,0,43436,32062,53437,"AGO",42750
1,209.0,"Eastern Europe",3581463,3058064,523399,2748510,4580851,"POL",3664681
1,209.0,"Central Asia",1541330,899155,642175,958665,1597775,"UZB",1278220
1,209.0,"Southern Europe",334404,0,334404,254195,423658,"ITA",338927
1,209.0,"Central America",230444,0,230444,165388,275647,"MEX",220518
1,209.0,"Southern Asia",384384,0,384384,291489,485816,"IRN",388653
1,209.0,"Western Asia",491848,0,491848,385795,642992,"IRQ",514394
1,209.0,"Eastern Asia",905516,0,905516,689511,1149185,"JPN",919348
1,209.0,"Southern Africa",97613,0,97613,76278,127130,"ZAF",101704
1,209.0,"South-Eastern Asia",546989,0,546989,422969,704948,"IDN",563959
1,209.0,"Caribbean",152767,0,152767,108593,180988,"CUB",144791
1,210.0,"Pakistan",1491306,1238188,253118,1118961,1864936,"PAK",1491949
1,210.0,"India",4830897,4750648,80249,3694773,6157955,"IND",4926364
1,210.0,"Western Europe",2742414,2699612,42802,2106949,3511582,"NLD",2809266
1,210.0,"China",9307398,8229992,1077406,7001106,11668510,"CPR",9334808
1,210.0,"United States of America",2632303,2629307,2996,2032336,3387227,"USA",2709782
1,210.0,"Northern Africa",1050070,0,1050070,801744,1336241,"EGY",1068993
1,210.0,"Russian Federation",4033528,3293181,740347,3015201,5025335,"RUS",4020268
1,210.0,"Western Africa",168919,0,168919,128324,213873,"NGA",171099
1,210.0,"South America",1631795,1321121,310674,1234981,2058302,"BRA",1646642
1,210.0,"Northern Europe",1512796,1465628,47168,1159842,1933071,"GBR",1546457
1,210.0,"Northern America",735434,712052,23382,565638,942730,"CAN",754184
1,210.0,"Oceania",372941,340449,32492,281766,469611,"NZL",375689
1,210.0,"Eastern Africa",132630,0,132630,101014,168357,"ETH",134686
1,210.0,"Middle Africa",42614,0,42614,32062,53437,"AGO",42750
1,210.0,"Eastern Europe",3560423,3104790,455633,2748510,4580851,"POL",3664681
1,210.0,"Central Asia",1540430,901843,638587,958665,1597775,"UZB",1278220
1,210.0,"Southern Europe",334096,0,334096,254195,423658,"ITA",338927
1,210.0,"Central America",216197,0,216197,165388,275647,"MEX",220518
1,210.0,"Southern Asia",384849,0,384849,291489,485816,"IRN",388653
1,210.0,"Western Asia",502263,0,502263,385795,642992,"IRQ",514394
1,210.0,"Eastern Asia",906355,0,906355,689511,1149185,"JPN",919348
1,210.0,"Southern Africa",99879,0,99879,76278,127130,"ZAF",101704
1,210.0,"South-Eastern Asia",560319,0,560319,422969,704948,"IDN",563959
1,210.0,"Caribbean",142421,0,142421,108593,180988,"CUB",144791
1,211.0,"Pakistan",1470034,1239083,230951,1118961,1864936,"PAK",1491949
1,211.0,"India",4824776,4750472,74304,3694773,6157955,"IND",4926364
1,211.0,"Western Europe",2789274,2744392,44882,2106949,3511582,"NLD",2809266
1,211.0,"China",9303581,8216654,1086927,7001106,11668510,"CPR",9334808
1,211.0,"United States of America",2514843,2513701,1142,2032336,3387227,"USA",2709782
1,211.0,"Northern Africa",1044628,0,1044628,801744,1336241,"EGY",1068993
1,211.0,"Russian Federation",3833695,3350083,483612,3015201,5025335,"RUS",4020268
1,211.0,"Western Africa",165348,0,165348,128324,213873,"NGA",171099
1,211.0,"South America",1659769,1336816,322953,1234981,2058302,"BRA",1646642
1,211.0,"Northern Europe",1472293,1428343,43950,1159842,1933071,"GBR",1546457
1,211.0,"Northern America",730074,701554,28520,565638,942730,"CAN",754184
1,211.0,"Oceania",398421,367212,31209,281766,469611,"NZL",375689
1,211.0,"Eastern Africa",132767,0,132767,101014,168357,"ETH",134686
1,211.0,"Middle Africa",41559,0,41559,32062,53437,"AGO",42750
1,211.0,"Eastern Europe",3671702,3213171,458531,2748510,4580851,"POL",3664681
1,211.0,"Central Asia",1374649,884407,490242,958665,1597775,"UZB",1278220
1,211.0,"Southern Europe",327838,0,327838,254195,423658,"ITA",338927
1,211.0,"Central America",205853,0,205853,165388,275647,"MEX",220518
1,211.0,"Southern Asia",383599,0,383599,291489,485816,"IRN",388653
1,211.0,"Western Asia",501739,0,501739,385795,642992,"IRQ",514394
1,211.0,"Eastern Asia",906646,0,906646,689511,1149185,"JPN",919348
1,211.0,"Southern Africa",100486,0,100486,76278,127130,"ZAF",101704
1,211.0,"South-Eastern Asia",581613,0,581613,422969,704948,"IDN",563959
1,211.0,"Caribbean",135342,0,135342,108593,180988,"CUB",144791
1,212.0,"Pakistan",1466991,1242246,224745,1118961,1864936,"PAK",1491949
1,212.0,"India",4857336,4781344,75992,3694773,6157955,"IND",4926364
1,212.0,"Western Europe",2913012,2893368,19644,2106949,3511582,"NLD",2809266
1,212.0,"China",9897749,8764660,1133089,7001106,11668510,"CPR",9334808
1,212.0,"United States of America",2739313,2737770,1543,2032336,3387227,"USA",2709782
1,212.0,"Northern Africa",1101577,0,1101577,801744,1336241,"EGY",1068993
1,212.0,"Russian Federation",3886809,3350499,536310,3015201,5025335,"RUS",4020268
1,212.0,"Western Africa",175694,0,175694,128324,213873,"NGA",171099
1,212.0,"South America",1665997,1342349,323648,1234981,2058302,"BRA",1646642
1,212.0,"Northern Europe",1620197,1564418,55779,1159842,1933071,"GBR",1546457
1,212.0,"Northern America",781607,745991,35616,565638,942730,"CAN",754184
1,212.0,"Oceania",347812,335859,11953,281766,469611,"NZL",375689
1,212.0,"Eastern Africa",130960,0,130960,101014,168357,"ETH",134686
1,212.0,"Middle Africa",44028,0,44028,32062,53437,"AGO",42750
1,212.0,"Eastern Europe",3300108,2931261,368847,2748510,4580851,"POL",3664681
1,212.0,"Central Asia",1227781,818211,409570,958665,1597775,"UZB",1278220
1,212.0,"Southern Europe",347077,0,347077,254195,423658,"ITA",338927
1,212.0,"Central America",222163,0,222163,165388,275647,"MEX",220518
1,212.0,"Southern Asia",376931,0,376931,291489,485816,"IRN",388653
1,212.0,"Western Asia",507333,0,507333,385795,642992,"IRQ",514394
1,212.0,"Eastern Asia",918700,0,918700,689511,1149185,"JPN",919348
1,212.0,"Southern Africa",100823,0,100823,76278,127130,"ZAF",101704
1,212.0,"South-Eastern Asia",537197,0,537197,422969,704948,"IDN",563959
1,212.0,"Caribbean",145917,0,145917,108593,180988,"CUB",144791
1,213.0,"Pakistan",1487017,1242823,244194,1118961,1864936,"PAK",1491949
1,213.0,"India",4883122,4791438,91684,3694773,6157955,"IND",4926364
1,213.0,"Western Europe",2754848,2747966,6882,2106949,3511582,"NLD",2809266
1,213.0,"China",9724912,8701375,1023537,7001106,11668510,"CPR",9334808
1,213.0,"United States of America",2664635,2664088,547,2032336,3387227,"USA",2709782
1,213.0,"Northern Africa",1055273,0,1055273,801744,1336241,"EGY",1068993
1,213.0,"Russian Federation",3964140,3377993,586147,3015201,5025335,"RUS",4020268
1,213.0,"Western Africa",171816,0,171816,128324,213873,"NGA",171099
1,213.0,"South America",1658937,1339890,319047,1234981,2058302,"BRA",1646642
1,213.0,"Northern Europe",1604841,1554942,49899,1159842,1933071,"GBR",1546457
1,213.0,"Northern America",766244,731714,34530,565638,942730,"CAN",754184
1,213.0,"Oceania",399215,367007,32208,281766,469611,"NZL",375689
1,213.0,"Eastern Africa",134433,0,134433,101014,168357,"ETH",134686
1,213.0,"Middle Africa",42853,0,42853,32062,53437,"AGO",42750
1,213.0,"Eastern Europe",3491897,3022781,469116,2748510,4580851,"POL",3664681
1,213.0,"Central Asia",1301259,840577,460682,958665,1597775,"UZB",1278220
1,213.0,"Southern Europe",339636,0,339636,254195,423658,"ITA",338927
1,213.0,"Central America",218584,0,218584,165388,275647,"MEX",220518
1,213.0,"Southern Asia",388242,0,388242,291489,485816,"IRN",388653
1,213.0,"Western Asia",516551,0,516551,385795,642992,"IRQ",514394
1,213.0,"Eastern Asia",937597,0,937597,689511,1149185,"JPN",919348
1,213.0,"Southern Africa",103518,0,103518,76278,127130,"ZAF",101704
1,213.0,"South-Eastern Asia",586812,0,586812,422969,704948,"IDN",563959
1,213.0,"Caribbean",143592,0,143592,108593,180988,"CUB",144791
1,214.0,"Pakistan",1519722,1246036,273686,1118961,1864936,"PAK",1491949
1,214.0,"India",4927564,4811743,115821,3694773,6157955,"IND",4926364
1,214.0,"Western Europe",2966304,2956287,10017,2106949,3511582,"NLD",2809266
1,214.0,"China",9090709,8643726,446983,7001106,11668510,"CPR",9334808
1,214.0,"United States of America",2789655,2788362,1293,2032336,3387227,"USA",2709782
1,214.0,"Northern Africa",1117685,0,1117685,801744,1336241,"EGY",1068993
1,214.0,"Russian Federation",4053151,3396706,656445,3015201,5025335,"RUS",4020268
1,214.0,"Western Africa",175552,0,175552,128324,213873,"NGA",171099
1,214.0,"South America",1680404,1341132,339272,1234981,2058302,"BRA",1646642
1,214.0,"Northern Europe",1447073,1428050,19023,1159842,1933071,"GBR",1546457
1,214.0,"Northern America",788055,774027,14028,565638,942730,"CAN",754184
1,214.0,"Oceania",360227,348355,11872,281766,469611,"NZL",375689
1,214.0,"Eastern Africa",138833,0,138833,101014,168357,"ETH",134686
1,214.0,"Middle Africa",43509,0,43509,32062,53437,"AGO",42750
1,214.0,"Eastern Europe",3679060,3093240,585820,2748510,4580851,"POL",3664681
1,214.0,"Central Asia",1526874,1051843,475031,958665,1597775,"UZB",1278220
1,214.0,"Southern Europe",350858,0,350858,254195,423658,"ITA",338927
1,214.0,"Central America",225157,0,225157,165388,275647,"MEX",220518
1,214.0,"Southern Asia",406007,0,406007,291489,485816,"IRN",388653
1,214.0,"Western Asia",539077,0,539077,385795,642992,"IRQ",514394
1,214.0,"Eastern Asia",936552,0,936552,689511,1149185,"JPN",919348
1,214.0,"Southern Africa",103912,0,103912,76278,127130,"ZAF",101704
1,214.0,"South-Eastern Asia",552824,0,552824,422969,704948,"IDN",563959
1,214.0,"Caribbean",148480,0,148480,108593,180988,"CUB",144791
1,215.0,"Pakistan",1523111,1244721,278390,1118961,1864936,"PAK",1491949
1,215.0,"India",4945807,4805976,139831,3694773,6157955,"IND",4926364
1,215.0,"Western Europe",2855424,2848649,6775,2106949,3511582,"NLD",2809266
1,215.0,"China",9103332,8657911,445421,7001106,11668510,"CPR",9334808
1,215.0,"United States of America",2785161,2781125,4036,2032336,3387227,"USA",2709782
1,215.0,"Northern Africa",1091931,0,1091931,801744,1336241,"EGY",1068993
1,215.0,"Russian Federation",4119751,3415984,703767,3015201,5025335,"RUS",4020268
1,215.0,"Western Africa",175493,0,175493,128324,213873,"NGA",171099
1,215.0,"South America",1690729,1339091,351638,1234981,2058302,"BRA",1646642
1,215.0,"Northern Europe",1610436,1562312,48124,1159842,1933071,"GBR",1546457
1,215.0,"Northern America",761635,753634,8001,565638,942730,"CAN",754184
1,215.0,"Oceania",402639,372997,29642,281766,469611,"NZL",375689
1,215.0,"Eastern Africa",140472,0,140472,101014,168357,"ETH",134686
1,215.0,"Middle Africa",43957,0,43957,32062,53437,"AGO",42750
1,215.0,"Eastern Europe",3811274,3144034,667240,2748510,4580851,"POL",3664681
1,215.0,"Central Asia",1205395,852303,353092,958665,1597775,"UZB",1278220
1,215.0,"Southern Europe",346490,0,346490,254195,423658,"ITA",338927
1,215.0,"Central America",227765,0,227765,165388,275647,"MEX",220518
1,215.0,"Southern Asia",402315,0,402315,291489,485816,"IRN",388653
1,215.0,"Western Asia",531172,0,531172,385795,642992,"IRQ",514394
1,215.0,"Eastern Asia",949124,0,949124,689511,1149185,"JPN",919348
1,215.0,"Southern Africa",105767,0,105767,76278,127130,"ZAF",101704
1,215.0,"South-Eastern Asia",596311,0,596311,422969,704948,"IDN",563959
1,215.0,"Caribbean",149217,0,149217,108593,180988,"CUB",144791
1,216.0,"Pakistan",1535166,1244360,290806,1118969,1864948,"PAK",1491959
1,216.0,"India",4966769,4808644,158125,3694780,6157967,"IND",4926374
1,216.0,"Western Europe",2776722,2774331,2391,2106953,3511588,"NLD",2809271
1,216.0,"China",9189363,8704828,484535,7001115,11668525,"CPR",9334820
1,216.0,"United States of America",2735409,2734030,1379,2032345,3387242,"USA",2709794
1,216.0,"Northern Africa",1061506,0,1061506,801744,1336240,"EGY",1068992
1,216.0,"Russian Federation",4136432,3420021,716411,3015208,5025347,"RUS",4020278
1,216.0,"Western Africa",173670,0,173670,128329,213882,"NGA",171106
1,216.0,"South America",1696195,1335166,361029,1234989,2058316,"BRA",1646653
1,216.0,"Northern Europe",1641848,1591357,50491,1159850,1933083,"GBR",1546467
1,216.0,"Northern America",778341,771328,7013,565642,942737,"CAN",754190
1,216.0,"Oceania",339490,329592,9898,281779,469632,"NZL",375706
1,216.0,"Eastern Africa",137982,0,137982,101016,168361,"ETH",134689
1,216.0,"Middle Africa",43095,0,43095,32058,53431,"AGO",42745
1,216.0,"Eastern Europe",3892545,3184955,707590,2748516,4580860,"POL",3664688
1,216.0,"Central Asia",1306629,940716,365913,958670,1597783,"UZB",1278227
1,216.0,"Southern Europe",343652,0,343652,254197,423662,"ITA",338930
1,216.0,"Central America",222752,0,222752,165391,275652,"MEX",220522
1,216.0,"Southern Asia",397969,0,397969,291495,485825,"IRN",388660
1,216.0,"Western Asia",520578,0,520578,385794,642990,"IRQ",514392
1,216.0,"Eastern Asia",915081,0,915081,689517,1149196,"JPN",919357
1,216.0,"Southern Africa",99590,0,99590,76282,127137,"ZAF",101710
1,216.0,"South-Eastern Asia",529356,0,529356,422972,704953,"IDN",563963
1,216.0,"Caribbean",146895,0,146895,108600,181001,"CUB",144801
1,217.0,"Pakistan",1538896,1241667,297229,1156070,1926783,"PAK",1541427
1,217.0,"India",5004267,4826736,177531,3874689,6457816,"IND",5166253
1,217.0,"Western Europe",2870844,2862935,7909,2337355,3895592,"NLD",3116474
1,217.0,"China",9272656,8757043,515613,7167502,11945837,"CPR",9556670
1,217.0,"United States of America",2726102,2725021,1081,2211062,3685103,"USA",2948083
1,217.0,"Northern Africa",1086813,0,1086813,942119,1570198,"EGY",1256159
1,217.0,"Russian Federation",4138352,3442730,695622,2278224,3797040,"RUS",3037632
1,217.0,"Western Africa",169116,0,169116,135873,226455,"NGA",181164
1,217.0,"South America",1626145,1263492,362653,1268741,2114568,"BRA",1691655
1,217.0,"Northern Europe",1490677,1472838,17839,1285005,2141675,"GBR",1713340
1,217.0,"Northern America",721775,719498,2277,481041,801736,"CAN",641389
1,217.0,"Oceania",436650,400793,35857,250705,417842,"NZL",334274
1,217.0,"Eastern Africa",135920,0,135920,127806,213010,"ETH",170408
1,217.0,"Middle Africa",42759,0,42759,39894,66491,"AGO",53193
1,217.0,"Eastern Europe",3818931,3185774,633157,2941916,4903193,"POL",3922555
1,217.0,"Central Asia",1166923,886966,279957,898176,1496960,"UZB",1197568
1,217.0,"Southern Europe",335772,0,335772,294077,490128,"ITA",392103
1,217.0,"Central America",222627,0,222627,141454,235757,"MEX",188606
1,217.0,"Southern Asia",390619,0,390619,260293,433822,"IRN",347058
1,217.0,"Western Asia",514927,0,514927,228926,381543,"IRQ",305235
1,217.0,"Eastern Asia",933293,0,933293,788052,1313421,"JPN",1050737
1,217.0,"Southern Africa",105878,0,105878,57105,95175,"ZAF",76140
1,217.0,"South-Eastern Asia",624947,0,624947,461166,768611,"IDN",614889
1,217.0,"Caribbean",145083,0,145083,110450,184083,"CUB",147267
1,218.0,"Pakistan",1510887,1234073,276814,1156070,1926783,"PAK",1541427
1,218.0,"India",5032626,4841490,191136,3874689,6457816,"IND",5166253
1,218.0,"Western Europe",2822780,2818201,4579,2337355,3895592,"NLD",3116474
1,218.0,"China",9316631,8759835,556796,7167502,11945837,"CPR",9556670
1,218.0,"United States of America",2669526,2667592,1934,2211062,3685103,"USA",2948083
1,218.0,"Northern Africa",1078949,0,1078949,942119,1570198,"EGY",1256159
1,218.0,"Russian Federation",4123696,3429519,694177,2278224,3797040,"RUS",3037632
1,218.0,"Western Africa",174098,0,174098,135873,226455,"NGA",181164
1,218.0,"South America",1652250,1272975,379275,1268741,2114568,"BRA",1691655
1,218.0,"Northern Europe",1571318,1541666,29652,1285005,2141675,"GBR",1713340
1,218.0,"Northern America",760378,747277,13101,481041,801736,"CAN",641389
1,218.0,"Oceania",412950,399885,13065,250705,417842,"NZL",334274
1,218.0,"Eastern Africa",139754,0,139754,127806,213010,"ETH",170408
1,218.0,"Middle Africa",43762,0,43762,39894,66491,"AGO",53193
1,218.0,"Eastern Europe",3784851,3179744,605107,2941916,4903193,"POL",3922555
1,218.0,"Central Asia",1340344,1003305,337039,898176,1496960,"UZB",1197568
1,218.0,"Southern Europe",344118,0,344118,294077,490128,"ITA",392103
1,218.0,"Central America",219595,0,219595,141454,235757,"MEX",188606
1,218.0,"Southern Asia",401843,0,401843,260293,433822,"IRN",347058
1,218.0,"Western Asia",524604,0,524604,228926,381543,"IRQ",305235
1,218.0,"Eastern Asia",938276,0,938276,788052,1313421,"JPN",1050737
1,218.0,"Southern Africa",105850,0,105850,57105,95175,"ZAF",76140
1,218.0,"South-Eastern Asia",601063,0,601063,461166,768611,"IDN",614889
1,218.0,"Caribbean",144366,0,144366,110450,184083,"CUB",147267
1,219.0,"Pakistan",1512411,1235284,277127,1156070,1926783,"PAK",1541427
1,219.0,"India",5054974,4842000,212974,3874689,6457816,"IND",5166253
1,219.0,"Western Europe",2835183,2829007,6176,2337355,3895592,"NLD",3116474
1,219.0,"China",9408934,8790232,618702,7167502,11945837,"CPR",9556670
1,219.0,"United States of America",2883565,2878239,5326,2211062,3685103,"USA",2948083
1,219.0,"Northern Africa",1144377,0,1144377,942119,1570198,"EGY",1256159
1,219.0,"Russian Federation",4050163,3441036,609127,2278224,3797040,"RUS",3037632
1,219.0,"Western Africa",178170,0,178170,135873,226455,"NGA",181164
1,219.0,"South America",1683765,1277547,406218,1268741,2114568,"BRA",1691655
1,219.0,"Northern Europe",1595473,1570389,25084,1285005,2141675,"GBR",1713340
1,219.0,"Northern America",741019,729492,11527,481041,801736,"CAN",641389
1,219.0,"Oceania",319431,315498,3933,250705,417842,"NZL",334274
1,219.0,"Eastern Africa",159334,0,159334,127806,213010,"ETH",170408
1,219.0,"Middle Africa",48685,0,48685,39894,66491,"AGO",53193
1,219.0,"Eastern Europe",3824415,3210507,613908,2941916,4903193,"POL",3922555
1,219.0,"Central Asia",1163665,919768,243897,898176,1496960,"UZB",1197568
1,219.0,"Southern Europe",374914,0,374914,294077,490128,"ITA",392103
1,219.0,"Central America",200422,0,200422,141454,235757,"MEX",188606
1,219.0,"Southern Asia",366824,0,366824,260293,433822,"IRN",347058
1,219.0,"Western Asia",380879,0,380879,228926,381543,"IRQ",305235
1,219.0,"Eastern Asia",1024840,0,1024840,788052,1313421,"JPN",1050737
1,219.0,"Southern Africa",82651,0,82651,57105,95175,"ZAF",76140
1,219.0,"South-Eastern Asia",567638,0,567638,461166,768611,"IDN",614889
1,219.0,"Caribbean",147080,0,147080,110450,184083,"CUB",147267
1,220.0,"Pakistan",1486859,1233109,253750,1156070,1926783,"PAK",1541427
1,220.0,"India",5083382,4835253,248129,3874689,6457816,"IND",5166253
1,220.0,"Western Europe",3049203,3011405,37798,2337355,3895592,"NLD",3116474
1,220.0,"China",9477874,8792239,685635,7167502,11945837,"CPR",9556670
1,220.0,"United States of America",2952448,2936440,16008,2211062,3685103,"USA",2948083
1,220.0,"Northern Africa",1232722,0,1232722,942119,1570198,"EGY",1256159
1,220.0,"Russian Federation",3362467,3024761,337706,2278224,3797040,"RUS",3037632
1,220.0,"Western Africa",182638,0,182638,135873,226455,"NGA",181164
1,220.0,"South America",1679560,1278171,401389,1268741,2114568,"BRA",1691655
1,220.0,"Northern Europe",1648011,1599288,48723,1285005,2141675,"GBR",1713340
1,220.0,"Northern America",669835,662064,7771,481041,801736,"CAN",641389
1,220.0,"Oceania",317266,303843,13423,250705,417842,"NZL",334274
1,220.0,"Eastern Africa",168222,0,168222,127806,213010,"ETH",170408
1,220.0,"Middle Africa",52223,0,52223,39894,66491,"AGO",53193
1,220.0,"Eastern Europe",3863377,3209530,653847,2941916,4903193,"POL",3922555
1,220.0,"Central Asia",1323316,1033570,289746,898176,1496960,"UZB",1197568
1,220.0,"Southern Europe",391253,0,391253,294077,490128,"ITA",392103
1,220.0,"Central America",195410,0,195410,141454,235757,"MEX",188606
1,220.0,"Southern Asia",358746,0,358746,260293,433822,"IRN",347058
1,220.0,"Western Asia",335102,0,335102,228926,381543,"IRQ",305235
1,220.0,"Eastern Asia",1047256,0,1047256,788052,1313421,"JPN",1050737
1,220.0,"Southern Africa",78703,0,78703,57105,95175,"ZAF",76140
1,220.0,"South-Eastern Asia",594085,0,594085,461166,768611,"IDN",614889
1,220.0,"Caribbean",149352,0,149352,110450,184083,"CUB",147267
1,221.0,"Pakistan",1540319,1242661,297658,1156070,1926783,"PAK",1541427
1,221.0,"India",5261104,4975222,285882,3874689,6457816,"IND",5166253
1,221.0,"Western Europe",3174603,3113776,60827,2337355,3895592,"NLD",3116474
1,221.0,"China",9543232,8782752,760480,7167502,11945837,"CPR",9556670
1,221.0,"United States of America",2941290,2913880,27410,2211062,3685103,"USA",2948083
1,221.0,"Northern Africa",1286670,0,1286670,942119,1570198,"EGY",1256159
1,221.0,"Russian Federation",2887549,2764091,123458,2278224,3797040,"RUS",3037632
1,221.0,"Western Africa",186261,0,186261,135873,226455,"NGA",181164
1,221.0,"South America",1710299,1274559,435740,1268741,2114568,"BRA",1691655
1,221.0,"Northern Europe",1746067,1659385,86682,1285005,2141675,"GBR",1713340
1,221.0,"Northern America",664958,654662,10296,481041,801736,"CAN",641389
1,221.0,"Oceania",363438,328853,34585,250705,417842,"NZL",334274
1,221.0,"Eastern Africa",175699,0,175699,127806,213010,"ETH",170408
1,221.0,"Middle Africa",54502,0,54502,39894,66491,"AGO",53193
1,221.0,"Eastern Europe",3933326,3231680,701646,2941916,4903193,"POL",3922555
1,221.0,"Central Asia",1188577,979537,209040,898176,1496960,"UZB",1197568
1,221.0,"Southern Europe",399732,0,399732,294077,490128,"ITA",392103
1,221.0,"Central America",190232,0,190232,141454,235757,"MEX",188606
1,221.0,"Southern Asia",360276,0,360276,260293,433822,"IRN",347058
1,221.0,"Western Asia",322835,0,322835,228926,381543,"IRQ",305235
1,221.0,"Eastern Asia",1073942,0,1073942,788052,1313421,"JPN",1050737
1,221.0,"Southern Africa",80486,0,80486,57105,95175,"ZAF",76140
1,221.0,"South-Eastern Asia",649912,0,649912,461166,768611,"IDN",614889
1,221.0,"Caribbean",147591,0,147591,110450,184083,"CUB",147267
1,222.0,"Pakistan",1722329,1391225,331104,1156070,1926783,"PAK",1541427
1,222.0,"India",5277536,4970144,307392,3874689,6457816,"IND",5166253
1,222.0,"Western Europe",3286860,3214378,72482,2337355,3895592,"NLD",3116474
1,222.0,"China",9608140,8790174,817966,7167502,11945837,"CPR",9556670
1,222.0,"United States of America",2976895,2943561,33334,2211062,3685103,"USA",2948083
1,222.0,"Northern Africa",1284765,0,1284765,942119,1570198,"EGY",1256159
1,222.0,"Russian Federation",2812628,2714425,98203,2278224,3797040,"RUS",3037632
1,222.0,"Western Africa",177886,0,177886,135873,226455,"NGA",181164
1,222.0,"South America",1732046,1275993,456053,1268741,2114568,"BRA",1691655
1,222.0,"Northern Europe",1781238,1676657,104581,1285005,2141675,"GBR",1713340
1,222.0,"Northern America",591017,588115,2902,481041,801736,"CAN",641389
1,222.0,"Oceania",325390,315158,10232,250705,417842,"NZL",334274
1,222.0,"Eastern Africa",166029,0,166029,127806,213010,"ETH",170408
1,222.0,"Middle Africa",53124,0,53124,39894,66491,"AGO",53193
1,222.0,"Eastern Europe",3974420,3233106,741314,2941916,4903193,"POL",3922555
1,222.0,"Central Asia",1213356,1017825,195531,898176,1496960,"UZB",1197568
1,222.0,"Southern Europe",385926,0,385926,294077,490128,"ITA",392103
1,222.0,"Central America",188833,0,188833,141454,235757,"MEX",188606
1,222.0,"Southern Asia",337656,0,337656,260293,433822,"IRN",347058
1,222.0,"Western Asia",300501,0,300501,228926,381543,"IRQ",305235
1,222.0,"Eastern Asia",1013873,0,1013873,788052,1313421,"JPN",1050737
1,222.0,"Southern Africa",75017,0,75017,57105,95175,"ZAF",76140
1,222.0,"South-Eastern Asia",599174,0,599174,461166,768611,"IDN",614889
1,222.0,"Caribbean",146960,0,146960,110450,184083,"CUB",147267
1,223.0,"Pakistan",1440287,1226594,213693,1156070,1926783,"PAK",1541427
1,223.0,"India",5288986,4955364,333622,3874689,6457816,"IND",5166253
1,223.0,"Western Europe",3157019,3130789,26230,2337355,3895592,"NLD",3116474
1,223.0,"China",9696626,8788731,907895,7167502,11945837,"CPR",9556670
1,223.0,"United States of America",2991906,2978807,13099,2211062,3685103,"USA",2948083
1,223.0,"Northern Africa",1265889,0,1265889,942119,1570198,"EGY",1256159
1,223.0,"Russian Federation",3157657,3045133,112524,2278224,3797040,"RUS",3037632
1,223.0,"Western Africa",185309,0,185309,135873,226455,"NGA",181164
1,223.0,"South America",1726172,1274426,451746,1268741,2114568,"BRA",1691655
1,223.0,"Northern Europe",1747243,1671325,75918,1285005,2141675,"GBR",1713340
1,223.0,"Northern America",699989,692857,7132,481041,801736,"CAN",641389
1,223.0,"Oceania",313712,309238,4474,250705,417842,"NZL",334274
1,223.0,"Eastern Africa",173055,0,173055,127806,213010,"ETH",170408
1,223.0,"Middle Africa",53531,0,53531,39894,66491,"AGO",53193
1,223.0,"Eastern Europe",4016494,3231913,784581,2941916,4903193,"POL",3922555
1,223.0,"Central Asia",1096531,975750,120781,898176,1496960,"UZB",1197568
1,223.0,"Southern Europe",400502,0,400502,294077,490128,"ITA",392103
1,223.0,"Central America",192260,0,192260,141454,235757,"MEX",188606
1,223.0,"Southern Asia",356455,0,356455,260293,433822,"IRN",347058
1,223.0,"Western Asia",314907,0,314907,228926,381543,"IRQ",305235
1,223.0,"Eastern Asia",1080012,0,1080012,788052,1313421,"JPN",1050737
1,223.0,"Southern Africa",76190,0,76190,57105,95175,"ZAF",76140
1,223.0,"South-Eastern Asia",598917,0,598917,461166,768611,"IDN",614889
1,223.0,"Caribbean",149966,0,149966,110450,184083,"CUB",147267
1,224.0,"Pakistan",1570517,1323934,246583,1156070,1926783,"PAK",1541427
1,224.0,"India",5248708,4937973,310735,3874689,6457816,"IND",5166253
1,224.0,"Western Europe",2988198,2963551,24647,2337355,3895592,"NLD",3116474
1,224.0,"China",9632942,8709547,923395,7167502,11945837,"CPR",9556670
1,224.0,"United States of America",2805718,2790035,15683,2211062,3685103,"USA",2948083
1,224.0,"Northern Africa",1217431,0,1217431,942119,1570198,"EGY",1256159
1,224.0,"Russian Federation",2503942,2414322,89620,2278224,3797040,"RUS",3037632
1,224.0,"Western Africa",177030,0,177030,135873,226455,"NGA",181164
1,224.0,"South America",1697876,1271433,426443,1268741,2114568,"BRA",1691655
1,224.0,"Northern Europe",1735207,1662247,72960,1285005,2141675,"GBR",1713340
1,224.0,"Northern America",605637,603455,2182,481041,801736,"CAN",641389
1,224.0,"Oceania",374247,351726,22521,250705,417842,"NZL",334274
1,224.0,"Eastern Africa",169114,0,169114,127806,213010,"ETH",170408
1,224.0,"Middle Africa",52533,0,52533,39894,66491,"AGO",53193
1,224.0,"Eastern Europe",4533157,3794896,738261,2941916,4903193,"POL",3922555
1,224.0,"Central Asia",1240762,1058951,181811,898176,1496960,"UZB",1197568
1,224.0,"Southern Europe",381466,0,381466,294077,490128,"ITA",392103
1,224.0,"Central America",179837,0,179837,141454,235757,"MEX",188606
1,224.0,"Southern Asia",341337,0,341337,260293,433822,"IRN",347058
1,224.0,"Western Asia",298317,0,298317,228926,381543,"IRQ",305235
1,224.0,"Eastern Asia",1017739,0,1017739,788052,1313421,"JPN",1050737
1,224.0,"Southern Africa",77258,0,77258,57105,95175,"ZAF",76140
1,224.0,"South-Eastern Asia",649460,0,649460,461166,768611,"IDN",614889
1,224.0,"Caribbean",140492,0,140492,110450,184083,"CUB",147267
1,225.0,"Pakistan",1482800,1313244,169556,1156070,1926783,"PAK",1541427
1,225.0,"India",5102579,4918981,183598,3874689,6457816,"IND",5166253
1,225.0,"Western Europe",3117731,3075495,42236,2337355,3895592,"NLD",3116474
1,225.0,"China",9639882,8677207,962675,7167502,11945837,"CPR",9556670
1,225.0,"United States of America",3217683,3183512,34171,2211062,3685103,"USA",2948083
1,225.0,"Northern Africa",1275616,0,1275616,942119,1570198,"EGY",1256159
1,225.0,"Russian Federation",2881043,2676455,204588,2278224,3797040,"RUS",3037632
1,225.0,"Western Africa",184635,0,184635,135873,226455,"NGA",181164
1,225.0,"South America",1625054,1265839,359215,1268741,2114568,"BRA",1691655
1,225.0,"Northern Europe",1791001,1736663,54338,1285005,2141675,"GBR",1713340
1,225.0,"Northern America",608583,596076,12507,481041,801736,"CAN",641389
1,225.0,"Oceania",332698,324988,7710,250705,417842,"NZL",334274
1,225.0,"Eastern Africa",171930,0,171930,127806,213010,"ETH",170408
1,225.0,"Middle Africa",54670,0,54670,39894,66491,"AGO",53193
1,225.0,"Eastern Europe",4028310,3576192,452118,2941916,4903193,"POL",3922555
1,225.0,"Central Asia",1171485,1046390,125095,898176,1496960,"UZB",1197568
1,225.0,"Southern Europe",400435,0,400435,294077,490128,"ITA",392103
1,225.0,"Central America",201676,0,201676,141454,235757,"MEX",188606
1,225.0,"Southern Asia",348945,0,348945,260293,433822,"IRN",347058
1,225.0,"Western Asia",308262,0,308262,228926,381543,"IRQ",305235
1,225.0,"Eastern Asia",1067852,0,1067852,788052,1313421,"JPN",1050737
1,225.0,"Southern Africa",77579,0,77579,57105,95175,"ZAF",76140
1,225.0,"South-Eastern Asia",620816,0,620816,461166,768611,"IDN",614889
1,225.0,"Caribbean",157430,0,157430,110450,184083,"CUB",147267
1,226.0,"Pakistan",1567984,1354823,213161,1156070,1926783,"PAK",1541427
1,226.0,"India",5120685,4910290,210395,3874689,6457816,"IND",5166253
1,226.0,"Western Europe",3214080,3160963,53117,2337355,3895592,"NLD",3116474
1,226.0,"China",9704585,8678852,1025733,7167502,11945837,"CPR",9556670
1,226.0,"United States of America",3048978,3030362,18616,2211062,3685103,"USA",2948083
1,226.0,"Northern Africa",1289444,0,1289444,942119,1570198,"EGY",1256159
1,226.0,"Russian Federation",3105006,2800436,304570,2278224,3797040,"RUS",3037632
1,226.0,"Western Africa",185602,0,185602,135873,226455,"NGA",181164
1,226.0,"South America",1694206,1271730,422476,1268741,2114568,"BRA",1691655
1,226.0,"Northern Europe",1774109,1729960,44149,1285005,2141675,"GBR",1713340
1,226.0,"Northern America",687484,652750,34734,481041,801736,"CAN",641389
1,226.0,"Oceania",311724,308513,3211,250705,417842,"NZL",334274
1,226.0,"Eastern Africa",172962,0,172962,127806,213010,"ETH",170408
1,226.0,"Middle Africa",53885,0,53885,39894,66491,"AGO",53193
1,226.0,"Eastern Europe",3525038,3328552,196486,2941916,4903193,"POL",3922555
1,226.0,"Central Asia",1130741,968085,162656,898176,1496960,"UZB",1197568
1,226.0,"Southern Europe",402009,0,402009,294077,490128,"ITA",392103
1,226.0,"Central America",194278,0,194278,141454,235757,"MEX",188606
1,226.0,"Southern Asia",356173,0,356173,260293,433822,"IRN",347058
1,226.0,"Western Asia",314646,0,314646,228926,381543,"IRQ",305235
1,226.0,"Eastern Asia",1087227,0,1087227,788052,1313421,"JPN",1050737
1,226.0,"Southern Africa",75902,0,75902,57105,95175,"ZAF",76140
1,226.0,"South-Eastern Asia",594176,0,594176,461166,768611,"IDN",614889
1,226.0,"Caribbean",151693,0,151693,110450,184083,"CUB",147267
1,227.0,"Pakistan",1569757,1357415,212342,1156070,1926783,"PAK",1541427
1,227.0,"India",5131728,4896909,234819,3874689,6457816,"IND",5166253
1,227.0,"Western Europe",3166546,3122213,44333,2337355,3895592,"NLD",3116474
1,227.0,"China",9703325,8676878,1026447,7167502,11945837,"CPR",9556670
1,227.0,"United States of America",2900020,2893886,6134,2211062,3685103,"USA",2948083
1,227.0,"Northern Africa",1266525,0,1266525,942119,1570198,"EGY",1256159
1,227.0,"Russian Federation",3179952,2846924,333028,2278224,3797040,"RUS",3037632
1,227.0,"Western Africa",177600,0,177600,135873,226455,"NGA",181164
1,227.0,"South America",1725483,1277686,447797,1268741,2114568,"BRA",1691655
1,227.0,"Northern Europe",1673230,1645189,28041,1285005,2141675,"GBR",1713340
1,227.0,"Northern America",602150,591336,10814,481041,801736,"CAN",641389
1,227.0,"Oceania",340337,322584,17753,250705,417842,"NZL",334274
1,227.0,"Eastern Africa",167442,0,167442,127806,213010,"ETH",170408
1,227.0,"Middle Africa",52806,0,52806,39894,66491,"AGO",53193
1,227.0,"Eastern Europe",3787896,3556785,231111,2941916,4903193,"POL",3922555
1,227.0,"Central Asia",1239250,998815,240435,898176,1496960,"UZB",1197568
1,227.0,"Southern Europe",385208,0,385208,294077,490128,"ITA",392103
1,227.0,"Central America",186099,0,186099,141454,235757,"MEX",188606
1,227.0,"Southern Asia",338195,0,338195,260293,433822,"IRN",347058
1,227.0,"Western Asia",297144,0,297144,228926,381543,"IRQ",305235
1,227.0,"Eastern Asia",1027474,0,1027474,788052,1313421,"JPN",1050737
1,227.0,"Southern Africa",75392,0,75392,57105,95175,"ZAF",76140
1,227.0,"South-Eastern Asia",618127,0,618127,461166,768611,"IDN",614889
1,227.0,"Caribbean",145346,0,145346,110450,184083,"CUB",147267
1,228.0,"Pakistan",1552535,1360622,191913,1156074,1926790,"PAK",1541432
1,228.0,"India",5181438,4923054,258384,3874693,6457822,"IND",5166258
1,228.0,"Western Europe",3123227,3089747,33480,2337365,3895608,"NLD",3116487
1,228.0,"China",9742483,8688909,1053574,7167518,11945863,"CPR",9556691
1,228.0,"United States of America",2753434,2751172,2262,2211072,3685120,"USA",2948096
1,228.0,"Northern Africa",1236494,0,1236494,942117,1570196,"EGY",1256157
1,228.0,"Russian Federation",3201630,2869517,332113,2278227,3797046,"RUS",3037637
1,228.0,"Western Africa",179186,0,179186,135867,226445,"NGA",181156
1,228.0,"South America",1703565,1276310,427255,1268745,2114576,"BRA",1691661
1,228.0,"Northern Europe",1616547,1595947,20600,1285017,2141696,"GBR",1713357
1,228.0,"Northern America",660928,643432,17496,481051,801752,"CAN",641402
1,228.0,"Oceania",320792,308783,12009,250713,417855,"NZL",334284
1,228.0,"Eastern Africa",169163,0,169163,127798,212997,"ETH",170398
1,228.0,"Middle Africa",52310,0,52310,39901,66502,"AGO",53202
1,228.0,"Eastern Europe",3966091,3716277,249814,2941920,4903200,"POL",3922560
1,228.0,"Central Asia",1252277,1004563,247714,898180,1496967,"UZB",1197574
1,228.0,"Southern Europe",387680,0,387680,294081,490135,"ITA",392108
1,228.0,"Central America",179761,0,179761,141461,235768,"MEX",188615
1,228.0,"Southern Asia",346566,0,346566,260295,433826,"IRN",347061
1,228.0,"Western Asia",304264,0,304264,228932,381553,"IRQ",305243
1,228.0,"Eastern Asia",1028153,0,1028153,788060,1313433,"JPN",1050747
1,228.0,"Southern Africa",74672,0,74672,57106,95177,"ZAF",76142
1,228.0,"South-Eastern Asia",596837,0,596837,461182,768637,"IDN",614910
1,228.0,"Caribbean",140408,0,140408,110460,184100,"CUB",147280
1,229.0,"Pakistan",1466603,1355853,110750,1226069,2043448,"PAK",1634759
1,229.0,"India",5215338,4937839,277499,4060841,6768068,"IND",5414455
1,229.0,"Western Europe",3041310,3026522,14788,2592418,4320697,"NLD",3456558
1,229.0,"China",9744701,8686061,1058640,7345325,12242208,"CPR",9793767
1,229.0,"United States of America",3004207,2999284,4923,1965780,3276301,"USA",2621041
1,229.0,"Northern Africa",1243220,0,1243220,992642,1654403,"EGY",1323523
1,229.0,"Russian Federation",3100173,2865400,234773,2228055,3713425,"RUS",2970740
1,229.0,"Western Africa",176940,0,176940,158903,264838,"NGA",211871
1,229.0,"South America",1618862,1198770,420092,1320825,2201375,"BRA",1761100
1,229.0,"Northern Europe",1756180,1726229,29951,1318707,2197846,"GBR",1758277
1,229.0,"Northern America",589272,583196,6076,504093,840155,"CAN",672124
1,229.0,"Oceania",354280,346729,7551,307809,513015,"NZL",410412
1,229.0,"Eastern Africa",167276,0,167276,104239,173732,"ETH",138986
1,229.0,"Middle Africa",52722,0,52722,39016,65027,"AGO",52022
1,229.0,"Eastern Europe",3868645,3697949,170696,2851215,4752026,"POL",3801621
1,229.0,"Central Asia",1173276,1006635,166641,878337,1463895,"UZB",1171116
1,229.0,"Southern Europe",383080,0,383080,442749,737916,"ITA",590333
1,229.0,"Central America",189748,0,189748,114462,190770,"MEX",152616
1,229.0,"Southern Asia",336802,0,336802,504704,841173,"IRN",672939
1,229.0,"Western Asia",295110,0,295110,445538,742563,"IRQ",594051
1,229.0,"Eastern Asia",1040576,0,1040576,545296,908827,"JPN",727062
1,229.0,"Southern Africa",76116,0,76116,70145,116908,"ZAF",93527
1,229.0,"South-Eastern Asia",634257,0,634257,482983,804972,"IDN",643978
1,229.0,"Caribbean",148051,0,148051,108211,180352,"CUB",144282
1,230.0,"Pakistan",1522255,1387681,134574,1226069,2043448,"PAK",1634759
1,230.0,"India",5177361,4934474,242887,4060841,6768068,"IND",5414455
1,230.0,"Western Europe",3063747,3045552,18195,2592418,4320697,"NLD",3456558
1,230.0,"China",9585449,8698477,886972,7345325,12242208,"CPR",9793767
1,230.0,"United States of America",2893186,2891047,2139,1965780,3276301,"USA",2621041
1,230.0,"Northern Africa",1222388,0,1222388,992642,1654403,"EGY",1323523
1,230.0,"Russian Federation",2972516,2855336,117180,2228055,3713425,"RUS",2970740
1,230.0,"Western Africa",181190,0,181190,158903,264838,"NGA",211871
1,230.0,"South America",1680678,1202188,478490,1320825,2201375,"BRA",1761100
1,230.0,"Northern Europe",1670432,1648611,21821,1318707,2197846,"GBR",1758277
1,230.0,"Northern America",731704,705670,26034,504093,840155,"CAN",672124
1,230.0,"Oceania",224236,221590,2646,307809,513015,"NZL",410412
1,230.0,"Eastern Africa",163722,0,163722,104239,173732,"ETH",138986
1,230.0,"Middle Africa",50113,0,50113,39016,65027,"AGO",52022
1,230.0,"Eastern Europe",3871571,3715250,156321,2851215,4752026,"POL",3801621
1,230.0,"Central Asia",1171235,1012489,158746,878337,1463895,"UZB",1171116
1,230.0,"Southern Europe",398023,0,398023,442749,737916,"ITA",590333
1,230.0,"Central America",186105,0,186105,114462,190770,"MEX",152616
1,230.0,"Southern Asia",345801,0,345801,504704,841173,"IRN",672939
1,230.0,"Western Asia",305343,0,305343,445538,742563,"IRQ",594051
1,230.0,"Eastern Asia",1024673,0,1024673,545296,908827,"JPN",727062
1,230.0,"Southern Africa",67954,0,67954,70145,116908,"ZAF",93527
1,230.0,"South-Eastern Asia",465724,0,465724,482983,804972,"IDN",643978
1,230.0,"Caribbean",144572,0,144572,108211,180352,"CUB",144282
1,231.0,"Pakistan",1555092,1402157,152935,1226069,2043448,"PAK",1634759
1,231.0,"India",5172814,4927876,244938,4060841,6768068,"IND",5414455
1,231.0,"Western Europe",3118944,3090952,27992,2592418,4320697,"NLD",3456558
1,231.0,"China",9553863,8694812,859051,7345325,12242208,"CPR",9793767
1,231.0,"United States of America",2695594,2688697,6897,1965780,3276301,"USA",2621041
1,231.0,"Northern Africa",1245635,0,1245635,992642,1654403,"EGY",1323523
1,231.0,"Russian Federation",2973116,2853213,119903,2228055,3713425,"RUS",2970740
1,231.0,"Western Africa",192057,0,192057,158903,264838,"NGA",211871
1,231.0,"South America",1704714,1200868,503846,1320825,2201375,"BRA",1761100
1,231.0,"Northern Europe",1654155,1625958,28197,1318707,2197846,"GBR",1758277
1,231.0,"Northern America",587455,578692,8763,504093,840155,"CAN",672124
1,231.0,"Oceania",340548,300028,40520,307809,513015,"NZL",410412
1,231.0,"Eastern Africa",140423,0,140423,104239,173732,"ETH",138986
1,231.0,"Middle Africa",49931,0,49931,39016,65027,"AGO",52022
1,231.0,"Eastern Europe",3893777,3736455,157322,2851215,4752026,"POL",3801621
1,231.0,"Central Asia",1195555,1015989,179566,878337,1463895,"UZB",1171116
1,231.0,"Southern Europe",499589,0,499589,442749,737916,"ITA",590333
1,231.0,"Central America",161129,0,161129,114462,190770,"MEX",152616
1,231.0,"Southern Asia",532465,0,532465,504704,841173,"IRN",672939
1,231.0,"Western Asia",472427,0,472427,445538,742563,"IRQ",594051
1,231.0,"Eastern Asia",796156,0,796156,545296,908827,"JPN",727062
1,231.0,"Southern Africa",82501,0,82501,70145,116908,"ZAF",93527
1,231.0,"South-Eastern Asia",579533,0,579533,482983,804972,"IDN",643978
1,231.0,"Caribbean",142452,0,142452,108211,180352,"CUB",144282
1,232.0,"Pakistan",1538458,1406730,131728,1226069,2043448,"PAK",1634759
1,232.0,"India",5190465,4964850,225615,4060841,6768068,"IND",5414455
1,232.0,"Western Europe",3475411,3428231,47180,2592418,4320697,"NLD",3456558
1,232.0,"China",9355156,8697725,657431,7345325,12242208,"CPR",9793767
1,232.0,"United States of America",2489473,2487120,2353,1965780,3276301,"USA",2621041
1,232.0,"Northern Africa",1303022,0,1303022,992642,1654403,"EGY",1323523
1,232.0,"Russian Federation",2909835,2833821,76014,2228055,3713425,"RUS",2970740
1,232.0,"Western Africa",199677,0,199677,158903,264838,"NGA",211871
1,232.0,"South America",1709613,1202249,507364,1320825,2201375,"BRA",1761100
1,232.0,"Northern Europe",1687741,1650922,36819,1318707,2197846,"GBR",1758277
1,232.0,"Northern America",618813,605095,13718,504093,840155,"CAN",672124
1,232.0,"Oceania",429158,357996,71162,307809,513015,"NZL",410412
1,232.0,"Eastern Africa",140306,0,140306,104239,173732,"ETH",138986
1,232.0,"Middle Africa",51563,0,51563,39016,65027,"AGO",52022
1,232.0,"Eastern Europe",3664493,3580806,83687,2851215,4752026,"POL",3801621
1,232.0,"Central Asia",1128091,1006621,121470,878337,1463895,"UZB",1171116
1,232.0,"Southern Europe",540010,0,540010,442749,737916,"ITA",590333
1,232.0,"Central America",148058,0,148058,114462,190770,"MEX",152616
1,232.0,"Southern Asia",608728,0,608728,504704,841173,"IRN",672939
1,232.0,"Western Asia",536371,0,536371,445538,742563,"IRQ",594051
1,232.0,"Eastern Asia",740443,0,740443,545296,908827,"JPN",727062
1,232.0,"Southern Africa",90886,0,90886,70145,116908,"ZAF",93527
1,232.0,"South-Eastern Asia",673265,0,673265,482983,804972,"IDN",643978
1,232.0,"Caribbean",136904,0,136904,108211,180352,"CUB",144282
1,233.0,"Pakistan",1569802,1410342,159460,1226069,2043448,"PAK",1634759
1,233.0,"India",5591851,5378075,213776,4060841,6768068,"IND",5414455
1,233.0,"Western Europe",3200895,3183085,17810,2592418,4320697,"NLD",3456558
1,233.0,"China",9377805,8704785,673020,7345325,12242208,"CPR",9793767
1,233.0,"United States of America",2525615,2523932,1683,1965780,3276301,"USA",2621041
1,233.0,"Northern Africa",1252044,0,1252044,992642,1654403,"EGY",1323523
1,233.0,"Russian Federation",2850396,2816765,33631,2228055,3713425,"RUS",2970740
1,233.0,"Western Africa",208597,0,208597,158903,264838,"NGA",211871
1,233.0,"South America",1726248,1202905,523343,1320825,2201375,"BRA",1761100
1,233.0,"Northern Europe",1699319,1663709,35610,1318707,2197846,"GBR",1758277
1,233.0,"Northern America",678193,659896,18297,504093,840155,"CAN",672124
1,233.0,"Oceania",498363,404751,93612,307809,513015,"NZL",410412
1,233.0,"Eastern Africa",144330,0,144330,104239,173732,"ETH",138986
1,233.0,"Middle Africa",52006,0,52006,39016,65027,"AGO",52022
1,233.0,"Eastern Europe",3591610,3538853,52757,2851215,4752026,"POL",3801621
1,233.0,"Central Asia",1131423,1009740,121683,878337,1463895,"UZB",1171116
1,233.0,"Southern Europe",572606,0,572606,442749,737916,"ITA",590333
1,233.0,"Central America",148895,0,148895,114462,190770,"MEX",152616
1,233.0,"Southern Asia",659635,0,659635,504704,841173,"IRN",672939
1,233.0,"Western Asia",580139,0,580139,445538,742563,"IRQ",594051
1,233.0,"Eastern Asia",740988,0,740988,545296,908827,"JPN",727062
1,233.0,"Southern Africa",97553,0,97553,70145,116908,"ZAF",93527
1,233.0,"South-Eastern Asia",753597,0,753597,482983,804972,"IDN",643978
1,233.0,"Caribbean",139728,0,139728,108211,180352,"CUB",144282
1,234.0,"Pakistan",1506432,1314755,191677,1226069,2043448,"PAK",1634759
1,234.0,"India",5275720,5189852,85868,4060841,6768068,"IND",5414455
1,234.0,"Western Europe",3489296,3453692,35604,2592418,4320697,"NLD",3456558
1,234.0,"China",9412338,8700796,711542,7345325,12242208,"CPR",9793767
1,234.0,"United States of America",2584338,2578388,5950,1965780,3276301,"USA",2621041
1,234.0,"Northern Africa",1320036,0,1320036,992642,1654403,"EGY",1323523
1,234.0,"Russian Federation",2859797,2823736,36061,2228055,3713425,"RUS",2970740
1,234.0,"Western Africa",207805,0,207805,158903,264838,"NGA",211871
1,234.0,"South America",1707127,1200005,507122,1320825,2201375,"BRA",1761100
1,234.0,"Northern Europe",1713953,1673601,40352,1318707,2197846,"GBR",1758277
1,234.0,"Northern America",639709,630358,9351,504093,840155,"CAN",672124
1,234.0,"Oceania",416125,356937,59188,307809,513015,"NZL",410412
1,234.0,"Eastern Africa",137412,0,137412,104239,173732,"ETH",138986
1,234.0,"Middle Africa",51769,0,51769,39016,65027,"AGO",52022
1,234.0,"Eastern Europe",3648973,3601278,47695,2851215,4752026,"POL",3801621
1,234.0,"Central Asia",1138451,1011845,126606,878337,1463895,"UZB",1171116
1,234.0,"Southern Europe",573839,0,573839,442749,737916,"ITA",590333
1,234.0,"Central America",151803,0,151803,114462,190770,"MEX",152616
1,234.0,"Southern Asia",648589,0,648589,504704,841173,"IRN",672939
1,234.0,"Western Asia",573722,0,573722,445538,742563,"IRQ",594051
1,234.0,"Eastern Asia",718773,0,718773,545296,908827,"JPN",727062
1,234.0,"Southern Africa",92634,0,92634,70145,116908,"ZAF",93527
1,234.0,"South-Eastern Asia",647077,0,647077,482983,804972,"IDN",643978
1,234.0,"Caribbean",143101,0,143101,108211,180352,"CUB",144282
1,235.0,"Pakistan",1575641,1314690,260951,1226069,2043448,"PAK",1634759
1,235.0,"India",5144873,5106587,38286,4060841,6768068,"IND",5414455
1,235.0,"Western Europe",3320826,3304348,16478,2592418,4320697,"NLD",3456558
1,235.0,"China",9431298,8695099,736199,7345325,12242208,"CPR",9793767
1,235.0,"United States of America",2582410,2577692,4718,1965780,3276301,"USA",2621041
1,235.0,"Northern Africa",1283241,0,1283241,992642,1654403,"EGY",1323523
1,235.0,"Russian Federation",2877060,2833569,43491,2228055,3713425,"RUS",2970740
1,235.0,"Western Africa",198122,0,198122,158903,264838,"NGA",211871
1,235.0,"South America",1723814,1201348,522466,1320825,2201375,"BRA",1761100
1,235.0,"Northern Europe",1765504,1720891,44613,1318707,2197846,"GBR",1758277
1,235.0,"Northern America",584596,572810,11786,504093,840155,"CAN",672124
1,235.0,"Oceania",367648,334920,32728,307809,513015,"NZL",410412
1,235.0,"Eastern Africa",127517,0,127517,104239,173732,"ETH",138986
1,235.0,"Middle Africa",49008,0,49008,39016,65027,"AGO",52022
1,235.0,"Eastern Europe",3771625,3711549,60076,2851215,4752026,"POL",3801621
1,235.0,"Central Asia",1152857,1012128,140729,878337,1463895,"UZB",1171116
1,235.0,"Southern Europe",552594,0,552594,442749,737916,"ITA",590333
1,235.0,"Central America",148907,0,148907,114462,190770,"MEX",152616
1,235.0,"Southern Asia",617336,0,617336,504704,841173,"IRN",672939
1,235.0,"Western Asia",545971,0,545971,445538,742563,"IRQ",594051
1,235.0,"Eastern Asia",684533,0,684533,545296,908827,"JPN",727062
1,235.0,"Southern Africa",86358,0,86358,70145,116908,"ZAF",93527
1,235.0,"South-Eastern Asia",582359,0,582359,482983,804972,"IDN",643978
1,235.0,"Caribbean",140573,0,140573,108211,180352,"CUB",144282
1,236.0,"Pakistan",1612516,1314992,297524,1226069,2043448,"PAK",1634759
1,236.0,"India",5182150,5147924,34226,4060841,6768068,"IND",5414455
1,236.0,"Western Europe",3573422,3559309,14113,2592418,4320697,"NLD",3456558
1,236.0,"China",9174430,8455683,718747,7345325,12242208,"CPR",9793767
1,236.0,"United States of America",2525898,2523741,2157,1965780,3276301,"USA",2621041
1,236.0,"Northern Africa",1327602,0,1327602,992642,1654403,"EGY",1323523
1,236.0,"Russian Federation",2669086,2631223,37863,2228055,3713425,"RUS",2970740
1,236.0,"Western Africa",211908,0,211908,158903,264838,"NGA",211871
1,236.0,"South America",1681234,1201189,480045,1320825,2201375,"BRA",1761100
1,236.0,"Northern Europe",1550791,1532580,18211,1318707,2197846,"GBR",1758277
1,236.0,"Northern America",728313,673406,54907,504093,840155,"CAN",672124
1,236.0,"Oceania",386034,355284,30750,307809,513015,"NZL",410412
1,236.0,"Eastern Africa",140962,0,140962,104239,173732,"ETH",138986
1,236.0,"Middle Africa",51872,0,51872,39016,65027,"AGO",52022
1,236.0,"Eastern Europe",3849074,3808554,40520,2851215,4752026,"POL",3801621
1,236.0,"Central Asia",1156009,1008993,147016,878337,1463895,"UZB",1171116
1,236.0,"Southern Europe",594282,0,594282,442749,737916,"ITA",590333
1,236.0,"Central America",147672,0,147672,114462,190770,"MEX",152616
1,236.0,"Southern Asia",687947,0,687947,504704,841173,"IRN",672939
1,236.0,"Western Asia",609317,0,609317,445538,742563,"IRQ",594051
1,236.0,"Eastern Asia",734440,0,734440,545296,908827,"JPN",727062
1,236.0,"Southern Africa",92241,0,92241,70145,116908,"ZAF",93527
1,236.0,"South-Eastern Asia",614827,0,614827,482983,804972,"IDN",643978
1,236.0,"Caribbean",139528,0,139528,108211,180352,"CUB",144282
1,237.0,"Pakistan",1619093,1312851,306242,1226069,2043448,"PAK",1634759
1,237.0,"India",5227845,5184024,43821,4060841,6768068,"IND",5414455
1,237.0,"Western Europe",3342512,3336763,5749,2592418,4320697,"NLD",3456558
1,237.0,"China",9180700,8450000,730700,7345325,12242208,"CPR",9793767
1,237.0,"United States of America",2557366,2551234,6132,1965780,3276301,"USA",2621041
1,237.0,"Northern Africa",1290068,0,1290068,992642,1654403,"EGY",1323523
1,237.0,"Russian Federation",2743660,2659211,84449,2228055,3713425,"RUS",2970740
1,237.0,"Western Africa",208921,0,208921,158903,264838,"NGA",211871
1,237.0,"South America",1708336,1200826,507510,1320825,2201375,"BRA",1761100
1,237.0,"Northern Europe",1777962,1716254,61708,1318707,2197846,"GBR",1758277
1,237.0,"Northern America",650800,629050,21750,504093,840155,"CAN",672124
1,237.0,"Oceania",421815,383678,38137,307809,513015,"NZL",410412
1,237.0,"Eastern Africa",137763,0,137763,104239,173732,"ETH",138986
1,237.0,"Middle Africa",51403,0,51403,39016,65027,"AGO",52022
1,237.0,"Eastern Europe",3796855,3770484,26371,2851215,4752026,"POL",3801621
1,237.0,"Central Asia",1150649,1005626,145023,878337,1463895,"UZB",1171116
1,237.0,"Southern Europe",578519,0,578519,442749,737916,"ITA",590333
1,237.0,"Central America",149235,0,149235,114462,190770,"MEX",152616
1,237.0,"Southern Asia",660054,0,660054,504704,841173,"IRN",672939
1,237.0,"Western Asia",580954,0,580954,445538,742563,"IRQ",594051
1,237.0,"Eastern Asia",711082,0,711082,545296,908827,"JPN",727062
1,237.0,"Southern Africa",93319,0,93319,70145,116908,"ZAF",93527
1,237.0,"South-Eastern Asia",653343,0,653343,482983,804972,"IDN",643978
1,237.0,"Caribbean",141081,0,141081,108211,180352,"CUB",144282
1,238.0,"Pakistan",1638100,1311619,326481,1226069,2043448,"PAK",1634759
1,238.0,"India",5278076,5225713,52363,4060841,6768068,"IND",5414455
1,238.0,"Western Europe",3322924,3318922,4002,2592418,4320697,"NLD",3456558
1,238.0,"China",9228809,8438063,790746,7345325,12242208,"CPR",9793767
1,238.0,"United States of America",2552892,2549368,3524,1965780,3276301,"USA",2621041
1,238.0,"Northern Africa",1278795,0,1278795,992642,1654403,"EGY",1323523
1,238.0,"Russian Federation",2813633,2675715,137918,2228055,3713425,"RUS",2970740
1,238.0,"Western Africa",207982,0,207982,158903,264838,"NGA",211871
1,238.0,"South America",1736152,1200571,535581,1320825,2201375,"BRA",1761100
1,238.0,"Northern Europe",1833013,1769427,63586,1318707,2197846,"GBR",1758277
1,238.0,"Northern America",698076,678313,19763,504093,840155,"CAN",672124
1,238.0,"Oceania",372972,357384,15588,307809,513015,"NZL",410412
1,238.0,"Eastern Africa",136312,0,136312,104239,173732,"ETH",138986
1,238.0,"Middle Africa",50452,0,50452,39016,65027,"AGO",52022
1,238.0,"Eastern Europe",3549963,3538531,11432,2851215,4752026,"POL",3801621
1,238.0,"Central Asia",1292034,1143359,148675,878337,1463895,"UZB",1171116
1,238.0,"Southern Europe",586022,0,586022,442749,737916,"ITA",590333
1,238.0,"Central America",148286,0,148286,114462,190770,"MEX",152616
1,238.0,"Southern Asia",675393,0,675393,504704,841173,"IRN",672939
1,238.0,"Western Asia",593413,0,593413,445538,742563,"IRQ",594051
1,238.0,"Eastern Asia",718977,0,718977,545296,908827,"JPN",727062
1,238.0,"Southern Africa",90161,0,90161,70145,116908,"ZAF",93527
1,238.0,"South-Eastern Asia",606747,0,606747,482983,804972,"IDN",643978
1,238.0,"Caribbean",140163,0,140163,108211,180352,"CUB",144282
1,239.0,"Pakistan",1641437,1309359,332078,1226069,2043448,"PAK",1634759
1,239.0,"India",5281517,5228846,52671,4060841,6768068,"IND",5414455
1,239.0,"Western Europe",3288946,3281804,7142,2592418,4320697,"NLD",3456558
1,239.0,"China",9306257,8444335,861922,7345325,12242208,"CPR",9793767
1,239.0,"United States of America",2575273,2568486,6787,1965780,3276301,"USA",2621041
1,239.0,"Northern Africa",1279107,0,1279107,992642,1654403,"EGY",1323523
1,239.0,"Russian Federation",2866093,2674054,192039,2228055,3713425,"RUS",2970740
1,239.0,"Western Africa",209598,0,209598,158903,264838,"NGA",211871
1,239.0,"South America",1743889,1200218,543671,1320825,2201375,"BRA",1761100
1,239.0,"Northern Europe",1689240,1655543,33697,1318707,2197846,"GBR",1758277
1,239.0,"Northern America",645902,636814,9088,504093,840155,"CAN",672124
1,239.0,"Oceania",445185,416935,28250,307809,513015,"NZL",410412
1,239.0,"Eastern Africa",138522,0,138522,104239,173732,"ETH",138986
1,239.0,"Middle Africa",51582,0,51582,39016,65027,"AGO",52022
1,239.0,"Eastern Europe",3714992,3692172,22820,2851215,4752026,"POL",3801621
1,239.0,"Central Asia",1105138,1028474,76664,878337,1463895,"UZB",1171116
1,239.0,"Southern Europe",575379,0,575379,442749,737916,"ITA",590333
1,239.0,"Central America",150789,0,150789,114462,190770,"MEX",152616
1,239.0,"Southern Asia",654285,0,654285,504704,841173,"IRN",672939
1,239.0,"Western Asia",577224,0,577224,445538,742563,"IRQ",594051
1,239.0,"Eastern Asia",708988,0,708988,545296,908827,"JPN",727062
1,239.0,"Southern Africa",94673,0,94673,70145,116908,"ZAF",93527
1,239.0,"South-Eastern Asia",671176,0,671176,482983,804972,"IDN",643978
1,239.0,"Caribbean",142533,0,142533,108211,180352,"CUB",144282
1,240.0,"Pakistan",1642760,1306703,336057,1226073,2043456,"PAK",1634765
1,240.0,"India",5280116,5227983,52133,4060845,6768076,"IND",5414461
1,240.0,"Western Europe",3495302,3484133,11169,2592431,4320718,"NLD",3456575
1,240.0,"China",9403767,8472286,931481,7345335,12242226,"CPR",9793781
1,240.0,"United States of America",2566851,2560728,6123,1965789,3276315,"USA",2621052
1,240.0,"Northern Africa",1313684,0,1313684,992647,1654412,"EGY",1323530
1,240.0,"Russian Federation",2919613,2679402,240211,2228064,3713441,"RUS",2970753
1,240.0,"Western Africa",202840,0,202840,158916,264861,"NGA",211889
1,240.0,"South America",1744149,1196413,547736,1320828,2201381,"BRA",1761105
1,240.0,"Northern Europe",1698091,1666090,32001,1318718,2197863,"GBR",1758291
1,240.0,"Northern America",616307,610937,5370,504108,840180,"CAN",672144
1,240.0,"Oceania",387414,376201,11213,307818,513031,"NZL",410425
1,240.0,"Eastern Africa",131642,0,131642,104239,173732,"ETH",138986
1,240.0,"Middle Africa",50334,0,50334,39016,65027,"AGO",52022
1,240.0,"Eastern Europe",3662895,3643028,19867,2851227,4752046,"POL",3801637
1,240.0,"Central Asia",1023496,986997,36499,878345,1463908,"UZB",1171127
1,240.0,"Southern Europe",565677,0,565677,442746,737911,"ITA",590329
1,240.0,"Central America",148777,0,148777,114464,190773,"MEX",152619
1,240.0,"Southern Asia",637650,0,637650,504703,841172,"IRN",672938
1,240.0,"Western Asia",564827,0,564827,445540,742567,"IRQ",594054
1,240.0,"Eastern Asia",697675,0,697675,545313,908855,"JPN",727084
1,240.0,"Southern Africa",89261,0,89261,70148,116913,"ZAF",93531
1,240.0,"South-Eastern Asia",609631,0,609631,482989,804982,"IDN",643986
1,240.0,"Caribbean",140673,0,140673,108219,180366,"CUB",144293
1,241.0,"Pakistan",1556608,1301721,254887,1194411,1990686,"PAK",1592549
1,241.0,"India",5296566,5244504,52062,3957441,6595736,"IND",5276589
1,241.0,"Western Europe",3280979,3275855,5124,2462349,4103915,"NLD",3283132
1,241.0,"China",9445679,8453611,992068,6976252,11627087,"CPR",9301670
1,241.0,"United States of America",2545620,2542420,3200,2151546,3585910,"USA",2868728
1,241.0,"Northern Africa",1270987,0,1270987,697752,1162920,"EGY",930336
1,241.0,"Russian Federation",2955697,2676819,278878,2369141,3948568,"RUS",3158855
1,241.0,"Western Africa",206159,0,206159,153917,256528,"NGA",205223
1,241.0,"South America",1948950,1455738,493212,1305796,2176327,"BRA",1741062
1,241.0,"Northern Europe",1701830,1674430,27400,1339806,2233011,"GBR",1786409
1,241.0,"Northern America",701354,688537,12817,506521,844202,"CAN",675362
1,241.0,"Oceania",362628,357482,5146,255363,425605,"NZL",340484
1,241.0,"Eastern Africa",135127,0,135127,105960,176601,"ETH",141281
1,241.0,"Middle Africa",49862,0,49862,35628,59380,"AGO",47504
1,241.0,"Eastern Europe",3725743,3704817,20926,2493577,4155962,"POL",3324770
1,241.0,"Central Asia",1126637,1057920,68717,836233,1393722,"UZB",1114978
1,241.0,"Southern Europe",584706,0,584706,368764,614607,"ITA",491686
1,241.0,"Central America",147513,0,147513,179733,299556,"MEX",239645
1,241.0,"Southern Asia",674959,0,674959,413471,689118,"IRN",551295
1,241.0,"Western Asia",594163,0,594163,495030,825050,"IRQ",660040
1,241.0,"Eastern Asia",717921,0,717921,529818,883030,"JPN",706424
1,241.0,"Southern Africa",88959,0,88959,75208,125347,"ZAF",100278
1,241.0,"South-Eastern Asia",599455,0,599455,478779,797966,"IDN",638373
1,241.0,"Caribbean",139435,0,139435,105528,175880,"CUB",140704
1,242.0,"Pakistan",1572314,1296616,275698,1194411,1990686,"PAK",1592549
1,242.0,"India",5266427,5213434,52993,3957441,6595736,"IND",5276589
1,242.0,"Western Europe",3306568,3298082,8486,2462349,4103915,"NLD",3283132
1,242.0,"China",9509226,8444955,1064271,6976252,11627087,"CPR",9301670
1,242.0,"United States of America",2578495,2571383,7112,2151546,3585910,"USA",2868728
1,242.0,"Northern Africa",1290947,0,1290947,697752,1162920,"EGY",930336
1,242.0,"Russian Federation",2985859,2672116,313743,2369141,3948568,"RUS",3158855
1,242.0,"Western Africa",215823,0,215823,153917,256528,"NGA",205223
1,242.0,"South America",1691478,1319252,372226,1305796,2176327,"BRA",1741062
1,242.0,"Northern Europe",1756175,1723879,32296,1339806,2233011,"GBR",1786409
1,242.0,"Northern America",622124,614864,7260,506521,844202,"CAN",675362
1,242.0,"Oceania",553346,529165,24181,255363,425605,"NZL",340484
1,242.0,"Eastern Africa",145434,0,145434,105960,176601,"ETH",141281
1,242.0,"Middle Africa",53985,0,53985,35628,59380,"AGO",47504
1,242.0,"Eastern Europe",3702700,3686495,16205,2493577,4155962,"POL",3324770
1,242.0,"Central Asia",1165562,1083287,82275,836233,1393722,"UZB",1114978
1,242.0,"Southern Europe",572063,0,572063,368764,614607,"ITA",491686
1,242.0,"Central America",152530,0,152530,179733,299556,"MEX",239645
1,242.0,"Southern Asia",647730,0,647730,413471,689118,"IRN",551295
1,242.0,"Western Asia",571580,0,571580,495030,825050,"IRQ",660040
1,242.0,"Eastern Asia",708820,0,708820,529818,883030,"JPN",706424
1,242.0,"Southern Africa",102291,0,102291,75208,125347,"ZAF",100278
1,242.0,"South-Eastern Asia",758367,0,758367,478779,797966,"IDN",638373
1,242.0,"Caribbean",144037,0,144037,105528,175880,"CUB",140704
1,243.0,"Pakistan",1611372,1301249,310123,1194411,1990686,"PAK",1592549
1,243.0,"India",5274746,5215480,59266,3957441,6595736,"IND",5276589
1,243.0,"Western Europe",3458446,3440385,18061,2462349,4103915,"NLD",3283132
1,243.0,"China",9580713,8442950,1137763,6976252,11627087,"CPR",9301670
1,243.0,"United States of America",2721811,2709212,12599,2151546,3585910,"USA",2868728
1,243.0,"Northern Africa",1127347,0,1127347,697752,1162920,"EGY",930336
1,243.0,"Russian Federation",3034283,2674087,360196,2369141,3948568,"RUS",3158855
1,243.0,"Western Africa",216866,0,216866,153917,256528,"NGA",205223
1,243.0,"South America",1561510,1271010,290500,1305796,2176327,"BRA",1741062
1,243.0,"Northern Europe",1673237,1646625,26612,1339806,2233011,"GBR",1786409
1,243.0,"Northern America",728874,709533,19341,506521,844202,"CAN",675362
1,243.0,"Oceania",397915,389987,7928,255363,425605,"NZL",340484
1,243.0,"Eastern Africa",149743,0,149743,105960,176601,"ETH",141281
1,243.0,"Middle Africa",51681,0,51681,35628,59380,"AGO",47504
1,243.0,"Eastern Europe",3697976,3676679,21297,2493577,4155962,"POL",3324770
1,243.0,"Central Asia",1160984,1085943,75041,836233,1393722,"UZB",1114978
1,243.0,"Southern Europe",549522,0,549522,368764,614607,"ITA",491686
1,243.0,"Central America",204309,0,204309,179733,299556,"MEX",239645
1,243.0,"Southern Asia",632783,0,632783,413471,689118,"IRN",551295
1,243.0,"Western Asia",654026,0,654026,495030,825050,"IRQ",660040
1,243.0,"Eastern Asia",732746,0,732746,529818,883030,"JPN",706424
1,243.0,"Southern Africa",103530,0,103530,75208,125347,"ZAF",100278
1,243.0,"South-Eastern Asia",690043,0,690043,478779,797966,"IDN",638373
1,243.0,"Caribbean",143523,0,143523,105528,175880,"CUB",140704
1,244.0,"Pakistan",1633615,1298601,335014,1194411,1990686,"PAK",1592549
1,244.0,"India",5280076,5201183,78893,3957441,6595736,"IND",5276589
1,244.0,"Western Europe",3452608,3428033,24575,2462349,4103915,"NLD",3283132
1,244.0,"China",9640378,8441617,1198761,6976252,11627087,"CPR",9301670
1,244.0,"United States of America",2833203,2808002,25201,2151546,3585910,"USA",2868728
1,244.0,"Northern Africa",1043107,0,1043107,697752,1162920,"EGY",930336
1,244.0,"Russian Federation",3087355,2672763,414592,2369141,3948568,"RUS",3158855
1,244.0,"Western Africa",214109,0,214109,153917,256528,"NGA",205223
1,244.0,"South America",1711519,1359837,351682,1305796,2176327,"BRA",1741062
1,244.0,"Northern Europe",1791726,1734987,56739,1339806,2233011,"GBR",1786409
1,244.0,"Northern America",666634,646152,20482,506521,844202,"CAN",675362
1,244.0,"Oceania",354457,351239,3218,255363,425605,"NZL",340484
1,244.0,"Eastern Africa",146425,0,146425,105960,176601,"ETH",141281
1,244.0,"Middle Africa",50517,0,50517,35628,59380,"AGO",47504
1,244.0,"Eastern Europe",3615459,3591451,24008,2493577,4155962,"POL",3324770
1,244.0,"Central Asia",1154589,1081116,73473,836233,1393722,"UZB",1114978
1,244.0,"Southern Europe",519253,0,519253,368764,614607,"ITA",491686
1,244.0,"Central America",231804,0,231804,179733,299556,"MEX",239645
1,244.0,"Southern Asia",582664,0,582664,413471,689118,"IRN",551295
1,244.0,"Western Asia",655464,0,655464,495030,825050,"IRQ",660040
1,244.0,"Eastern Asia",718821,0,718821,529818,883030,"JPN",706424
1,244.0,"Southern Africa",103543,0,103543,75208,125347,"ZAF",100278
1,244.0,"South-Eastern Asia",657719,0,657719,478779,797966,"IDN",638373
1,244.0,"Caribbean",146089,0,146089,105528,175880,"CUB",140704
1,245.0,"Pakistan",1641416,1297267,344149,1194411,1990686,"PAK",1592549
1,245.0,"India",5187715,5086442,101273,3957441,6595736,"IND",5276589
1,245.0,"Western Europe",3420179,3393780,26399,2462349,4103915,"NLD",3283132
1,245.0,"China",9695512,8443344,1252168,6976252,11627087,"CPR",9301670
1,245.0,"United States of America",2948051,2912379,35672,2151546,3585910,"USA",2868728
1,245.0,"Northern Africa",997535,0,997535,697752,1162920,"EGY",930336
1,245.0,"Russian Federation",3153088,2678220,474868,2369141,3948568,"RUS",3158855
1,245.0,"Western Africa",208205,0,208205,153917,256528,"NGA",205223
1,245.0,"South America",1797324,1404545,392779,1305796,2176327,"BRA",1741062
1,245.0,"Northern Europe",1844473,1766582,77891,1339806,2233011,"GBR",1786409
1,245.0,"Northern America",673164,648316,24848,506521,844202,"CAN",675362
1,245.0,"Oceania",308812,307433,1379,255363,425605,"NZL",340484
1,245.0,"Eastern Africa",140226,0,140226,105960,176601,"ETH",141281
1,245.0,"Middle Africa",48319,0,48319,35628,59380,"AGO",47504
1,245.0,"Eastern Europe",3433390,3410284,23106,2493577,4155962,"POL",3324770
1,245.0,"Central Asia",1150830,1073055,77775,836233,1393722,"UZB",1114978
1,245.0,"Southern Europe",514884,0,514884,368764,614607,"ITA",491686
1,245.0,"Central America",239102,0,239102,179733,299556,"MEX",239645
1,245.0,"Southern Asia",573007,0,573007,413471,689118,"IRN",551295
1,245.0,"Western Asia",666393,0,666393,495030,825050,"IRQ",660040
1,245.0,"Eastern Asia",724263,0,724263,529818,883030,"JPN",706424
1,245.0,"Southern Africa",98466,0,98466,75208,125347,"ZAF",100278
1,245.0,"South-Eastern Asia",608921,0,608921,478779,797966,"IDN",638373
1,245.0,"Caribbean",145414,0,145414,105528,175880,"CUB",140704
1,246.0,"Pakistan",1735750,1377795,357955,1194411,1990686,"PAK",1592549
1,246.0,"India",5216621,5082161,134460,3957441,6595736,"IND",5276589
1,246.0,"Western Europe",3380001,3357548,22453,2462349,4103915,"NLD",3283132
1,246.0,"China",9747569,8455581,1291988,6976252,11627087,"CPR",9301670
1,246.0,"United States of America",3031543,2999162,32381,2151546,3585910,"USA",2868728
1,246.0,"Northern Africa",965806,0,965806,697752,1162920,"EGY",930336
1,246.0,"Russian Federation",3215634,2684894,530740,2369141,3948568,"RUS",3158855
1,246.0,"Western Africa",202110,0,202110,153917,256528,"NGA",205223
1,246.0,"South America",1839365,1423895,415470,1305796,2176327,"BRA",1741062
1,246.0,"Northern Europe",1869468,1780355,89113,1339806,2233011,"GBR",1786409
1,246.0,"Northern America",682137,656173,25964,506521,844202,"CAN",675362
1,246.0,"Oceania",285411,284927,484,255363,425605,"NZL",340484
1,246.0,"Eastern Africa",134467,0,134467,105960,176601,"ETH",141281
1,246.0,"Middle Africa",46353,0,46353,35628,59380,"AGO",47504
1,246.0,"Eastern Europe",3281501,3261258,20243,2493577,4155962,"POL",3324770
1,246.0,"Central Asia",1166452,1084233,82219,836233,1393722,"UZB",1114978
1,246.0,"Southern Europe",505582,0,505582,368764,614607,"ITA",491686
1,246.0,"Central America",237863,0,237863,179733,299556,"MEX",239645
1,246.0,"Southern Asia",559944,0,559944,413471,689118,"IRN",551295
1,246.0,"Western Asia",668217,0,668217,495030,825050,"IRQ",660040
1,246.0,"Eastern Asia",724944,0,724944,529818,883030,"JPN",706424
1,246.0,"Southern Africa",93965,0,93965,75208,125347,"ZAF",100278
1,246.0,"South-Eastern Asia",577914,0,577914,478779,797966,"IDN",638373
1,246.0,"Caribbean",143051,0,143051,105528,175880,"CUB",140704
1,247.0,"Pakistan",1643700,1368764,274936,1194411,1990686,"PAK",1592549
1,247.0,"India",5275964,5094189,181775,3957441,6595736,"IND",5276589
1,247.0,"Western Europe",3219435,3208638,10797,2462349,4103915,"NLD",3283132
1,247.0,"China",9781061,8466084,1314977,6976252,11627087,"CPR",9301670
1,247.0,"United States of America",2918386,2903428,14958,2151546,3585910,"USA",2868728
1,247.0,"Northern Africa",936298,0,936298,697752,1162920,"EGY",930336
1,247.0,"Russian Federation",3269350,2685087,584263,2369141,3948568,"RUS",3158855
1,247.0,"Western Africa",212156,0,212156,153917,256528,"NGA",205223
1,247.0,"South America",1806356,1426737,379619,1305796,2176327,"BRA",1741062
1,247.0,"Northern Europe",1852786,1781231,71555,1339806,2233011,"GBR",1786409
1,247.0,"Northern America",682176,664840,17336,506521,844202,"CAN",675362
1,247.0,"Oceania",367364,363170,4194,255363,425605,"NZL",340484
1,247.0,"Eastern Africa",146690,0,146690,105960,176601,"ETH",141281
1,247.0,"Middle Africa",49002,0,49002,35628,59380,"AGO",47504
1,247.0,"Eastern Europe",3416048,3398473,17575,2493577,4155962,"POL",3324770
1,247.0,"Central Asia",1135271,1083975,51296,836233,1393722,"UZB",1114978
1,247.0,"Southern Europe",502631,0,502631,368764,614607,"ITA",491686
1,247.0,"Central America",247686,0,247686,179733,299556,"MEX",239645
1,247.0,"Southern Asia",563594,0,563594,413471,689118,"IRN",551295
1,247.0,"Western Asia",666700,0,666700,495030,825050,"IRQ",660040
1,247.0,"Eastern Asia",722557,0,722557,529818,883030,"JPN",706424
1,247.0,"Southern Africa",104817,0,104817,75208,125347,"ZAF",100278
1,247.0,"South-Eastern Asia",673019,0,673019,478779,797966,"IDN",638373
1,247.0,"Caribbean",145656,0,145656,105528,175880,"CUB",140704
1,248.0,"Pakistan",1570311,1364825,205486,1194411,1990686,"PAK",1592549
1,248.0,"India",5400219,5185365,214854,3957441,6595736,"IND",5276589
1,248.0,"Western Europe",3350259,3333757,16502,2462349,4103915,"NLD",3283132
1,248.0,"China",9989121,8755026,1234095,6976252,11627087,"CPR",9301670
1,248.0,"United States of America",2905974,2892202,13772,2151546,3585910,"USA",2868728
1,248.0,"Northern Africa",909306,0,909306,697752,1162920,"EGY",930336
1,248.0,"Russian Federation",3487175,2916167,571008,2369141,3948568,"RUS",3158855
1,248.0,"Western Africa",203965,0,203965,153917,256528,"NGA",205223
1,248.0,"South America",1786915,1430656,356259,1305796,2176327,"BRA",1741062
1,248.0,"Northern Europe",1829495,1776532,52963,1339806,2233011,"GBR",1786409
1,248.0,"Northern America",702776,683583,19193,506521,844202,"CAN",675362
1,248.0,"Oceania",316302,314691,1611,255363,425605,"NZL",340484
1,248.0,"Eastern Africa",138889,0,138889,105960,176601,"ETH",141281
1,248.0,"Middle Africa",46897,0,46897,35628,59380,"AGO",47504
1,248.0,"Eastern Europe",2677908,2663362,14546,2493577,4155962,"POL",3324770
1,248.0,"Central Asia",1123614,1083543,40071,836233,1393722,"UZB",1114978
1,248.0,"Southern Europe",499451,0,499451,368764,614607,"ITA",491686
1,248.0,"Central America",237728,0,237728,179733,299556,"MEX",239645
1,248.0,"Southern Asia",557751,0,557751,413471,689118,"IRN",551295
1,248.0,"Western Asia",655740,0,655740,495030,825050,"IRQ",660040
1,248.0,"Eastern Asia",712293,0,712293,529818,883030,"JPN",706424
1,248.0,"Southern Africa",97621,0,97621,75208,125347,"ZAF",100278
1,248.0,"South-Eastern Asia",600663,0,600663,478779,797966,"IDN",638373
1,248.0,"Caribbean",140529,0,140529,105528,175880,"CUB",140704
1,249.0,"Pakistan",1576076,1365187,210889,1194411,1990686,"PAK",1592549
1,249.0,"India",5449748,5217462,232286,3957441,6595736,"IND",5276589
1,249.0,"Western Europe",3279412,3272048,7364,2462349,4103915,"NLD",3283132
1,249.0,"China",9830505,8720787,1109718,6976252,11627087,"CPR",9301670
1,249.0,"United States of America",2892945,2886772,6173,2151546,3585910,"USA",2868728
1,249.0,"Northern Africa",929456,0,929456,697752,1162920,"EGY",930336
1,249.0,"Russian Federation",3383001,2898349,484652,2369141,3948568,"RUS",3158855
1,249.0,"Western Africa",203000,0,203000,153917,256528,"NGA",205223
1,249.0,"South America",1778605,1430240,348365,1305796,2176327,"BRA",1741062
1,249.0,"Northern Europe",1952270,1909552,42718,1339806,2233011,"GBR",1786409
1,249.0,"Northern America",619074,611227,7847,506521,844202,"CAN",675362
1,249.0,"Oceania",340047,339364,683,255363,425605,"NZL",340484
1,249.0,"Eastern Africa",137828,0,137828,105960,176601,"ETH",141281
1,249.0,"Middle Africa",47357,0,47357,35628,59380,"AGO",47504
1,249.0,"Eastern Europe",3071039,2946861,124178,2493577,4155962,"POL",3324770
1,249.0,"Central Asia",1123560,1084843,38717,836233,1393722,"UZB",1114978
1,249.0,"Southern Europe",478927,0,478927,368764,614607,"ITA",491686
1,249.0,"Central America",239714,0,239714,179733,299556,"MEX",239645
1,249.0,"Southern Asia",528780,0,528780,413471,689118,"IRN",551295
1,249.0,"Western Asia",633752,0,633752,495030,825050,"IRQ",660040
1,249.0,"Eastern Asia",690707,0,690707,529818,883030,"JPN",706424
1,249.0,"Southern Africa",99669,0,99669,75208,125347,"ZAF",100278
1,249.0,"South-Eastern Asia",631325,0,631325,478779,797966,"IDN",638373
1,249.0,"Caribbean",140957,0,140957,105528,175880,"CUB",140704
1,250.0,"Pakistan",1594887,1374479,220408,1194411,1990686,"PAK",1592549
1,250.0,"India",5463989,5226992,236997,3957441,6595736,"IND",5276589
1,250.0,"Western Europe",3323419,3312707,10712,2462349,4103915,"NLD",3283132
1,250.0,"China",9685465,8709011,976454,6976252,11627087,"CPR",9301670
1,250.0,"United States of America",2860305,2856523,3782,2151546,3585910,"USA",2868728
1,250.0,"Northern Africa",949270,0,949270,697752,1162920,"EGY",930336
1,250.0,"Russian Federation",3210296,2880624,329672,2369141,3948568,"RUS",3158855
1,250.0,"Western Africa",202814,0,202814,153917,256528,"NGA",205223
1,250.0,"South America",1751571,1427828,323743,1305796,2176327,"BRA",1741062
1,250.0,"Northern Europe",1768322,1751216,17106,1339806,2233011,"GBR",1786409
1,250.0,"Northern America",723868,688022,35846,506521,844202,"CAN",675362
1,250.0,"Oceania",311190,310964,226,255363,425605,"NZL",340484
1,250.0,"Eastern Africa",139735,0,139735,105960,176601,"ETH",141281
1,250.0,"Middle Africa",46459,0,46459,35628,59380,"AGO",47504
1,250.0,"Eastern Europe",3349649,3125327,224322,2493577,4155962,"POL",3324770
1,250.0,"Central Asia",1094622,1055602,39020,836233,1393722,"UZB",1114978
1,250.0,"Southern Europe",500735,0,500735,368764,614607,"ITA",491686
1,250.0,"Central America",235736,0,235736,179733,299556,"MEX",239645
1,250.0,"Southern Asia",568591,0,568591,413471,689118,"IRN",551295
1,250.0,"Western Asia",690190,0,690190,495030,825050,"IRQ",660040
1,250.0,"Eastern Asia",720397,0,720397,529818,883030,"JPN",706424
1,250.0,"Southern Africa",96602,0,96602,75208,125347,"ZAF",100278
1,250.0,"South-Eastern Asia",616887,0,616887,478779,797966,"IDN",638373
1,250.0,"Caribbean",138818,0,138818,105528,175880,"CUB",140704
1,251.0,"Pakistan",1599914,1378618,221296,1194411,1990686,"PAK",1592549
1,251.0,"India",5471104,5233062,238042,3957441,6595736,"IND",5276589
1,251.0,"Western Europe",3300007,3292198,7809,2462349,4103915,"NLD",3283132
1,251.0,"China",9553508,8684518,868990,6976252,11627087,"CPR",9301670
1,251.0,"United States of America",2856366,2853957,2409,2151546,3585910,"USA",2868728
1,251.0,"Northern Africa",948539,0,948539,697752,1162920,"EGY",930336
1,251.0,"Russian Federation",3155778,2869537,286241,2369141,3948568,"RUS",3158855
1,251.0,"Western Africa",212051,0,212051,153917,256528,"NGA",205223
1,251.0,"South America",1745679,1434367,311312,1305796,2176327,"BRA",1741062
1,251.0,"Northern Europe",1647332,1639995,7337,1339806,2233011,"GBR",1786409
1,251.0,"Northern America",657884,643072,14812,506521,844202,"CAN",675362
1,251.0,"Oceania",400503,390636,9867,255363,425605,"NZL",340484
1,251.0,"Eastern Africa",149880,0,149880,105960,176601,"ETH",141281
1,251.0,"Middle Africa",50000,0,50000,35628,59380,"AGO",47504
1,251.0,"Eastern Europe",3533496,3232029,301467,2493577,4155962,"POL",3324770
1,251.0,"Central Asia",1118581,1077317,41264,836233,1393722,"UZB",1114978
1,251.0,"Southern Europe",494431,0,494431,368764,614607,"ITA",491686
1,251.0,"Central America",243827,0,243827,179733,299556,"MEX",239645
1,251.0,"Southern Asia",559816,0,559816,413471,689118,"IRN",551295
1,251.0,"Western Asia",662248,0,662248,495030,825050,"IRQ",660040
1,251.0,"Eastern Asia",709540,0,709540,529818,883030,"JPN",706424
1,251.0,"Southern Africa",108516,0,108516,75208,125347,"ZAF",100278
1,251.0,"South-Eastern Asia",710843,0,710843,478779,797966,"IDN",638373
1,251.0,"Caribbean",142477,0,142477,105528,175880,"CUB",140704
1,252.0,"Pakistan",1607875,1384351,223524,1194418,1990697,"PAK",1592558
1,252.0,"India",5462292,5241423,220869,3957447,6595745,"IND",5276596
1,252.0,"Western Europe",3217436,3208858,8578,2462365,4103942,"NLD",3283154
1,252.0,"China",9433770,8671755,762015,6976263,11627105,"CPR",9301684
1,252.0,"United States of America",2845812,2840572,5240,2151554,3585923,"USA",2868739
1,252.0,"Northern Africa",927396,0,927396,697753,1162922,"EGY",930338
1,252.0,"Russian Federation",3128388,2875512,252876,2369144,3948573,"RUS",3158859
1,252.0,"Western Africa",206225,0,206225,153915,256525,"NGA",205220
1,252.0,"South America",1741504,1438253,303251,1305798,2176331,"BRA",1741065
1,252.0,"Northern Europe",1863571,1838549,25022,1339810,2233017,"GBR",1786414
1,252.0,"Northern America",725228,703806,21422,506529,844215,"CAN",675372
1,252.0,"Oceania",327420,323629,3791,255371,425618,"NZL",340495
1,252.0,"Eastern Africa",143192,0,143192,105960,176601,"ETH",141281
1,252.0,"Middle Africa",47181,0,47181,35628,59380,"AGO",47504
1,252.0,"Eastern Europe",3632731,3295541,337190,2493593,4155988,"POL",3324791
1,252.0,"Central Asia",1123401,1080612,42789,836247,1393745,"UZB",1114996
1,252.0,"Southern Europe",503214,0,503214,368763,614605,"ITA",491684
1,252.0,"Central America",239704,0,239704,179733,299555,"MEX",239644
1,252.0,"Southern Asia",573032,0,573032,413466,689111,"IRN",551289
1,252.0,"Western Asia",687560,0,687560,495031,825052,"IRQ",660042
1,252.0,"Eastern Asia",722191,0,722191,529829,883048,"JPN",706439
1,252.0,"Southern Africa",99448,0,99448,75204,125341,"ZAF",100273
1,252.0,"South-Eastern Asia",635119,0,635119,478782,797970,"IDN",638376
1,252.0,"Caribbean",140853,0,140853,105536,175893,"CUB",140715
1,253.0,"Pakistan",1631357,1393156,238201,1200647,2001078,"PAK",1600863
1,253.0,"India",5371201,5243484,127717,4042141,6736902,"IND",5389522
1,253.0,"Western Europe",3454795,3441675,13120,2452580,4087633,"NLD",3270107
1,253.0,"China",9295012,8659252,635760,6951843,11586405,"CPR",9269124
1,253.0,"United States of America",3004076,2996134,7942,2039802,3399670,"USA",2719736
1,253.0,"Northern Africa",974309,0,974309,890403,1484006,"EGY",1187205
1,253.0,"Russian Federation",3173125,2900508,272617,2253696,3756160,"RUS",3004928
1,253.0,"Western Africa",204404,0,204404,167817,279696,"NGA",223757
1,253.0,"South America",1237258,1024861,212397,1283945,2139908,"BRA",1711927
1,253.0,"Northern Europe",1828327,1813031,15296,1377492,2295821,"GBR",1836657
1,253.0,"Northern America",655224,647225,7999,452432,754053,"CAN",603243
1,253.0,"Oceania",311505,310057,1448,285130,475217,"NZL",380174
1,253.0,"Eastern Africa",136092,0,136092,99330,165550,"ETH",132440
1,253.0,"Middle Africa",47015,0,47015,40586,67643,"AGO",54115
1,253.0,"Eastern Europe",3633483,3322041,311442,2497339,4162232,"POL",3329786
1,253.0,"Central Asia",1132951,1089943,43008,812170,1353617,"UZB",1082894
1,253.0,"Southern Europe",492791,0,492791,498869,831448,"ITA",665159
1,253.0,"Central America",242764,0,242764,140747,234578,"MEX",187663
1,253.0,"Southern Asia",539492,0,539492,443868,739781,"IRN",591825
1,253.0,"Western Asia",660038,0,660038,620634,1034391,"IRQ",827513
1,253.0,"Eastern Asia",714211,0,714211,608976,1014960,"JPN",811968
1,253.0,"Southern Africa",96757,0,96757,25974,43291,"ZAF",34633
1,253.0,"South-Eastern Asia",605506,0,605506,503691,839486,"IDN",671589
1,253.0,"Caribbean",143132,0,143132,122409,204015,"CUB",163212
1,254.0,"Pakistan",1619999,1390593,229406,1200647,2001078,"PAK",1600863
1,254.0,"India",5370900,5257666,113234,4042141,6736902,"IND",5389522
1,254.0,"Western Europe",3258606,3252610,5996,2452580,4087633,"NLD",3270107
1,254.0,"China",9350243,8719922,630321,6951843,11586405,"CPR",9269124
1,254.0,"United States of America",2859312,2855523,3789,2039802,3399670,"USA",2719736
1,254.0,"Northern Africa",934556,0,934556,890403,1484006,"EGY",1187205
1,254.0,"Russian Federation",3184068,2910873,273195,2253696,3756160,"RUS",3004928
1,254.0,"Western Africa",216741,0,216741,167817,279696,"NGA",223757
1,254.0,"South America",1399294,1029107,370187,1283945,2139908,"BRA",1711927
1,254.0,"Northern Europe",1803463,1791917,11546,1377492,2295821,"GBR",1836657
1,254.0,"Northern America",690415,675016,15399,452432,754053,"CAN",603243
1,254.0,"Oceania",414379,405204,9175,285130,475217,"NZL",380174
1,254.0,"Eastern Africa",156998,0,156998,99330,165550,"ETH",132440
1,254.0,"Middle Africa",51608,0,51608,40586,67643,"AGO",54115
1,254.0,"Eastern Europe",3506013,3296842,209171,2497339,4162232,"POL",3329786
1,254.0,"Central Asia",1134053,1089930,44123,812170,1353617,"UZB",1082894
1,254.0,"Southern Europe",506937,0,506937,498869,831448,"ITA",665159
1,254.0,"Central America",248793,0,248793,140747,234578,"MEX",187663
1,254.0,"Southern Asia",581338,0,581338,443868,739781,"IRN",591825
1,254.0,"Western Asia",673383,0,673383,620634,1034391,"IRQ",827513
1,254.0,"Eastern Asia",718852,0,718852,608976,1014960,"JPN",811968
1,254.0,"Southern Africa",113897,0,113897,25974,43291,"ZAF",34633
1,254.0,"South-Eastern Asia",735181,0,735181,503691,839486,"IDN",671589
1,254.0,"Caribbean",144544,0,144544,122409,204015,"CUB",163212
1,255.0,"Pakistan",1639555,1390781,248774,1200647,2001078,"PAK",1600863
1,255.0,"India",5385671,5257443,128228,4042141,6736902,"IND",5389522
1,255.0,"Western Europe",3205746,3189598,16148,2452580,4087633,"NLD",3270107
1,255.0,"China",9411123,8742371,668752,6951843,11586405,"CPR",9269124
1,255.0,"United States of America",2929932,2919480,10452,2039802,3399670,"USA",2719736
1,255.0,"Northern Africa",1079995,0,1079995,890403,1484006,"EGY",1187205
1,255.0,"Russian Federation",3200169,2906039,294130,2253696,3756160,"RUS",3004928
1,255.0,"Western Africa",225469,0,225469,167817,279696,"NGA",223757
1,255.0,"South America",1563947,1032753,531194,1283945,2139908,"BRA",1711927
1,255.0,"Northern Europe",1780153,1765927,14226,1377492,2295821,"GBR",1836657
1,255.0,"Northern America",606118,592407,13711,452432,754053,"CAN",603243
1,255.0,"Oceania",392414,389064,3350,285130,475217,"NZL",380174
1,255.0,"Eastern Africa",140431,0,140431,99330,165550,"ETH",132440
1,255.0,"Middle Africa",54467,0,54467,40586,67643,"AGO",54115
1,255.0,"Eastern Europe",3241295,3141159,100136,2497339,4162232,"POL",3329786
1,255.0,"Central Asia",1146116,1089630,56486,812170,1353617,"UZB",1082894
1,255.0,"Southern Europe",602264,0,602264,498869,831448,"ITA",665159
1,255.0,"Central America",219555,0,219555,140747,234578,"MEX",187663
1,255.0,"Southern Asia",572738,0,572738,443868,739781,"IRN",591825
1,255.0,"Western Asia",750302,0,750302,620634,1034391,"IRQ",827513
1,255.0,"Eastern Asia",786131,0,786131,608976,1014960,"JPN",811968
1,255.0,"Southern Africa",60757,0,60757,25974,43291,"ZAF",34633
1,255.0,"South-Eastern Asia",693336,0,693336,503691,839486,"IDN",671589
1,255.0,"Caribbean",163360,0,163360,122409,204015,"CUB",163212
1,256.0,"Pakistan",1597496,1384013,213483,1200647,2001078,"PAK",1600863
1,256.0,"India",5387970,5265138,122832,4042141,6736902,"IND",5389522
1,256.0,"Western Europe",3296163,3263970,32193,2452580,4087633,"NLD",3270107
1,256.0,"China",9321791,8728743,593048,6951843,11586405,"CPR",9269124
1,256.0,"United States of America",2746300,2731818,14482,2039802,3399670,"USA",2719736
1,256.0,"Northern Africa",1159010,0,1159010,890403,1484006,"EGY",1187205
1,256.0,"Russian Federation",3128409,2893130,235279,2253696,3756160,"RUS",3004928
1,256.0,"Western Africa",224846,0,224846,167817,279696,"NGA",223757
1,256.0,"South America",1690428,1032224,658204,1283945,2139908,"BRA",1711927
1,256.0,"Northern Europe",1780620,1751802,28818,1377492,2295821,"GBR",1836657
1,256.0,"Northern America",701481,667285,34196,452432,754053,"CAN",603243
1,256.0,"Oceania",358456,357320,1136,285130,475217,"NZL",380174
1,256.0,"Eastern Africa",135827,0,135827,99330,165550,"ETH",132440
1,256.0,"Middle Africa",53014,0,53014,40586,67643,"AGO",54115
1,256.0,"Eastern Europe",3283759,3171729,112030,2497339,4162232,"POL",3329786
1,256.0,"Central Asia",1117507,1067543,49964,812170,1353617,"UZB",1082894
1,256.0,"Southern Europe",669418,0,669418,498869,831448,"ITA",665159
1,256.0,"Central America",196354,0,196354,140747,234578,"MEX",187663
1,256.0,"Southern Asia",626985,0,626985,443868,739781,"IRN",591825
1,256.0,"Western Asia",855052,0,855052,620634,1034391,"IRQ",827513
1,256.0,"Eastern Asia",834673,0,834673,608976,1014960,"JPN",811968
1,256.0,"Southern Africa",41220,0,41220,25974,43291,"ZAF",34633
1,256.0,"South-Eastern Asia",659846,0,659846,503691,839486,"IDN",671589
1,256.0,"Caribbean",162333,0,162333,122409,204015,"CUB",163212
1,257.0,"Pakistan",1611465,1383990,227475,1200647,2001078,"PAK",1600863
1,257.0,"India",5505918,5373714,132204,4042141,6736902,"IND",5389522
1,257.0,"Western Europe",3340677,3297695,42982,2452580,4087633,"NLD",3270107
1,257.0,"China",9317275,8730773,586502,6951843,11586405,"CPR",9269124
1,257.0,"United States of America",2720120,2701504,18616,2039802,3399670,"USA",2719736
1,257.0,"Northern Africa",1187051,0,1187051,890403,1484006,"EGY",1187205
1,257.0,"Russian Federation",3086510,2869552,216958,2253696,3756160,"RUS",3004928
1,257.0,"Western Africa",215737,0,215737,167817,279696,"NGA",223757
1,257.0,"South America",1797520,1032232,765288,1283945,2139908,"BRA",1711927
1,257.0,"Northern Europe",1932652,1881943,50709,1377492,2295821,"GBR",1836657
1,257.0,"Northern America",619285,599750,19535,452432,754053,"CAN",603243
1,257.0,"Oceania",335218,334565,653,285130,475217,"NZL",380174
1,257.0,"Eastern Africa",125441,0,125441,99330,165550,"ETH",132440
1,257.0,"Middle Africa",51025,0,51025,40586,67643,"AGO",54115
1,257.0,"Eastern Europe",3382980,3250000,132980,2497339,4162232,"POL",3329786
1,257.0,"Central Asia",1057766,1008966,48800,812170,1353617,"UZB",1082894
1,257.0,"Southern Europe",653615,0,653615,498869,831448,"ITA",665159
1,257.0,"Central America",184627,0,184627,140747,234578,"MEX",187663
1,257.0,"Southern Asia",583147,0,583147,443868,739781,"IRN",591825
1,257.0,"Western Asia",828477,0,828477,620634,1034391,"IRQ",827513
1,257.0,"Eastern Asia",806486,0,806486,608976,1014960,"JPN",811968
1,257.0,"Southern Africa",34417,0,34417,25974,43291,"ZAF",34633
1,257.0,"South-Eastern Asia",616917,0,616917,503691,839486,"IDN",671589
1,257.0,"Caribbean",157910,0,157910,122409,204015,"CUB",163212
1,258.0,"Pakistan",1680492,1440121,240371,1200647,2001078,"PAK",1600863
1,258.0,"India",5505949,5373271,132678,4042141,6736902,"IND",5389522
1,258.0,"Western Europe",3347928,3314908,33020,2452580,4087633,"NLD",3270107
1,258.0,"China",9345196,8740946,604250,6951843,11586405,"CPR",9269124
1,258.0,"United States of America",2703788,2692985,10803,2039802,3399670,"USA",2719736
1,258.0,"Northern Africa",1192066,0,1192066,890403,1484006,"EGY",1187205
1,258.0,"Russian Federation",3035216,2848405,186811,2253696,3756160,"RUS",3004928
1,258.0,"Western Africa",222487,0,222487,167817,279696,"NGA",223757
1,258.0,"South America",1885966,1035219,850747,1283945,2139908,"BRA",1711927
1,258.0,"Northern Europe",1777935,1753877,24058,1377492,2295821,"GBR",1836657
1,258.0,"Northern America",547677,540118,7559,452432,754053,"CAN",603243
1,258.0,"Oceania",389191,387329,1862,285130,475217,"NZL",380174
1,258.0,"Eastern Africa",132288,0,132288,99330,165550,"ETH",132440
1,258.0,"Middle Africa",54846,0,54846,40586,67643,"AGO",54115
1,258.0,"Eastern Europe",3435555,3289386,146169,2497339,4162232,"POL",3329786
1,258.0,"Central Asia",1112480,1050796,61684,812170,1353617,"UZB",1082894
1,258.0,"Southern Europe",643656,0,643656,498869,831448,"ITA",665159
1,258.0,"Central America",187888,0,187888,140747,234578,"MEX",187663
1,258.0,"Southern Asia",568948,0,568948,443868,739781,"IRN",591825
1,258.0,"Western Asia",791405,0,791405,620634,1034391,"IRQ",827513
1,258.0,"Eastern Asia",780931,0,780931,608976,1014960,"JPN",811968
1,258.0,"Southern Africa",35921,0,35921,25974,43291,"ZAF",34633
1,258.0,"South-Eastern Asia",680699,0,680699,503691,839486,"IDN",671589
1,258.0,"Caribbean",161876,0,161876,122409,204015,"CUB",163212
1,259.0,"Pakistan",1526182,1388613,137569,1200647,2001078,"PAK",1600863
1,259.0,"India",5483862,5356991,126871,4042141,6736902,"IND",5389522
1,259.0,"Western Europe",3260284,3240107,20177,2452580,4087633,"NLD",3270107
1,259.0,"China",9332003,8728347,603656,6951843,11586405,"CPR",9269124
1,259.0,"United States of America",2746356,2736732,9624,2039802,3399670,"USA",2719736
1,259.0,"Northern Africa",1186554,0,1186554,890403,1484006,"EGY",1187205
1,259.0,"Russian Federation",3010235,2831235,179000,2253696,3756160,"RUS",3004928
1,259.0,"Western Africa",224302,0,224302,167817,279696,"NGA",223757
1,259.0,"South America",1953434,1033135,920299,1283945,2139908,"BRA",1711927
1,259.0,"Northern Europe",1852980,1814265,38715,1377492,2295821,"GBR",1836657
1,259.0,"Northern America",712048,686968,25080,452432,754053,"CAN",603243
1,259.0,"Oceania",354265,353445,820,285130,475217,"NZL",380174
1,259.0,"Eastern Africa",132398,0,132398,99330,165550,"ETH",132440
1,259.0,"Middle Africa",52572,0,52572,40586,67643,"AGO",54115
1,259.0,"Eastern Europe",3400422,3265232,135190,2497339,4162232,"POL",3329786
1,259.0,"Central Asia",997229,957130,40099,812170,1353617,"UZB",1082894
1,259.0,"Southern Europe",694062,0,694062,498869,831448,"ITA",665159
1,259.0,"Central America",187473,0,187473,140747,234578,"MEX",187663
1,259.0,"Southern Asia",629871,0,629871,443868,739781,"IRN",591825
1,259.0,"Western Asia",884489,0,884489,620634,1034391,"IRQ",827513
1,259.0,"Eastern Asia",857433,0,857433,608976,1014960,"JPN",811968
1,259.0,"Southern Africa",33736,0,33736,25974,43291,"ZAF",34633
1,259.0,"South-Eastern Asia",642334,0,642334,503691,839486,"IDN",671589
1,259.0,"Caribbean",163355,0,163355,122409,204015,"CUB",163212
1,260.0,"Pakistan",1583565,1418991,164574,1200647,2001078,"PAK",1600863
1,260.0,"India",5421033,5333410,87623,4042141,6736902,"IND",5389522
1,260.0,"Western Europe",3255693,3233439,22254,2452580,4087633,"NLD",3270107
1,260.0,"China",9850619,9288318,562301,6951843,11586405,"CPR",9269124
1,260.0,"United States of America",2366248,2354566,11682,2039802,3399670,"USA",2719736
1,260.0,"Northern Africa",1146644,0,1146644,890403,1484006,"EGY",1187205
1,260.0,"Russian Federation",2925677,2770032,155645,2253696,3756160,"RUS",3004928
1,260.0,"Western Africa",220897,0,220897,167817,279696,"NGA",223757
1,260.0,"South America",1946104,1034648,911456,1283945,2139908,"BRA",1711927
1,260.0,"Northern Europe",1909823,1870498,39325,1377492,2295821,"GBR",1836657
1,260.0,"Northern America",566446,557796,8650,452432,754053,"CAN",603243
1,260.0,"Oceania",414490,405466,9024,285130,475217,"NZL",380174
1,260.0,"Eastern Africa",139197,0,139197,99330,165550,"ETH",132440
1,260.0,"Middle Africa",55440,0,55440,40586,67643,"AGO",54115
1,260.0,"Eastern Europe",3483339,3395409,87930,2497339,4162232,"POL",3329786
1,260.0,"Central Asia",1131478,1030666,100812,812170,1353617,"UZB",1082894
1,260.0,"Southern Europe",640092,0,640092,498869,831448,"ITA",665159
1,260.0,"Central America",176980,0,176980,140747,234578,"MEX",187663
1,260.0,"Southern Asia",594286,0,594286,443868,739781,"IRN",591825
1,260.0,"Western Asia",795779,0,795779,620634,1034391,"IRQ",827513
1,260.0,"Eastern Asia",744390,0,744390,608976,1014960,"JPN",811968
1,260.0,"Southern Africa",36071,0,36071,25974,43291,"ZAF",34633
1,260.0,"South-Eastern Asia",713649,0,713649,503691,839486,"IDN",671589
1,260.0,"Caribbean",153526,0,153526,122409,204015,"CUB",163212
1,261.0,"Pakistan",1585218,1421972,163246,1200647,2001078,"PAK",1600863
1,261.0,"India",5389709,5319459,70250,4042141,6736902,"IND",5389522
1,261.0,"Western Europe",3304746,3272522,32224,2452580,4087633,"NLD",3270107
1,261.0,"China",9510718,9208888,301830,6951843,11586405,"CPR",9269124
1,261.0,"United States of America",2874550,2789470,85080,2039802,3399670,"USA",2719736
1,261.0,"Northern Africa",1214329,0,1214329,890403,1484006,"EGY",1187205
1,261.0,"Russian Federation",2896596,2782172,114424,2253696,3756160,"RUS",3004928
1,261.0,"Western Africa",222021,0,222021,167817,279696,"NGA",223757
1,261.0,"South America",1987850,1033867,953983,1283945,2139908,"BRA",1711927
1,261.0,"Northern Europe",1991784,1960633,31151,1377492,2295821,"GBR",1836657
1,261.0,"Northern America",549741,542226,7515,452432,754053,"CAN",603243
1,261.0,"Oceania",361660,358690,2970,285130,475217,"NZL",380174
1,261.0,"Eastern Africa",125836,0,125836,99330,165550,"ETH",132440
1,261.0,"Middle Africa",53208,0,53208,40586,67643,"AGO",54115
1,261.0,"Eastern Europe",3351185,3295908,55277,2497339,4162232,"POL",3329786
1,261.0,"Central Asia",1119849,1030747,89102,812170,1353617,"UZB",1082894
1,261.0,"Southern Europe",655170,0,655170,498869,831448,"ITA",665159
1,261.0,"Central America",191365,0,191365,140747,234578,"MEX",187663
1,261.0,"Southern Asia",559429,0,559429,443868,739781,"IRN",591825
1,261.0,"Western Asia",808770,0,808770,620634,1034391,"IRQ",827513
1,261.0,"Eastern Asia",811343,0,811343,608976,1014960,"JPN",811968
1,261.0,"Southern Africa",33841,0,33841,25974,43291,"ZAF",34633
1,261.0,"South-Eastern Asia",645889,0,645889,503691,839486,"IDN",671589
1,261.0,"Caribbean",166316,0,166316,122409,204015,"CUB",163212
1,262.0,"Pakistan",1649224,1445909,203315,1200647,2001078,"PAK",1600863
1,262.0,"India",5389780,5329829,59951,4042141,6736902,"IND",5389522
1,262.0,"Western Europe",3313853,3285174,28679,2452580,4087633,"NLD",3270107
1,262.0,"China",9337440,9185259,152181,6951843,11586405,"CPR",9269124
1,262.0,"United States of America",2946434,2895933,50501,2039802,3399670,"USA",2719736
1,262.0,"Northern Africa",1216414,0,1216414,890403,1484006,"EGY",1187205
1,262.0,"Russian Federation",2987020,2820276,166744,2253696,3756160,"RUS",3004928
1,262.0,"Western Africa",225399,0,225399,167817,279696,"NGA",223757
1,262.0,"South America",1927570,1033585,893985,1283945,2139908,"BRA",1711927
1,262.0,"Northern Europe",1811273,1799407,11866,1377492,2295821,"GBR",1836657
1,262.0,"Northern America",673079,650612,22467,452432,754053,"CAN",603243
1,262.0,"Oceania",348567,346263,2304,285130,475217,"NZL",380174
1,262.0,"Eastern Africa",127972,0,127972,99330,165550,"ETH",132440
1,262.0,"Middle Africa",52504,0,52504,40586,67643,"AGO",54115
1,262.0,"Eastern Europe",3220110,3194971,25139,2497339,4162232,"POL",3329786
1,262.0,"Central Asia",1278555,1205906,72649,812170,1353617,"UZB",1082894
1,262.0,"Southern Europe",698269,0,698269,498869,831448,"ITA",665159
1,262.0,"Central America",193362,0,193362,140747,234578,"MEX",187663
1,262.0,"Southern Asia",615091,0,615091,443868,739781,"IRN",591825
1,262.0,"Western Asia",874654,0,874654,620634,1034391,"IRQ",827513
1,262.0,"Eastern Asia",878008,0,878008,608976,1014960,"JPN",811968
1,262.0,"Southern Africa",33227,0,33227,25974,43291,"ZAF",34633
1,262.0,"South-Eastern Asia",635420,0,635420,503691,839486,"IDN",671589
1,262.0,"Caribbean",168824,0,168824,122409,204015,"CUB",163212
1,263.0,"Pakistan",1648448,1449720,198728,1200647,2001078,"PAK",1600863
1,263.0,"India",5409981,5339695,70286,4042141,6736902,"IND",5389522
1,263.0,"Western Europe",3327889,3293877,34012,2452580,4087633,"NLD",3270107
1,263.0,"China",9330304,9196782,133522,6951843,11586405,"CPR",9269124
1,263.0,"United States of America",2849159,2819319,29840,2039802,3399670,"USA",2719736
1,263.0,"Northern Africa",1222992,0,1222992,890403,1484006,"EGY",1187205
1,263.0,"Russian Federation",3048957,2837237,211720,2253696,3756160,"RUS",3004928
1,263.0,"Western Africa",244735,0,244735,167817,279696,"NGA",223757
1,263.0,"South America",1790566,1032467,758099,1283945,2139908,"BRA",1711927
1,263.0,"Northern Europe",1822664,1804946,17718,1377492,2295821,"GBR",1836657
1,263.0,"Northern America",586948,577217,9731,452432,754053,"CAN",603243
1,263.0,"Oceania",454107,425223,28884,285130,475217,"NZL",380174
1,263.0,"Eastern Africa",150507,0,150507,99330,165550,"ETH",132440
1,263.0,"Middle Africa",61625,0,61625,40586,67643,"AGO",54115
1,263.0,"Eastern Europe",3329218,3280092,49126,2497339,4162232,"POL",3329786
1,263.0,"Central Asia",1086878,1059387,27491,812170,1353617,"UZB",1082894
1,263.0,"Southern Europe",681402,0,681402,498869,831448,"ITA",665159
1,263.0,"Central America",204374,0,204374,140747,234578,"MEX",187663
1,263.0,"Southern Asia",618577,0,618577,443868,739781,"IRN",591825
1,263.0,"Western Asia",843831,0,843831,620634,1034391,"IRQ",827513
1,263.0,"Eastern Asia",835142,0,835142,608976,1014960,"JPN",811968
1,263.0,"Southern Africa",39978,0,39978,25974,43291,"ZAF",34633
1,263.0,"South-Eastern Asia",784123,0,784123,503691,839486,"IDN",671589
1,263.0,"Caribbean",177074,0,177074,122409,204015,"CUB",163212
1,264.0,"Pakistan",1666753,1454559,212194,1200660,2001100,"PAK",1600880
1,264.0,"India",5449478,5351697,97781,4042157,6736928,"IND",5389543
1,264.0,"Western Europe",3438593,3391339,47254,2452584,4087641,"NLD",3270113
1,264.0,"China",9320952,9175668,145284,6951852,11586420,"CPR",9269136
1,264.0,"United States of America",2771837,2751371,20466,2039804,3399673,"USA",2719739
1,264.0,"Northern Africa",1240452,0,1240452,890401,1484002,"EGY",1187202
1,264.0,"Russian Federation",3108769,2848313,260456,2253702,3756170,"RUS",3004936
1,264.0,"Western Africa",232144,0,232144,167828,279713,"NGA",223771
1,264.0,"South America",1750608,1033596,717012,1283960,2139933,"BRA",1711947
1,264.0,"Northern Europe",1880131,1851238,28893,1377497,2295828,"GBR",1836663
1,264.0,"Northern America",616507,601934,14573,452445,754076,"CAN",603261
1,264.0,"Oceania",398972,390304,8668,285142,475237,"NZL",380190
1,264.0,"Eastern Africa",138067,0,138067,99332,165553,"ETH",132443
1,264.0,"Middle Africa",56420,0,56420,40588,67647,"AGO",54118
1,264.0,"Eastern Europe",3471625,3396420,75205,2497345,4162242,"POL",3329794
1,264.0,"Central Asia",966773,944817,21956,812178,1353631,"UZB",1082905
1,264.0,"Southern Europe",686559,0,686559,498876,831461,"ITA",665169
1,264.0,"Central America",193379,0,193379,140749,234582,"MEX",187666
1,264.0,"Southern Asia",610932,0,610932,443867,739778,"IRN",591823
1,264.0,"Western Asia",852398,0,852398,620637,1034396,"IRQ",827517
1,264.0,"Eastern Asia",828054,0,828054,608983,1014972,"JPN",811978
1,264.0,"Southern Africa",36046,0,36046,25968,43281,"ZAF",34625
1,264.0,"South-Eastern Asia",698487,0,698487,503696,839493,"IDN",671595
1,264.0,"Caribbean",168079,0,168079,122415,204025,"CUB",163220
1,265.0,"Pakistan",1646999,1455360,191639,1272144,2120240,"PAK",1696192
1,265.0,"India",5479146,5357163,121983,4268804,7114673,"IND",5691739
1,265.0,"Western Europe",3402982,3362614,40368,2676381,4460635,"NLD",3568508
1,265.0,"China",9369391,9213625,155766,7121455,11869092,"CPR",9495274
1,265.0,"United States of America",2759720,2741398,18322,2339702,3899503,"USA",3119603
1,265.0,"Northern Africa",1222757,0,1222757,873731,1456218,"EGY",1164975
1,265.0,"Russian Federation",3135941,2847491,288450,2346376,3910627,"RUS",3128502
1,265.0,"Western Africa",218030,0,218030,220683,367806,"NGA",294245
1,265.0,"South America",1969743,1258608,711135,1337587,2229312,"BRA",1783450
1,265.0,"Northern Europe",1924477,1894963,29514,1426240,2377067,"GBR",1901654
1,265.0,"Northern America",585654,573141,12513,506889,844816,"CAN",675853
1,265.0,"Oceania",348824,345812,3012,311436,519060,"NZL",415248
1,265.0,"Eastern Africa",124541,0,124541,141619,236032,"ETH",188826
1,265.0,"Middle Africa",51638,0,51638,51888,86480,"AGO",69184
1,265.0,"Eastern Europe",3497966,3419191,78775,2635681,4392802,"POL",3514242
1,265.0,"Central Asia",1192143,1134767,57376,782797,1304662,"UZB",1043730
1,265.0,"Southern Europe",665221,0,665221,582531,970886,"ITA",776709
1,265.0,"Central America",185024,0,185024,223095,371825,"MEX",297460
1,265.0,"Southern Asia",573325,0,573325,380560,634267,"IRN",507414
1,265.0,"Western Asia",825216,0,825216,683195,1138658,"IRQ",910927
1,265.0,"Eastern Asia",812746,0,812746,684477,1140796,"JPN",912637
1,265.0,"Southern Africa",32697,0,32697,40428,67381,"ZAF",53905
1,265.0,"South-Eastern Asia",628315,0,628315,448899,748166,"IDN",598533
1,265.0,"Caribbean",161044,0,161044,128724,214541,"CUB",171633
1,266.0,"Pakistan",1639271,1455769,183502,1272144,2120240,"PAK",1696192
1,266.0,"India",5523436,5363249,160187,4268804,7114673,"IND",5691739
1,266.0,"Western Europe",3351692,3327965,23727,2676381,4460635,"NLD",3568508
1,266.0,"China",9389873,9208827,181046,7121455,11869092,"CPR",9495274
1,266.0,"United States of America",2794388,2780903,13485,2339702,3899503,"USA",3119603
1,266.0,"Northern Africa",1214401,0,1214401,873731,1456218,"EGY",1164975
1,266.0,"Russian Federation",3169095,2851781,317314,2346376,3910627,"RUS",3128502
1,266.0,"Western Africa",215812,0,215812,220683,367806,"NGA",294245
1,266.0,"South America",1809828,1264939,544889,1337587,2229312,"BRA",1783450
1,266.0,"Northern Europe",1774135,1757406,16729,1426240,2377067,"GBR",1901654
1,266.0,"Northern America",694313,672754,21559,506889,844816,"CAN",675853
1,266.0,"Oceania",331584,322273,9311,311436,519060,"NZL",415248
1,266.0,"Eastern Africa",122491,0,122491,141619,236032,"ETH",188826
1,266.0,"Middle Africa",50570,0,50570,51888,86480,"AGO",69184
1,266.0,"Eastern Europe",3491991,3424848,67143,2635681,4392802,"POL",3514242
1,266.0,"Central Asia",1070763,1051029,19734,782797,1304662,"UZB",1043730
1,266.0,"Southern Europe",699282,0,699282,582531,970886,"ITA",776709
1,266.0,"Central America",186757,0,186757,223095,371825,"MEX",297460
1,266.0,"Southern Asia",620062,0,620062,380560,634267,"IRN",507414
1,266.0,"Western Asia",874822,0,874822,683195,1138658,"IRQ",910927
1,266.0,"Eastern Asia",850486,0,850486,684477,1140796,"JPN",912637
1,266.0,"Southern Africa",32059,0,32059,40428,67381,"ZAF",53905
1,266.0,"South-Eastern Asia",601052,0,601052,448899,748166,"IDN",598533
1,266.0,"Caribbean",161787,0,161787,128724,214541,"CUB",171633
1,267.0,"Pakistan",1636368,1457213,179155,1272144,2120240,"PAK",1696192
1,267.0,"India",5549530,5363687,185843,4268804,7114673,"IND",5691739
1,267.0,"Western Europe",3431932,3406389,25543,2676381,4460635,"NLD",3568508
1,267.0,"China",9427313,9244223,183090,7121455,11869092,"CPR",9495274
1,267.0,"United States of America",2820747,2800828,19919,2339702,3899503,"USA",3119603
1,267.0,"Northern Africa",1153261,0,1153261,873731,1456218,"EGY",1164975
1,267.0,"Russian Federation",3118513,2848288,270225,2346376,3910627,"RUS",3128502
1,267.0,"Western Africa",282820,0,282820,220683,367806,"NGA",294245
1,267.0,"South America",1727638,1326957,400681,1337587,2229312,"BRA",1783450
1,267.0,"Northern Europe",1926272,1880631,45641,1426240,2377067,"GBR",1901654
1,267.0,"Northern America",630158,623491,6667,506889,844816,"CAN",675853
1,267.0,"Oceania",450646,407474,43172,311436,519060,"NZL",415248
1,267.0,"Eastern Africa",184719,0,184719,141619,236032,"ETH",188826
1,267.0,"Middle Africa",68466,0,68466,51888,86480,"AGO",69184
1,267.0,"Eastern Europe",3373791,3334798,38993,2635681,4392802,"POL",3514242
1,267.0,"Central Asia",1030887,1010995,19892,782797,1304662,"UZB",1043730
1,267.0,"Southern Europe",732875,0,732875,582531,970886,"ITA",776709
1,267.0,"Central America",261272,0,261272,223095,371825,"MEX",297460
1,267.0,"Southern Asia",543434,0,543434,380560,634267,"IRN",507414
1,267.0,"Western Asia",870275,0,870275,683195,1138658,"IRQ",910927
1,267.0,"Eastern Asia",854829,0,854829,684477,1140796,"JPN",912637
1,267.0,"Southern Africa",50970,0,50970,40428,67381,"ZAF",53905
1,267.0,"South-Eastern Asia",690329,0,690329,448899,748166,"IDN",598533
1,267.0,"Caribbean",169505,0,169505,128724,214541,"CUB",171633
1,268.0,"Pakistan",1621447,1455200,166247,1272144,2120240,"PAK",1696192
1,268.0,"India",5587383,5367590,219793,4268804,7114673,"IND",5691739
1,268.0,"Western Europe",3441213,3412386,28827,2676381,4460635,"NLD",3568508
1,268.0,"China",9413589,9275111,138478,7121455,11869092,"CPR",9495274
1,268.0,"United States of America",3271339,3234968,36371,2339702,3899503,"USA",3119603
1,268.0,"Northern Africa",1150114,0,1150114,873731,1456218,"EGY",1164975
1,268.0,"Russian Federation",3046241,2846105,200136,2346376,3910627,"RUS",3128502
1,268.0,"Western Africa",277287,0,277287,220683,367806,"NGA",294245
1,268.0,"South America",1536299,1232048,304251,1337587,2229312,"BRA",1783450
1,268.0,"Northern Europe",1849719,1815871,33848,1426240,2377067,"GBR",1901654
1,268.0,"Northern America",623082,619286,3796,506889,844816,"CAN",675853
1,268.0,"Oceania",403423,381272,22151,311436,519060,"NZL",415248
1,268.0,"Eastern Africa",174641,0,174641,141619,236032,"ETH",188826
1,268.0,"Middle Africa",65006,0,65006,51888,86480,"AGO",69184
1,268.0,"Eastern Europe",3375124,3331066,44058,2635681,4392802,"POL",3514242
1,268.0,"Central Asia",1049047,1027323,21724,782797,1304662,"UZB",1043730
1,268.0,"Southern Europe",741990,0,741990,582531,970886,"ITA",776709
1,268.0,"Central America",285104,0,285104,223095,371825,"MEX",297460
1,268.0,"Southern Asia",488367,0,488367,380560,634267,"IRN",507414
1,268.0,"Western Asia",877135,0,877135,683195,1138658,"IRQ",910927
1,268.0,"Eastern Asia",906590,0,906590,684477,1140796,"JPN",912637
1,268.0,"Southern Africa",49306,0,49306,40428,67381,"ZAF",53905
1,268.0,"South-Eastern Asia",595223,0,595223,448899,748166,"IDN",598533
1,268.0,"Caribbean",171602,0,171602,128724,214541,"CUB",171633
1,269.0,"Pakistan",1655867,1460119,195748,1272144,2120240,"PAK",1696192
1,269.0,"India",5763214,5527797,235417,4268804,7114673,"IND",5691739
1,269.0,"Western Europe",3443587,3413619,29968,2676381,4460635,"NLD",3568508
1,269.0,"China",9378483,9244591,133892,7121455,11869092,"CPR",9495274
1,269.0,"United States of America",2955752,2942702,13050,2339702,3899503,"USA",3119603
1,269.0,"Northern Africa",1128667,0,1128667,873731,1456218,"EGY",1164975
1,269.0,"Russian Federation",3041414,2838415,202999,2346376,3910627,"RUS",3128502
1,269.0,"Western Africa",283393,0,283393,220683,367806,"NGA",294245
1,269.0,"South America",1822097,1456542,365555,1337587,2229312,"BRA",1783450
1,269.0,"Northern Europe",1905138,1872196,32942,1426240,2377067,"GBR",1901654
1,269.0,"Northern America",644760,636524,8236,506889,844816,"CAN",675853
1,269.0,"Oceania",387931,373507,14424,311436,519060,"NZL",415248
1,269.0,"Eastern Africa",178296,0,178296,141619,236032,"ETH",188826
1,269.0,"Middle Africa",66214,0,66214,51888,86480,"AGO",69184
1,269.0,"Eastern Europe",3444022,3391591,52431,2635681,4392802,"POL",3514242
1,269.0,"Central Asia",991091,981341,9750,782797,1304662,"UZB",1043730
1,269.0,"Southern Europe",747436,0,747436,582531,970886,"ITA",776709
1,269.0,"Central America",284047,0,284047,223095,371825,"MEX",297460
1,269.0,"Southern Asia",488476,0,488476,380560,634267,"IRN",507414
1,269.0,"Western Asia",876965,0,876965,683195,1138658,"IRQ",910927
1,269.0,"Eastern Asia",872580,0,872580,684477,1140796,"JPN",912637
1,269.0,"Southern Africa",51432,0,51432,40428,67381,"ZAF",53905
1,269.0,"South-Eastern Asia",566944,0,566944,448899,748166,"IDN",598533
1,269.0,"Caribbean",164852,0,164852,128724,214541,"CUB",171633
1,270.0,"Pakistan",1735506,1507053,228453,1272144,2120240,"PAK",1696192
1,270.0,"India",5713793,5536874,176919,4268804,7114673,"IND",5691739
1,270.0,"Western Europe",3542323,3511708,30615,2676381,4460635,"NLD",3568508
1,270.0,"China",9393307,9278968,114339,7121455,11869092,"CPR",9495274
1,270.0,"United States of America",2920372,2911786,8586,2339702,3899503,"USA",3119603
1,270.0,"Northern Africa",1143456,0,1143456,873731,1456218,"EGY",1164975
1,270.0,"Russian Federation",3056611,2846820,209791,2346376,3910627,"RUS",3128502
1,270.0,"Western Africa",295656,0,295656,220683,367806,"NGA",294245
1,270.0,"South America",1591699,1352983,238716,1337587,2229312,"BRA",1783450
1,270.0,"Northern Europe",1762514,1751181,11333,1426240,2377067,"GBR",1901654
1,270.0,"Northern America",654803,646082,8721,506889,844816,"CAN",675853
1,270.0,"Oceania",480779,462149,18630,311436,519060,"NZL",415248
1,270.0,"Eastern Africa",203289,0,203289,141619,236032,"ETH",188826
1,270.0,"Middle Africa",72263,0,72263,51888,86480,"AGO",69184
1,270.0,"Eastern Europe",3446338,3394850,51488,2635681,4392802,"POL",3514242
1,270.0,"Central Asia",1023971,1014499,9472,782797,1304662,"UZB",1043730
1,270.0,"Southern Europe",752080,0,752080,582531,970886,"ITA",776709
1,270.0,"Central America",284919,0,284919,223095,371825,"MEX",297460
1,270.0,"Southern Asia",513182,0,513182,380560,634267,"IRN",507414
1,270.0,"Western Asia",880791,0,880791,683195,1138658,"IRQ",910927
1,270.0,"Eastern Asia",870458,0,870458,684477,1140796,"JPN",912637
1,270.0,"Southern Africa",56465,0,56465,40428,67381,"ZAF",53905
1,270.0,"South-Eastern Asia",669815,0,669815,448899,748166,"IDN",598533
1,270.0,"Caribbean",167556,0,167556,128724,214541,"CUB",171633
1,271.0,"Pakistan",1642156,1490862,151294,1272144,2120240,"PAK",1696192
1,271.0,"India",5616046,5524196,91850,4268804,7114673,"IND",5691739
1,271.0,"Western Europe",3445454,3427326,18128,2676381,4460635,"NLD",3568508
1,271.0,"China",9370953,9287284,83669,7121455,11869092,"CPR",9495274
1,271.0,"United States of America",3035510,3020648,14862,2339702,3899503,"USA",3119603
1,271.0,"Northern Africa",1128641,0,1128641,873731,1456218,"EGY",1164975
1,271.0,"Russian Federation",3059642,2843274,216368,2346376,3910627,"RUS",3128502
1,271.0,"Western Africa",291995,0,291995,220683,367806,"NGA",294245
1,271.0,"South America",1820057,1513766,306291,1337587,2229312,"BRA",1783450
1,271.0,"Northern Europe",1960077,1928057,32020,1426240,2377067,"GBR",1901654
1,271.0,"Northern America",643690,634386,9304,506889,844816,"CAN",675853
1,271.0,"Oceania",399495,392662,6833,311436,519060,"NZL",415248
1,271.0,"Eastern Africa",184826,0,184826,141619,236032,"ETH",188826
1,271.0,"Middle Africa",68315,0,68315,51888,86480,"AGO",69184
1,271.0,"Eastern Europe",3458177,3413566,44611,2635681,4392802,"POL",3514242
1,271.0,"Central Asia",958655,948505,10150,782797,1304662,"UZB",1043730
1,271.0,"Southern Europe",754059,0,754059,582531,970886,"ITA",776709
1,271.0,"Central America",293174,0,293174,223095,371825,"MEX",297460
1,271.0,"Southern Asia",489510,0,489510,380560,634267,"IRN",507414
1,271.0,"Western Asia",880731,0,880731,683195,1138658,"IRQ",910927
1,271.0,"Eastern Asia",882987,0,882987,684477,1140796,"JPN",912637
1,271.0,"Southern Africa",53329,0,53329,40428,67381,"ZAF",53905
1,271.0,"South-Eastern Asia",577738,0,577738,448899,748166,"IDN",598533
1,271.0,"Caribbean",169002,0,169002,128724,214541,"CUB",171633
1,272.0,"Pakistan",1658937,1501582,157355,1272144,2120240,"PAK",1696192
1,272.0,"India",5578657,5524675,53982,4268804,7114673,"IND",5691739
1,272.0,"Western Europe",3637688,3620864,16824,2676381,4460635,"NLD",3568508
1,272.0,"China",9305840,9257233,48607,7121455,11869092,"CPR",9495274
1,272.0,"United States of America",3422390,3408170,14220,2339702,3899503,"USA",3119603
1,272.0,"Northern Africa",1202381,0,1202381,873731,1456218,"EGY",1164975
1,272.0,"Russian Federation",3320879,3082701,238178,2346376,3910627,"RUS",3128502
1,272.0,"Western Africa",283283,0,283283,220683,367806,"NGA",294245
1,272.0,"South America",1713568,1506466,207102,1337587,2229312,"BRA",1783450
1,272.0,"Northern Europe",1806477,1788493,17984,1426240,2377067,"GBR",1901654
1,272.0,"Northern America",718479,703327,15152,506889,844816,"CAN",675853
1,272.0,"Oceania",362121,359413,2708,311436,519060,"NZL",415248
1,272.0,"Eastern Africa",172870,0,172870,141619,236032,"ETH",188826
1,272.0,"Middle Africa",64516,0,64516,51888,86480,"AGO",69184
1,272.0,"Eastern Europe",3743828,3715061,28767,2635681,4392802,"POL",3514242
1,272.0,"Central Asia",1179510,1132163,47347,782797,1304662,"UZB",1043730
1,272.0,"Southern Europe",806829,0,806829,582531,970886,"ITA",776709
1,272.0,"Central America",306684,0,306684,223095,371825,"MEX",297460
1,272.0,"Southern Asia",512286,0,512286,380560,634267,"IRN",507414
1,272.0,"Western Asia",958256,0,958256,683195,1138658,"IRQ",910927
1,272.0,"Eastern Asia",977228,0,977228,684477,1140796,"JPN",912637
1,272.0,"Southern Africa",49500,0,49500,40428,67381,"ZAF",53905
1,272.0,"South-Eastern Asia",542834,0,542834,448899,748166,"IDN",598533
1,272.0,"Caribbean",175971,0,175971,128724,214541,"CUB",171633
1,273.0,"Pakistan",1712942,1504675,208267,1272144,2120240,"PAK",1696192
1,273.0,"India",5599198,5530245,68953,4268804,7114673,"IND",5691739
1,273.0,"Western Europe",3658120,3635066,23054,2676381,4460635,"NLD",3568508
1,273.0,"China",9337873,9268878,68995,7121455,11869092,"CPR",9495274
1,273.0,"United States of America",3172468,3166951,5517,2339702,3899503,"USA",3119603
1,273.0,"Northern Africa",1198018,0,1198018,873731,1456218,"EGY",1164975
1,273.0,"Russian Federation",3252492,3062839,189653,2346376,3910627,"RUS",3128502
1,273.0,"Western Africa",306539,0,306539,220683,367806,"NGA",294245
1,273.0,"South America",1881065,1620375,260690,1337587,2229312,"BRA",1783450
1,273.0,"Northern Europe",1935394,1885843,49551,1426240,2377067,"GBR",1901654
1,273.0,"Northern America",704698,692334,12364,506889,844816,"CAN",675853
1,273.0,"Oceania",434459,401876,32583,311436,519060,"NZL",415248
1,273.0,"Eastern Africa",197751,0,197751,141619,236032,"ETH",188826
1,273.0,"Middle Africa",72356,0,72356,51888,86480,"AGO",69184
1,273.0,"Eastern Europe",3642684,3627106,15578,2635681,4392802,"POL",3514242
1,273.0,"Central Asia",996421,979468,16953,782797,1304662,"UZB",1043730
1,273.0,"Southern Europe",802407,0,802407,582531,970886,"ITA",776709
1,273.0,"Central America",308979,0,308979,223095,371825,"MEX",297460
1,273.0,"Southern Asia",526437,0,526437,380560,634267,"IRN",507414
1,273.0,"Western Asia",941039,0,941039,683195,1138658,"IRQ",910927
1,273.0,"Eastern Asia",940347,0,940347,684477,1140796,"JPN",912637
1,273.0,"Southern Africa",56480,0,56480,40428,67381,"ZAF",53905
1,273.0,"South-Eastern Asia",622271,0,622271,448899,748166,"IDN",598533
1,273.0,"Caribbean",178100,0,178100,128724,214541,"CUB",171633
1,274.0,"Pakistan",1744591,1505930,238661,1272144,2120240,"PAK",1696192
1,274.0,"India",5641292,5531623,109669,4268804,7114673,"IND",5691739
1,274.0,"Western Europe",3682377,3654220,28157,2676381,4460635,"NLD",3568508
1,274.0,"China",9406828,9295366,111462,7121455,11869092,"CPR",9495274
1,274.0,"United States of America",3136767,3134753,2014,2339702,3899503,"USA",3119603
1,274.0,"Northern Africa",1191916,0,1191916,873731,1456218,"EGY",1164975
1,274.0,"Russian Federation",3211214,3047383,163831,2346376,3910627,"RUS",3128502
1,274.0,"Western Africa",302609,0,302609,220683,367806,"NGA",294245
1,274.0,"South America",1899401,1658217,241184,1337587,2229312,"BRA",1783450
1,274.0,"Northern Europe",2085507,2017789,67718,1426240,2377067,"GBR",1901654
1,274.0,"Northern America",647634,643587,4047,506889,844816,"CAN",675853
1,274.0,"Oceania",426164,415767,10397,311436,519060,"NZL",415248
1,274.0,"Eastern Africa",193222,0,193222,141619,236032,"ETH",188826
1,274.0,"Middle Africa",71280,0,71280,51888,86480,"AGO",69184
1,274.0,"Eastern Europe",3428090,3422878,5212,2635681,4392802,"POL",3514242
1,274.0,"Central Asia",1015722,981170,34552,782797,1304662,"UZB",1043730
1,274.0,"Southern Europe",777409,0,777409,582531,970886,"ITA",776709
1,274.0,"Central America",300838,0,300838,223095,371825,"MEX",297460
1,274.0,"Southern Asia",501249,0,501249,380560,634267,"IRN",507414
1,274.0,"Western Asia",904670,0,904670,683195,1138658,"IRQ",910927
1,274.0,"Eastern Asia",906608,0,906608,684477,1140796,"JPN",912637
1,274.0,"Southern Africa",55707,0,55707,40428,67381,"ZAF",53905
1,274.0,"South-Eastern Asia",613487,0,613487,448899,748166,"IDN",598533
1,274.0,"Caribbean",173448,0,173448,128724,214541,"CUB",171633
1,275.0,"Pakistan",1766349,1503441,262908,1272144,2120240,"PAK",1696192
1,275.0,"India",5694808,5536436,158372,4268804,7114673,"IND",5691739
1,275.0,"Western Europe",3667455,3648710,18745,2676381,4460635,"NLD",3568508
1,275.0,"China",9467188,9304035,163153,7121455,11869092,"CPR",9495274
1,275.0,"United States of America",3021077,3020013,1064,2339702,3899503,"USA",3119603
1,275.0,"Northern Africa",1180702,0,1180702,873731,1456218,"EGY",1164975
1,275.0,"Russian Federation",3132824,3028967,103857,2346376,3910627,"RUS",3128502
1,275.0,"Western Africa",290748,0,290748,220683,367806,"NGA",294245
1,275.0,"South America",1814509,1651846,162663,1337587,2229312,"BRA",1783450
1,275.0,"Northern Europe",1865927,1844168,21759,1426240,2377067,"GBR",1901654
1,275.0,"Northern America",758886,738151,20735,506889,844816,"CAN",675853
1,275.0,"Oceania",404013,400534,3479,311436,519060,"NZL",415248
1,275.0,"Eastern Africa",186088,0,186088,141619,236032,"ETH",188826
1,275.0,"Middle Africa",68119,0,68119,51888,86480,"AGO",69184
1,275.0,"Eastern Europe",3534308,3519668,14640,2635681,4392802,"POL",3514242
1,275.0,"Central Asia",1128566,1064790,63776,782797,1304662,"UZB",1043730
1,275.0,"Southern Europe",808773,0,808773,582531,970886,"ITA",776709
1,275.0,"Central America",293622,0,293622,223095,371825,"MEX",297460
1,275.0,"Southern Asia",539320,0,539320,380560,634267,"IRN",507414
1,275.0,"Western Asia",950398,0,950398,683195,1138658,"IRQ",910927
1,275.0,"Eastern Asia",931779,0,931779,684477,1140796,"JPN",912637
1,275.0,"Southern Africa",53045,0,53045,40428,67381,"ZAF",53905
1,275.0,"South-Eastern Asia",587239,0,587239,448899,748166,"IDN",598533
1,275.0,"Caribbean",168820,0,168820,128724,214541,"CUB",171633
1,276.0,"Pakistan",1743086,1500044,243042,1272144,2120241,"PAK",1696193
1,276.0,"India",5750404,5540998,209406,4268811,7114685,"IND",5691748
1,276.0,"Western Europe",3541442,3529719,11723,2676390,4460650,"NLD",3568520
1,276.0,"China",9519707,9302163,217544,7121459,11869098,"CPR",9495279
1,276.0,"United States of America",3350802,3341020,9782,2339713,3899522,"USA",3119618
1,276.0,"Northern Africa",1180706,0,1180706,873730,1456217,"EGY",1164974
1,276.0,"Russian Federation",3087232,3028278,58954,2346390,3910650,"RUS",3128520
1,276.0,"Western Africa",305262,0,305262,220695,367825,"NGA",294260
1,276.0,"South America",1726448,1649630,76818,1337603,2229338,"BRA",1783471
1,276.0,"Northern Europe",1900169,1873628,26541,1426244,2377073,"GBR",1901659
1,276.0,"Northern America",653667,647032,6635,506899,844832,"CAN",675866
1,276.0,"Oceania",437009,428195,8814,311445,519075,"NZL",415260
1,276.0,"Eastern Africa",196892,0,196892,141619,236032,"ETH",188826
1,276.0,"Middle Africa",71801,0,71801,51891,86486,"AGO",69189
1,276.0,"Eastern Europe",3541245,3525655,15590,2635688,4392813,"POL",3514251
1,276.0,"Central Asia",991934,965468,26466,782808,1304680,"UZB",1043744
1,276.0,"Southern Europe",780268,0,780268,582531,970886,"ITA",776709
1,276.0,"Central America",313499,0,313499,223092,371821,"MEX",297457
1,276.0,"Southern Asia",505809,0,505809,380563,634272,"IRN",507418
1,276.0,"Western Asia",919929,0,919929,683187,1138645,"IRQ",910916
1,276.0,"Eastern Asia",943798,0,943798,684480,1140800,"JPN",912640
1,276.0,"Southern Africa",55836,0,55836,40428,67381,"ZAF",53905
1,276.0,"South-Eastern Asia",625911,0,625911,448895,748158,"IDN",598527
1,276.0,"Caribbean",181246,0,181246,128736,214560,"CUB",171648
1,277.0,"Pakistan",1731579,1497515,234064,1281667,2136112,"PAK",1708890
1,277.0,"India",5786287,5530156,256131,4391330,7318883,"IND",5855107
1,277.0,"Western Europe",3609356,3590692,18664,2591498,4319163,"NLD",3455331
1,277.0,"China",9567960,9295620,272340,7150712,11917853,"CPR",9534283
1,277.0,"United States of America",3052342,3049478,2864,2203431,3672386,"USA",2937909
1,277.0,"Northern Africa",1171056,0,1171056,871569,1452616,"EGY",1162093
1,277.0,"Russian Federation",3104821,3031900,72921,2225547,3709246,"RUS",2967397
1,277.0,"Western Africa",295270,0,295270,204022,340037,"NGA",272030
1,277.0,"South America",1787125,1687430,99695,1355298,2258830,"BRA",1807064
1,277.0,"Northern Europe",2013167,1975235,37932,1481035,2468392,"GBR",1974714
1,277.0,"Northern America",659700,650879,8821,526026,876711,"CAN",701369
1,277.0,"Oceania",414079,410358,3721,334125,556875,"NZL",445500
1,277.0,"Eastern Africa",189110,0,189110,145667,242778,"ETH",194223
1,277.0,"Middle Africa",69536,0,69536,53047,88412,"AGO",70730
1,277.0,"Eastern Europe",3533322,3514225,19097,2476240,4127067,"POL",3301654
1,277.0,"Central Asia",1121413,1062582,58831,803691,1339485,"UZB",1071588
1,277.0,"Southern Europe",774990,0,774990,538967,898278,"ITA",718623
1,277.0,"Central America",294007,0,294007,224685,374475,"MEX",299580
1,277.0,"Southern Asia",504206,0,504206,556406,927343,"IRN",741875
1,277.0,"Western Asia",902679,0,902679,587595,979326,"IRQ",783461
1,277.0,"Eastern Asia",898123,0,898123,669243,1115406,"JPN",892325
1,277.0,"Southern Africa",54233,0,54233,40623,67705,"ZAF",54164
1,277.0,"South-Eastern Asia",600241,0,600241,529865,883108,"IDN",706487
1,277.0,"Caribbean",169547,0,169547,136670,227783,"CUB",182227
1,278.0,"Pakistan",1729350,1490271,239079,1281667,2136112,"PAK",1708890
1,278.0,"India",5832155,5534348,297807,4391330,7318883,"IND",5855107
1,278.0,"Western Europe",3591635,3583207,8428,2591498,4319163,"NLD",3455331
1,278.0,"China",9617344,9289396,327948,7150712,11917853,"CPR",9534283
1,278.0,"United States of America",3072443,3070435,2008,2203431,3672386,"USA",2937909
1,278.0,"Northern Africa",1166187,0,1166187,871569,1452616,"EGY",1162093
1,278.0,"Russian Federation",3122962,3030290,92672,2225547,3709246,"RUS",2967397
1,278.0,"Western Africa",303096,0,303096,204022,340037,"NGA",272030
1,278.0,"South America",1824373,1708190,116183,1355298,2258830,"BRA",1807064
1,278.0,"Northern Europe",1786334,1774209,12125,1481035,2468392,"GBR",1974714
1,278.0,"Northern America",721754,711218,10536,526026,876711,"CAN",701369
1,278.0,"Oceania",450070,448991,1079,334125,556875,"NZL",445500
1,278.0,"Eastern Africa",200601,0,200601,145667,242778,"ETH",194223
1,278.0,"Middle Africa",72689,0,72689,53047,88412,"AGO",70730
1,278.0,"Eastern Europe",3629069,3605346,23723,2476240,4127067,"POL",3301654
1,278.0,"Central Asia",955246,936715,18531,803691,1339485,"UZB",1071588
1,278.0,"Southern Europe",789490,0,789490,538967,898278,"ITA",718623
1,278.0,"Central America",298335,0,298335,224685,374475,"MEX",299580
1,278.0,"Southern Asia",531162,0,531162,556406,927343,"IRN",741875
1,278.0,"Western Asia",931127,0,931127,587595,979326,"IRQ",783461
1,278.0,"Eastern Asia",926692,0,926692,669243,1115406,"JPN",892325
1,278.0,"Southern Africa",56980,0,56980,40623,67705,"ZAF",54164
1,278.0,"South-Eastern Asia",638502,0,638502,529865,883108,"IDN",706487
1,278.0,"Caribbean",172002,0,172002,136670,227783,"CUB",182227
1,279.0,"Pakistan",1695479,1482893,212586,1281667,2136112,"PAK",1708890
1,279.0,"India",5850896,5524490,326406,4391330,7318883,"IND",5855107
1,279.0,"Western Europe",3567121,3555526,11595,2591498,4319163,"NLD",3455331
1,279.0,"China",9685574,9304483,381091,7150712,11917853,"CPR",9534283
1,279.0,"United States of America",3130557,3122746,7811,2203431,3672386,"USA",2937909
1,279.0,"Northern Africa",1191867,0,1191867,871569,1452616,"EGY",1162093
1,279.0,"Russian Federation",3130935,3025504,105431,2225547,3709246,"RUS",2967397
1,279.0,"Western Africa",272019,0,272019,204022,340037,"NGA",272030
1,279.0,"South America",1828856,1705882,122974,1355298,2258830,"BRA",1807064
1,279.0,"Northern Europe",2001366,1958558,42808,1481035,2468392,"GBR",1974714
1,279.0,"Northern America",624075,620527,3548,526026,876711,"CAN",701369
1,279.0,"Oceania",396872,396605,267,334125,556875,"NZL",445500
1,279.0,"Eastern Africa",179679,0,179679,145667,242778,"ETH",194223
1,279.0,"Middle Africa",66579,0,66579,53047,88412,"AGO",70730
1,279.0,"Eastern Europe",3486952,3470869,16083,2476240,4127067,"POL",3301654
1,279.0,"Central Asia",1130898,1057705,73193,803691,1339485,"UZB",1071588
1,279.0,"Southern Europe",724972,0,724972,538967,898278,"ITA",718623
1,279.0,"Central America",301003,0,301003,224685,374475,"MEX",299580
1,279.0,"Southern Asia",627216,0,627216,556406,927343,"IRN",741875
1,279.0,"Western Asia",806924,0,806924,587595,979326,"IRQ",783461
1,279.0,"Eastern Asia",891174,0,891174,669243,1115406,"JPN",892325
1,279.0,"Southern Africa",50806,0,50806,40623,67705,"ZAF",54164
1,279.0,"South-Eastern Asia",623730,0,623730,529865,883108,"IDN",706487
1,279.0,"Caribbean",180260,0,180260,136670,227783,"CUB",182227
1,280.0,"Pakistan",1675666,1483378,192288,1281667,2136112,"PAK",1708890
1,280.0,"India",5873233,5525661,347572,4391330,7318883,"IND",5855107
1,280.0,"Western Europe",3528508,3519237,9271,2591498,4319163,"NLD",3455331
1,280.0,"China",9741270,9305640,435630,7150712,11917853,"CPR",9534283
1,280.0,"United States of America",2970975,2968335,2640,2203431,3672386,"USA",2937909
1,280.0,"Northern Africa",1174971,0,1174971,871569,1452616,"EGY",1162093
1,280.0,"Russian Federation",3097072,3010376,86696,2225547,3709246,"RUS",2967397
1,280.0,"Western Africa",274559,0,274559,204022,340037,"NGA",272030
1,280.0,"South America",1820235,1704153,116082,1355298,2258830,"BRA",1807064
1,280.0,"Northern Europe",1995000,1951970,43030,1481035,2468392,"GBR",1974714
1,280.0,"Northern America",788017,746850,41167,526026,876711,"CAN",701369
1,280.0,"Oceania",435708,418744,16964,334125,556875,"NZL",445500
1,280.0,"Eastern Africa",191999,0,191999,145667,242778,"ETH",194223
1,280.0,"Middle Africa",70172,0,70172,53047,88412,"AGO",70730
1,280.0,"Eastern Europe",3152336,3146606,5730,2476240,4127067,"POL",3301654
1,280.0,"Central Asia",1111298,1056218,55080,803691,1339485,"UZB",1071588
1,280.0,"Southern Europe",760954,0,760954,538967,898278,"ITA",718623
1,280.0,"Central America",307719,0,307719,224685,374475,"MEX",299580
1,280.0,"Southern Asia",764626,0,764626,556406,927343,"IRN",741875
1,280.0,"Western Asia",831910,0,831910,587595,979326,"IRQ",783461
1,280.0,"Eastern Asia",924420,0,924420,669243,1115406,"JPN",892325
1,280.0,"Southern Africa",53788,0,53788,40623,67705,"ZAF",54164
1,280.0,"South-Eastern Asia",690090,0,690090,529865,883108,"IDN",706487
1,280.0,"Caribbean",185770,0,185770,136670,227783,"CUB",182227
1,281.0,"Pakistan",1714666,1482712,231954,1281667,2136112,"PAK",1708890
1,281.0,"India",6098719,5700655,398064,4391330,7318883,"IND",5855107
1,281.0,"Western Europe",3458935,3450948,7987,2591498,4319163,"NLD",3455331
1,281.0,"China",9780409,9304510,475899,7150712,11917853,"CPR",9534283
1,281.0,"United States of America",2955614,2949885,5729,2203431,3672386,"USA",2937909
1,281.0,"Northern Africa",1164204,0,1164204,871569,1452616,"EGY",1162093
1,281.0,"Russian Federation",3063529,2987011,76518,2225547,3709246,"RUS",2967397
1,281.0,"Western Africa",286938,0,286938,204022,340037,"NGA",272030
1,281.0,"South America",1821365,1701808,119557,1355298,2258830,"BRA",1807064
1,281.0,"Northern Europe",1997861,1952591,45270,1481035,2468392,"GBR",1974714
1,281.0,"Northern America",679395,667560,11835,526026,876711,"CAN",701369
1,281.0,"Oceania",495551,466809,28742,334125,556875,"NZL",445500
1,281.0,"Eastern Africa",211722,0,211722,145667,242778,"ETH",194223
1,281.0,"Middle Africa",76111,0,76111,53047,88412,"AGO",70730
1,281.0,"Eastern Europe",3380076,3349502,30574,2476240,4127067,"POL",3301654
1,281.0,"Central Asia",955466,931832,23634,803691,1339485,"UZB",1071588
1,281.0,"Southern Europe",716742,0,716742,538967,898278,"ITA",718623
1,281.0,"Central America",301523,0,301523,224685,374475,"MEX",299580
1,281.0,"Southern Asia",740202,0,740202,556406,927343,"IRN",741875
1,281.0,"Western Asia",781277,0,781277,587595,979326,"IRQ",783461
1,281.0,"Eastern Asia",897299,0,897299,669243,1115406,"JPN",892325
1,281.0,"Southern Africa",58939,0,58939,40623,67705,"ZAF",54164
1,281.0,"South-Eastern Asia",769711,0,769711,529865,883108,"IDN",706487
1,281.0,"Caribbean",183452,0,183452,136670,227783,"CUB",182227
1,282.0,"Pakistan",1718533,1452958,265575,1281667,2136112,"PAK",1708890
1,282.0,"India",6083105,5688376,394729,4391330,7318883,"IND",5855107
1,282.0,"Western Europe",3456294,3445514,10780,2591498,4319163,"NLD",3455331
1,282.0,"China",9786359,9285471,500888,7150712,11917853,"CPR",9534283
1,282.0,"United States of America",2966658,2962810,3848,2203431,3672386,"USA",2937909
1,282.0,"Northern Africa",1167373,0,1167373,871569,1452616,"EGY",1162093
1,282.0,"Russian Federation",2853306,2827737,25569,2225547,3709246,"RUS",2967397
1,282.0,"Western Africa",271585,0,271585,204022,340037,"NGA",272030
1,282.0,"South America",1844928,1713463,131465,1355298,2258830,"BRA",1807064
1,282.0,"Northern Europe",2082653,2032285,50368,1481035,2468392,"GBR",1974714
1,282.0,"Northern America",662051,656142,5909,526026,876711,"CAN",701369
1,282.0,"Oceania",432459,424469,7990,334125,556875,"NZL",445500
1,282.0,"Eastern Africa",190531,0,190531,145667,242778,"ETH",194223
1,282.0,"Middle Africa",69941,0,69941,53047,88412,"AGO",70730
1,282.0,"Eastern Europe",3469654,3433898,35756,2476240,4127067,"POL",3301654
1,282.0,"Central Asia",1165013,1059661,105352,803691,1339485,"UZB",1071588
1,282.0,"Southern Europe",710070,0,710070,538967,898278,"ITA",718623
1,282.0,"Central America",299428,0,299428,224685,374475,"MEX",299580
1,282.0,"Southern Asia",722923,0,722923,556406,927343,"IRN",741875
1,282.0,"Western Asia",779251,0,779251,587595,979326,"IRQ",783461
1,282.0,"Eastern Asia",886342,0,886342,669243,1115406,"JPN",892325
1,282.0,"Southern Africa",53187,0,53187,40623,67705,"ZAF",54164
1,282.0,"South-Eastern Asia",690657,0,690657,529865,883108,"IDN",706487
1,282.0,"Caribbean",182204,0,182204,136670,227783,"CUB",182227
1,283.0,"Pakistan",1767761,1463936,303825,1281667,2136112,"PAK",1708890
1,283.0,"India",6034596,5683978,350618,4391330,7318883,"IND",5855107
1,283.0,"Western Europe",3502536,3491126,11410,2591498,4319163,"NLD",3455331
1,283.0,"China",9808915,9284887,524028,7150712,11917853,"CPR",9534283
1,283.0,"United States of America",2930773,2929590,1183,2203431,3672386,"USA",2937909
1,283.0,"Northern Africa",1176103,0,1176103,871569,1452616,"EGY",1162093
1,283.0,"Russian Federation",2954677,2909913,44764,2225547,3709246,"RUS",2967397
1,283.0,"Western Africa",267480,0,267480,204022,340037,"NGA",272030
1,283.0,"South America",1823578,1717383,106195,1355298,2258830,"BRA",1807064
1,283.0,"Northern Europe",1861048,1846039,15009,1481035,2468392,"GBR",1974714
1,283.0,"Northern America",759340,732207,27133,526026,876711,"CAN",701369
1,283.0,"Oceania",430114,427579,2535,334125,556875,"NZL",445500
1,283.0,"Eastern Africa",189494,0,189494,145667,242778,"ETH",194223
1,283.0,"Middle Africa",69029,0,69029,53047,88412,"AGO",70730
1,283.0,"Eastern Europe",3236992,3225450,11542,2476240,4127067,"POL",3301654
1,283.0,"Central Asia",1127911,1057111,70800,803691,1339485,"UZB",1071588
1,283.0,"Southern Europe",740472,0,740472,538967,898278,"ITA",718623
1,283.0,"Central America",299943,0,299943,224685,374475,"MEX",299580
1,283.0,"Southern Asia",764952,0,764952,556406,927343,"IRN",741875
1,283.0,"Western Asia",804566,0,804566,587595,979326,"IRQ",783461
1,283.0,"Eastern Asia",902079,0,902079,669243,1115406,"JPN",892325
1,283.0,"Southern Africa",52740,0,52740,40623,67705,"ZAF",54164
1,283.0,"South-Eastern Asia",688088,0,688088,529865,883108,"IDN",706487
1,283.0,"Caribbean",182262,0,182262,136670,227783,"CUB",182227
1,284.0,"Pakistan",1760786,1463886,296900,1281667,2136112,"PAK",1708890
1,284.0,"India",5928477,5681122,247355,4391330,7318883,"IND",5855107
1,284.0,"Western Europe",3608261,3600678,7583,2591498,4319163,"NLD",3455331
1,284.0,"China",9853747,9341268,512479,7150712,11917853,"CPR",9534283
1,284.0,"United States of America",2881293,2877945,3348,2203431,3672386,"USA",2937909
1,284.0,"Northern Africa",1183202,0,1183202,871569,1452616,"EGY",1162093
1,284.0,"Russian Federation",2567251,2511154,56097,2225547,3709246,"RUS",2967397
1,284.0,"Western Africa",279547,0,279547,204022,340037,"NGA",272030
1,284.0,"South America",1820461,1719406,101055,1355298,2258830,"BRA",1807064
1,284.0,"Northern Europe",2093076,2052519,40557,1481035,2468392,"GBR",1974714
1,284.0,"Northern America",690881,682931,7950,526026,876711,"CAN",701369
1,284.0,"Oceania",471336,464197,7139,334125,556875,"NZL",445500
1,284.0,"Eastern Africa",202533,0,202533,145667,242778,"ETH",194223
1,284.0,"Middle Africa",73703,0,73703,53047,88412,"AGO",70730
1,284.0,"Eastern Europe",3299438,3283413,16025,2476240,4127067,"POL",3301654
1,284.0,"Central Asia",924125,898446,25679,803691,1339485,"UZB",1071588
1,284.0,"Southern Europe",715752,0,715752,538967,898278,"ITA",718623
1,284.0,"Central America",297945,0,297945,224685,374475,"MEX",299580
1,284.0,"Southern Asia",738099,0,738099,556406,927343,"IRN",741875
1,284.0,"Western Asia",775042,0,775042,587595,979326,"IRQ",783461
1,284.0,"Eastern Asia",881271,0,881271,669243,1115406,"JPN",892325
1,284.0,"Southern Africa",56783,0,56783,40623,67705,"ZAF",54164
1,284.0,"South-Eastern Asia",735940,0,735940,529865,883108,"IDN",706487
1,284.0,"Caribbean",181321,0,181321,136670,227783,"CUB",182227
1,285.0,"Pakistan",1710079,1453195,256884,1281667,2136112,"PAK",1708890
1,285.0,"India",5828171,5650653,177518,4391330,7318883,"IND",5855107
1,285.0,"Western Europe",3308240,3306160,2080,2591498,4319163,"NLD",3455331
1,285.0,"China",9709219,9324670,384549,7150712,11917853,"CPR",9534283
1,285.0,"United States of America",3062331,3048932,13399,2203431,3672386,"USA",2937909
1,285.0,"Northern Africa",1145744,0,1145744,871569,1452616,"EGY",1162093
1,285.0,"Russian Federation",2767603,2553157,214446,2225547,3709246,"RUS",2967397
1,285.0,"Western Africa",271969,0,271969,204022,340037,"NGA",272030
1,285.0,"South America",1778514,1724150,54364,1355298,2258830,"BRA",1807064
1,285.0,"Northern Europe",1925166,1904854,20312,1481035,2468392,"GBR",1974714
1,285.0,"Northern America",685451,679226,6225,526026,876711,"CAN",701369
1,285.0,"Oceania",438868,436771,2097,334125,556875,"NZL",445500
1,285.0,"Eastern Africa",191997,0,191997,145667,242778,"ETH",194223
1,285.0,"Middle Africa",70060,0,70060,53047,88412,"AGO",70730
1,285.0,"Eastern Europe",3291985,3268882,23103,2476240,4127067,"POL",3301654
1,285.0,"Central Asia",1149082,1040236,108846,803691,1339485,"UZB",1071588
1,285.0,"Southern Europe",716062,0,716062,538967,898278,"ITA",718623
1,285.0,"Central America",306801,0,306801,224685,374475,"MEX",299580
1,285.0,"Southern Asia",739073,0,739073,556406,927343,"IRN",741875
1,285.0,"Western Asia",787574,0,787574,587595,979326,"IRQ",783461
1,285.0,"Eastern Asia",914219,0,914219,669243,1115406,"JPN",892325
1,285.0,"Southern Africa",53577,0,53577,40623,67705,"ZAF",54164
1,285.0,"South-Eastern Asia",701906,0,701906,529865,883108,"IDN",706487
1,285.0,"Caribbean",186674,0,186674,136670,227783,"CUB",182227
1,286.0,"Pakistan",1620062,1451829,168233,1281667,2136112,"PAK",1708890
1,286.0,"India",5767530,5651233,116297,4391330,7318883,"IND",5855107
1,286.0,"Western Europe",3603955,3596243,7712,2591498,4319163,"NLD",3455331
1,286.0,"China",9562778,9284495,278283,7150712,11917853,"CPR",9534283
1,286.0,"United States of America",2941778,2937785,3993,2203431,3672386,"USA",2937909
1,286.0,"Northern Africa",1193737,0,1193737,871569,1452616,"EGY",1162093
1,286.0,"Russian Federation",2953520,2571718,381802,2225547,3709246,"RUS",2967397
1,286.0,"Western Africa",262971,0,262971,204022,340037,"NGA",272030
1,286.0,"South America",1789147,1723836,65311,1355298,2258830,"BRA",1807064
1,286.0,"Northern Europe",1986180,1969243,16937,1481035,2468392,"GBR",1974714
1,286.0,"Northern America",696739,689402,7337,526026,876711,"CAN",701369
1,286.0,"Oceania",406330,404850,1480,334125,556875,"NZL",445500
1,286.0,"Eastern Africa",182704,0,182704,145667,242778,"ETH",194223
1,286.0,"Middle Africa",66884,0,66884,53047,88412,"AGO",70730
1,286.0,"Eastern Europe",3289961,3276313,13648,2476240,4127067,"POL",3301654
1,286.0,"Central Asia",1161797,1061523,100274,803691,1339485,"UZB",1071588
1,286.0,"Southern Europe",728675,0,728675,538967,898278,"ITA",718623
1,286.0,"Central America",298845,0,298845,224685,374475,"MEX",299580
1,286.0,"Southern Asia",728712,0,728712,556406,927343,"IRN",741875
1,286.0,"Western Asia",787735,0,787735,587595,979326,"IRQ",783461
1,286.0,"Eastern Asia",888435,0,888435,669243,1115406,"JPN",892325
1,286.0,"Southern Africa",50377,0,50377,40623,67705,"ZAF",54164
1,286.0,"South-Eastern Asia",653353,0,653353,529865,883108,"IDN",706487
1,286.0,"Caribbean",181705,0,181705,136670,227783,"CUB",182227
1,287.0,"Pakistan",1669424,1451884,217540,1281667,2136112,"PAK",1708890
1,287.0,"India",5763701,5633942,129759,4391330,7318883,"IND",5855107
1,287.0,"Western Europe",3360946,3358865,2081,2591498,4319163,"NLD",3455331
1,287.0,"China",9496912,9242130,254782,7150712,11917853,"CPR",9534283
1,287.0,"United States of America",2885404,2883036,2368,2203431,3672386,"USA",2937909
1,287.0,"Northern Africa",1142509,0,1142509,871569,1452616,"EGY",1162093
1,287.0,"Russian Federation",3102817,2581197,521620,2225547,3709246,"RUS",2967397
1,287.0,"Western Africa",278882,0,278882,204022,340037,"NGA",272030
1,287.0,"South America",1801449,1719023,82426,1355298,2258830,"BRA",1807064
1,287.0,"Northern Europe",1988268,1966493,21775,1481035,2468392,"GBR",1974714
1,287.0,"Northern America",720162,705475,14687,526026,876711,"CAN",701369
1,287.0,"Oceania",475912,440672,35240,334125,556875,"NZL",445500
1,287.0,"Eastern Africa",203857,0,203857,145667,242778,"ETH",194223
1,287.0,"Middle Africa",73810,0,73810,53047,88412,"AGO",70730
1,287.0,"Eastern Europe",3315913,3292682,23231,2476240,4127067,"POL",3301654
1,287.0,"Central Asia",1077228,1048663,28565,803691,1339485,"UZB",1071588
1,287.0,"Southern Europe",717888,0,717888,538967,898278,"ITA",718623
1,287.0,"Central America",297947,0,297947,224685,374475,"MEX",299580
1,287.0,"Southern Asia",762658,0,762658,556406,927343,"IRN",741875
1,287.0,"Western Asia",786464,0,786464,587595,979326,"IRQ",783461
1,287.0,"Eastern Asia",891734,0,891734,669243,1115406,"JPN",892325
1,287.0,"Southern Africa",57233,0,57233,40623,67705,"ZAF",54164
1,287.0,"South-Eastern Asia",751917,0,751917,529865,883108,"IDN",706487
1,287.0,"Caribbean",181267,0,181267,136670,227783,"CUB",182227
1,288.0,"Pakistan",1735111,1454636,280475,1281675,2136126,"PAK",1708901
1,288.0,"India",5777341,5621113,156228,4391337,7318896,"IND",5855117
1,288.0,"Western Europe",3418011,3415885,2126,2591509,4319182,"NLD",3455346
1,288.0,"China",9469006,9209246,259760,7150722,11917870,"CPR",9534296
1,288.0,"United States of America",2968862,2967130,1732,2203439,3672398,"USA",2937919
1,288.0,"Northern Africa",1152257,0,1152257,871574,1452623,"EGY",1162099
1,288.0,"Russian Federation",3192429,2586911,605518,2225552,3709253,"RUS",2967403
1,288.0,"Western Africa",272511,0,272511,204026,340043,"NGA",272035
1,288.0,"South America",1814806,1717421,97385,1355311,2258852,"BRA",1807082
1,288.0,"Northern Europe",1863153,1854491,8662,1481042,2468403,"GBR",1974723
1,288.0,"Northern America",668419,664216,4203,526035,876725,"CAN",701380
1,288.0,"Oceania",452164,442334,9830,334135,556892,"NZL",445514
1,288.0,"Eastern Africa",194153,0,194153,145660,242767,"ETH",194214
1,288.0,"Middle Africa",70862,0,70862,53054,88423,"AGO",70739
1,288.0,"Eastern Europe",3327575,3300517,27058,2476253,4127088,"POL",3301671
1,288.0,"Central Asia",1009247,1000846,8401,803694,1339491,"UZB",1071593
1,288.0,"Southern Europe",703409,0,703409,538970,898283,"ITA",718627
1,288.0,"Central America",299595,0,299595,224679,374466,"MEX",299573
1,288.0,"Southern Asia",725573,0,725573,556403,927338,"IRN",741871
1,288.0,"Western Asia",771546,0,771546,587598,979330,"IRQ",783464
1,288.0,"Eastern Asia",891636,0,891636,669252,1115420,"JPN",892336
1,288.0,"Southern Africa",54724,0,54724,40626,67710,"ZAF",54168
1,288.0,"South-Eastern Asia",713708,0,713708,529874,883123,"IDN",706499
1,288.0,"Caribbean",182290,0,182290,136671,227786,"CUB",182229
1,289.0,"Pakistan",1754895,1454249,300646,1287834,2146390,"PAK",1717112
1,289.0,"India",5796519,5619385,177134,4382950,7304917,"IND",5843934
1,289.0,"Western Europe",3416423,3414066,2357,2828631,4714385,"NLD",3771508
1,289.0,"China",9409147,9189520,219627,7048677,11747795,"CPR",9398236
1,289.0,"United States of America",2823455,2822898,557,2173072,3621787,"USA",2897430
1,289.0,"Northern Africa",1146884,0,1146884,1046895,1744826,"EGY",1395861
1,289.0,"Russian Federation",3197806,2583651,614155,2319819,3866366,"RUS",3093093
1,289.0,"Western Africa",270145,0,270145,227234,378723,"NGA",302979
1,289.0,"South America",1619092,1527442,91650,1376343,2293905,"BRA",1835124
1,289.0,"Northern Europe",2003063,1968657,34406,1503791,2506318,"GBR",2005055
1,289.0,"Northern America",726295,712131,14164,468813,781355,"CAN",625084
1,289.0,"Oceania",447512,444639,2873,338422,564037,"NZL",451230
1,289.0,"Eastern Africa",196300,0,196300,177340,295567,"ETH",236454
1,289.0,"Middle Africa",71186,0,71186,60122,100203,"AGO",80163
1,289.0,"Eastern Europe",3300414,3276378,24036,2333488,3889147,"POL",3111318
1,289.0,"Central Asia",1117725,1093691,24034,836585,1394308,"UZB",1115447
1,289.0,"Southern Europe",719257,0,719257,460668,767780,"ITA",614224
1,289.0,"Central America",292330,0,292330,206094,343491,"MEX",274793
1,289.0,"Southern Asia",754447,0,754447,607750,1012917,"IRN",810334
1,289.0,"Western Asia",783822,0,783822,661547,1102578,"IRQ",882063
1,289.0,"Eastern Asia",874031,0,874031,616705,1027842,"JPN",822274
1,289.0,"Southern Africa",54444,0,54444,45447,75745,"ZAF",60596
1,289.0,"South-Eastern Asia",709728,0,709728,607362,1012270,"IDN",809816
1,289.0,"Caribbean",177781,0,177781,134145,223576,"CUB",178861
1,290.0,"Pakistan",1704607,1459140,245467,1287834,2146390,"PAK",1717112
1,290.0,"India",5868431,5661507,206924,4382950,7304917,"IND",5843934
1,290.0,"Western Europe",3397124,3393250,3874,2828631,4714385,"NLD",3771508
1,290.0,"China",9518696,9283766,234930,7048677,11747795,"CPR",9398236
1,290.0,"United States of America",2997080,2993294,3786,2173072,3621787,"USA",2897430
1,290.0,"Northern Africa",1151977,0,1151977,1046895,1744826,"EGY",1395861
1,290.0,"Russian Federation",2963017,2575012,388005,2319819,3866366,"RUS",3093093
1,290.0,"Western Africa",271075,0,271075,227234,378723,"NGA",302979
1,290.0,"South America",1731860,1536110,195750,1376343,2293905,"BRA",1835124
1,290.0,"Northern Europe",1994067,1963197,30870,1503791,2506318,"GBR",2005055
1,290.0,"Northern America",690447,686118,4329,468813,781355,"CAN",625084
1,290.0,"Oceania",441186,440611,575,338422,564037,"NZL",451230
1,290.0,"Eastern Africa",191311,0,191311,177340,295567,"ETH",236454
1,290.0,"Middle Africa",69798,0,69798,60122,100203,"AGO",80163
1,290.0,"Eastern Europe",3266046,3255286,10760,2333488,3889147,"POL",3111318
1,290.0,"Central Asia",1011524,1004609,6915,836585,1394308,"UZB",1115447
1,290.0,"Southern Europe",714711,0,714711,460668,767780,"ITA",614224
1,290.0,"Central America",303767,0,303767,206094,343491,"MEX",274793
1,290.0,"Southern Asia",734270,0,734270,607750,1012917,"IRN",810334
1,290.0,"Western Asia",780115,0,780115,661547,1102578,"IRQ",882063
1,290.0,"Eastern Asia",901750,0,901750,616705,1027842,"JPN",822274
1,290.0,"Southern Africa",53586,0,53586,45447,75745,"ZAF",60596
1,290.0,"South-Eastern Asia",701180,0,701180,607362,1012270,"IDN",809816
1,290.0,"Caribbean",184655,0,184655,134145,223576,"CUB",178861
1,291.0,"Pakistan",1710194,1462166,248028,1287834,2146390,"PAK",1717112
1,291.0,"India",5898598,5676823,221775,4382950,7304917,"IND",5843934
1,291.0,"Western Europe",3563937,3555023,8914,2828631,4714385,"NLD",3771508
1,291.0,"China",9486483,9251007,235476,7048677,11747795,"CPR",9398236
1,291.0,"United States of America",2926451,2925330,1121,2173072,3621787,"USA",2897430
1,291.0,"Northern Africa",1297050,0,1297050,1046895,1744826,"EGY",1395861
1,291.0,"Russian Federation",2948924,2574190,374734,2319819,3866366,"RUS",3093093
1,291.0,"Western Africa",282040,0,282040,227234,378723,"NGA",302979
1,291.0,"South America",1836764,1539721,297043,1376343,2293905,"BRA",1835124
1,291.0,"Northern Europe",1969224,1951808,17416,1503791,2506318,"GBR",2005055
1,291.0,"Northern America",651569,647376,4193,468813,781355,"CAN",625084
1,291.0,"Oceania",396014,396014,0,338422,564037,"NZL",451230
1,291.0,"Eastern Africa",204261,0,204261,177340,295567,"ETH",236454
1,291.0,"Middle Africa",70863,0,70863,60122,100203,"AGO",80163
1,291.0,"Eastern Europe",3184752,3175947,8805,2333488,3889147,"POL",3111318
1,291.0,"Central Asia",1125828,1100679,25149,836585,1394308,"UZB",1115447
1,291.0,"Southern Europe",644811,0,644811,460668,767780,"ITA",614224
1,291.0,"Central America",283834,0,283834,206094,343491,"MEX",274793
1,291.0,"Southern Asia",769561,0,769561,607750,1012917,"IRN",810334
1,291.0,"Western Asia",841597,0,841597,661547,1102578,"IRQ",882063
1,291.0,"Eastern Asia",835397,0,835397,616705,1027842,"JPN",822274
1,291.0,"Southern Africa",52652,0,52652,45447,75745,"ZAF",60596
1,291.0,"South-Eastern Asia",697051,0,697051,607362,1012270,"IDN",809816
1,291.0,"Caribbean",180936,0,180936,134145,223576,"CUB",178861
1,292.0,"Pakistan",1660014,1461522,198492,1287834,2146390,"PAK",1717112
1,292.0,"India",5841975,5659749,182226,4382950,7304917,"IND",5843934
1,292.0,"Western Europe",3723091,3700470,22621,2828631,4714385,"NLD",3771508
1,292.0,"China",9396934,9205629,191305,7048677,11747795,"CPR",9398236
1,292.0,"United States of America",2744479,2744269,210,2173072,3621787,"USA",2897430
1,292.0,"Northern Africa",1353830,0,1353830,1046895,1744826,"EGY",1395861
1,292.0,"Russian Federation",2977877,2576693,401184,2319819,3866366,"RUS",3093093
1,292.0,"Western Africa",302165,0,302165,227234,378723,"NGA",302979
1,292.0,"South America",1894131,1544915,349216,1376343,2293905,"BRA",1835124
1,292.0,"Northern Europe",1971138,1948728,22410,1503791,2506318,"GBR",2005055
1,292.0,"Northern America",612554,608954,3600,468813,781355,"CAN",625084
1,292.0,"Oceania",495412,462003,33409,338422,564037,"NZL",451230
1,292.0,"Eastern Africa",248731,0,248731,177340,295567,"ETH",236454
1,292.0,"Middle Africa",84348,0,84348,60122,100203,"AGO",80163
1,292.0,"Eastern Europe",3024034,3016440,7594,2333488,3889147,"POL",3111318
1,292.0,"Central Asia",1085753,1067270,18483,836585,1394308,"UZB",1115447
1,292.0,"Southern Europe",605382,0,605382,460668,767780,"ITA",614224
1,292.0,"Central America",263053,0,263053,206094,343491,"MEX",274793
1,292.0,"Southern Asia",802763,0,802763,607750,1012917,"IRN",810334
1,292.0,"Western Asia",854813,0,854813,661547,1102578,"IRQ",882063
1,292.0,"Eastern Asia",801693,0,801693,616705,1027842,"JPN",822274
1,292.0,"Southern Africa",64911,0,64911,45447,75745,"ZAF",60596
1,292.0,"South-Eastern Asia",866260,0,866260,607362,1012270,"IDN",809816
1,292.0,"Caribbean",170296,0,170296,134145,223576,"CUB",178861
1,293.0,"Pakistan",1694271,1462747,231524,1287834,2146390,"PAK",1717112
1,293.0,"India",6227162,6099188,127974,4382950,7304917,"IND",5843934
1,293.0,"Western Europe",3724066,3711253,12813,2828631,4714385,"NLD",3771508
1,293.0,"China",9267253,9196680,70573,7048677,11747795,"CPR",9398236
1,293.0,"United States of America",3014025,3010603,3422,2173072,3621787,"USA",2897430
1,293.0,"Northern Africa",1372851,0,1372851,1046895,1744826,"EGY",1395861
1,293.0,"Russian Federation",3042628,2585269,457359,2319819,3866366,"RUS",3093093
1,293.0,"Western Africa",297468,0,297468,227234,378723,"NGA",302979
1,293.0,"South America",1903989,1541932,362057,1376343,2293905,"BRA",1835124
1,293.0,"Northern Europe",1965842,1950993,14849,1503791,2506318,"GBR",2005055
1,293.0,"Northern America",583899,581147,2752,468813,781355,"CAN",625084
1,293.0,"Oceania",424004,413759,10245,338422,564037,"NZL",451230
1,293.0,"Eastern Africa",221858,0,221858,177340,295567,"ETH",236454
1,293.0,"Middle Africa",75740,0,75740,60122,100203,"AGO",80163
1,293.0,"Eastern Europe",3022484,3015631,6853,2333488,3889147,"POL",3111318
1,293.0,"Central Asia",1023240,1013807,9433,836585,1394308,"UZB",1115447
1,293.0,"Southern Europe",604805,0,604805,460668,767780,"ITA",614224
1,293.0,"Central America",281994,0,281994,206094,343491,"MEX",274793
1,293.0,"Southern Asia",764694,0,764694,607750,1012917,"IRN",810334
1,293.0,"Western Asia",854456,0,854456,661547,1102578,"IRQ",882063
1,293.0,"Eastern Asia",829220,0,829220,616705,1027842,"JPN",822274
1,293.0,"Southern Africa",56887,0,56887,45447,75745,"ZAF",60596
1,293.0,"South-Eastern Asia",762173,0,762173,607362,1012270,"IDN",809816
1,293.0,"Caribbean",182964,0,182964,134145,223576,"CUB",178861
1,294.0,"Pakistan",1844918,1603789,241129,1287834,2146390,"PAK",1717112
1,294.0,"India",5789918,5748005,41913,4382950,7304917,"IND",5843934
1,294.0,"Western Europe",3725074,3703460,21614,2828631,4714385,"NLD",3771508
1,294.0,"China",9250231,9197747,52484,7048677,11747795,"CPR",9398236
1,294.0,"United States of America",2892830,2891644,1186,2173072,3621787,"USA",2897430
1,294.0,"Northern Africa",1391740,0,1391740,1046895,1744826,"EGY",1395861
1,294.0,"Russian Federation",3095722,2584118,511604,2319819,3866366,"RUS",3093093
1,294.0,"Western Africa",302720,0,302720,227234,378723,"NGA",302979
1,294.0,"South America",1812652,1545094,267558,1376343,2293905,"BRA",1835124
1,294.0,"Northern Europe",1981721,1956309,25412,1503791,2506318,"GBR",2005055
1,294.0,"Northern America",665039,631023,34016,468813,781355,"CAN",625084
1,294.0,"Oceania",442868,419419,23449,338422,564037,"NZL",451230
1,294.0,"Eastern Africa",234536,0,234536,177340,295567,"ETH",236454
1,294.0,"Middle Africa",79470,0,79470,60122,100203,"AGO",80163
1,294.0,"Eastern Europe",3090734,3067382,23352,2333488,3889147,"POL",3111318
1,294.0,"Central Asia",1189610,1115140,74470,836585,1394308,"UZB",1115447
1,294.0,"Southern Europe",629908,0,629908,460668,767780,"ITA",614224
1,294.0,"Central America",276238,0,276238,206094,343491,"MEX",274793
1,294.0,"Southern Asia",832475,0,832475,607750,1012917,"IRN",810334
1,294.0,"Western Asia",898263,0,898263,661547,1102578,"IRQ",882063
1,294.0,"Eastern Asia",833747,0,833747,616705,1027842,"JPN",822274
1,294.0,"Southern Africa",59867,0,59867,45447,75745,"ZAF",60596
1,294.0,"South-Eastern Asia",797442,0,797442,607362,1012270,"IDN",809816
1,294.0,"Caribbean",180333,0,180333,134145,223576,"CUB",178861
1,295.0,"Pakistan",1679998,1557355,122643,1287834,2146390,"PAK",1717112
1,295.0,"India",5748755,5734270,14485,4382950,7304917,"IND",5843934
1,295.0,"Western Europe",3840872,3804763,36109,2828631,4714385,"NLD",3771508
1,295.0,"China",9295478,9234788,60690,7048677,11747795,"CPR",9398236
1,295.0,"United States of America",2919370,2918961,409,2173072,3621787,"USA",2897430
1,295.0,"Northern Africa",1420534,0,1420534,1046895,1744826,"EGY",1395861
1,295.0,"Russian Federation",3149223,2583291,565932,2319819,3866366,"RUS",3093093
1,295.0,"Western Africa",310744,0,310744,227234,378723,"NGA",302979
1,295.0,"South America",1831257,1543252,288005,1376343,2293905,"BRA",1835124
1,295.0,"Northern Europe",2031442,1989745,41697,1503791,2506318,"GBR",2005055
1,295.0,"Northern America",642639,632375,10264,468813,781355,"CAN",625084
1,295.0,"Oceania",478360,441450,36910,338422,564037,"NZL",451230
1,295.0,"Eastern Africa",247555,0,247555,177340,295567,"ETH",236454
1,295.0,"Middle Africa",83816,0,83816,60122,100203,"AGO",80163
1,295.0,"Eastern Europe",3174675,3137578,37097,2333488,3889147,"POL",3111318
1,295.0,"Central Asia",1088321,1050111,38210,836585,1394308,"UZB",1115447
1,295.0,"Southern Europe",626785,0,626785,460668,767780,"ITA",614224
1,295.0,"Central America",278555,0,278555,206094,343491,"MEX",274793
1,295.0,"Southern Asia",834424,0,834424,607750,1012917,"IRN",810334
1,295.0,"Western Asia",897991,0,897991,661547,1102578,"IRQ",882063
1,295.0,"Eastern Asia",835279,0,835279,616705,1027842,"JPN",822274
1,295.0,"Southern Africa",63680,0,63680,45447,75745,"ZAF",60596
1,295.0,"South-Eastern Asia",854279,0,854279,607362,1012270,"IDN",809816
1,295.0,"Caribbean",180964,0,180964,134145,223576,"CUB",178861
1,296.0,"Pakistan",1757671,1634611,123060,1287834,2146390,"PAK",1717112
1,296.0,"India",5813297,5801852,11445,4382950,7304917,"IND",5843934
1,296.0,"Western Europe",3940329,3908766,31563,2828631,4714385,"NLD",3771508
1,296.0,"China",9256446,9174371,82075,7048677,11747795,"CPR",9398236
1,296.0,"United States of America",2888341,2888341,0,2173072,3621787,"USA",2897430
1,296.0,"Northern Africa",1396413,0,1396413,1046895,1744826,"EGY",1395861
1,296.0,"Russian Federation",3337134,2754379,582755,2319819,3866366,"RUS",3093093
1,296.0,"Western Africa",305325,0,305325,227234,378723,"NGA",302979
1,296.0,"South America",1862675,1543606,319069,1376343,2293905,"BRA",1835124
1,296.0,"Northern Europe",2049755,2000211,49544,1503791,2506318,"GBR",2005055
1,296.0,"Northern America",626887,623966,2921,468813,781355,"CAN",625084
1,296.0,"Oceania",457207,446441,10766,338422,564037,"NZL",451230
1,296.0,"Eastern Africa",237986,0,237986,177340,295567,"ETH",236454
1,296.0,"Middle Africa",80431,0,80431,60122,100203,"AGO",80163
1,296.0,"Eastern Europe",2555511,2524233,31278,2333488,3889147,"POL",3111318
1,296.0,"Central Asia",1181541,1121558,59983,836585,1394308,"UZB",1115447
1,296.0,"Southern Europe",619087,0,619087,460668,767780,"ITA",614224
1,296.0,"Central America",274438,0,274438,206094,343491,"MEX",274793
1,296.0,"Southern Asia",793036,0,793036,607750,1012917,"IRN",810334
1,296.0,"Western Asia",863351,0,863351,661547,1102578,"IRQ",882063
1,296.0,"Eastern Asia",823399,0,823399,616705,1027842,"JPN",822274
1,296.0,"Southern Africa",61541,0,61541,45447,75745,"ZAF",60596
1,296.0,"South-Eastern Asia",820304,0,820304,607362,1012270,"IDN",809816
1,296.0,"Caribbean",178535,0,178535,134145,223576,"CUB",178861
1,297.0,"Pakistan",1700853,1645857,54996,1287834,2146390,"PAK",1717112
1,297.0,"India",5930590,5913348,17242,4382950,7304917,"IND",5843934
1,297.0,"Western Europe",3760676,3751613,9063,2828631,4714385,"NLD",3771508
1,297.0,"China",9323779,9202348,121431,7048677,11747795,"CPR",9398236
1,297.0,"United States of America",2848320,2848320,0,2173072,3621787,"USA",2897430
1,297.0,"Northern Africa",1399295,0,1399295,1046895,1744826,"EGY",1395861
1,297.0,"Russian Federation",3136858,2775200,361658,2319819,3866366,"RUS",3093093
1,297.0,"Western Africa",300466,0,300466,227234,378723,"NGA",302979
1,297.0,"South America",1875387,1538763,336624,1376343,2293905,"BRA",1835124
1,297.0,"Northern Europe",2057409,2007333,50076,1503791,2506318,"GBR",2005055
1,297.0,"Northern America",615563,614741,822,468813,781355,"CAN",625084
1,297.0,"Oceania",445814,442626,3188,338422,564037,"NZL",451230
1,297.0,"Eastern Africa",234637,0,234637,177340,295567,"ETH",236454
1,297.0,"Middle Africa",79909,0,79909,60122,100203,"AGO",80163
1,297.0,"Eastern Europe",2977335,2769843,207492,2333488,3889147,"POL",3111318
1,297.0,"Central Asia",1085734,1067283,18451,836585,1394308,"UZB",1115447
1,297.0,"Southern Europe",607849,0,607849,460668,767780,"ITA",614224
1,297.0,"Central America",270284,0,270284,206094,343491,"MEX",274793
1,297.0,"Southern Asia",808540,0,808540,607750,1012917,"IRN",810334
1,297.0,"Western Asia",880337,0,880337,661547,1102578,"IRQ",882063
1,297.0,"Eastern Asia",810417,0,810417,616705,1027842,"JPN",822274
1,297.0,"Southern Africa",60083,0,60083,45447,75745,"ZAF",60596
1,297.0,"South-Eastern Asia",801071,0,801071,607362,1012270,"IDN",809816
1,297.0,"Caribbean",175896,0,175896,134145,223576,"CUB",178861
1,298.0,"Pakistan",1699434,1653513,45921,1287834,2146390,"PAK",1717112
1,298.0,"India",5791160,5785844,5316,4382950,7304917,"IND",5843934
1,298.0,"Western Europe",3788479,3785641,2838,2828631,4714385,"NLD",3771508
1,298.0,"China",9346831,9189492,157339,7048677,11747795,"CPR",9398236
1,298.0,"United States of America",2897878,2897878,0,2173072,3621787,"USA",2897430
1,298.0,"Northern Africa",1415557,0,1415557,1046895,1744826,"EGY",1395861
1,298.0,"Russian Federation",2880796,2727049,153747,2319819,3866366,"RUS",3093093
1,298.0,"Western Africa",304029,0,304029,227234,378723,"NGA",302979
1,298.0,"South America",1867475,1533110,334365,1376343,2293905,"BRA",1835124
1,298.0,"Northern Europe",2032245,2016929,15316,1503791,2506318,"GBR",2005055
1,298.0,"Northern America",625470,625252,218,468813,781355,"CAN",625084
1,298.0,"Oceania",450646,449774,872,338422,564037,"NZL",451230
1,298.0,"Eastern Africa",237406,0,237406,177340,295567,"ETH",236454
1,298.0,"Middle Africa",80654,0,80654,60122,100203,"AGO",80163
1,298.0,"Eastern Europe",3282894,2934234,348660,2333488,3889147,"POL",3111318
1,298.0,"Central Asia",1145248,1114826,30422,836585,1394308,"UZB",1115447
1,298.0,"Southern Europe",616160,0,616160,460668,767780,"ITA",614224
1,298.0,"Central America",274862,0,274862,206094,343491,"MEX",274793
1,298.0,"Southern Asia",822226,0,822226,607750,1012917,"IRN",810334
1,298.0,"Western Asia",898776,0,898776,661547,1102578,"IRQ",882063
1,298.0,"Eastern Asia",816341,0,816341,616705,1027842,"JPN",822274
1,298.0,"Southern Africa",60543,0,60543,45447,75745,"ZAF",60596
1,298.0,"South-Eastern Asia",807364,0,807364,607362,1012270,"IDN",809816
1,298.0,"Caribbean",178898,0,178898,134145,223576,"CUB",178861
1,299.0,"Pakistan",1712010,1660518,51492,1287834,2146390,"PAK",1717112
1,299.0,"India",5907240,5903136,4104,4382950,7304917,"IND",5843934
1,299.0,"Western Europe",3735912,3734762,1150,2828631,4714385,"NLD",3771508
1,299.0,"China",9382059,9195312,186747,7048677,11747795,"CPR",9398236
1,299.0,"United States of America",2881920,2881920,0,2173072,3621787,"USA",2897430
1,299.0,"Northern Africa",1396747,0,1396747,1046895,1744826,"EGY",1395861
1,299.0,"Russian Federation",2994950,2799680,195270,2319819,3866366,"RUS",3093093
1,299.0,"Western Africa",301623,0,301623,227234,378723,"NGA",302979
1,299.0,"South America",1830721,1532365,298356,1376343,2293905,"BRA",1835124
1,299.0,"Northern Europe",1948197,1943640,4557,1503791,2506318,"GBR",2005055
1,299.0,"Northern America",621760,621760,0,468813,781355,"CAN",625084
1,299.0,"Oceania",449832,449560,272,338422,564037,"NZL",451230
1,299.0,"Eastern Africa",236723,0,236723,177340,295567,"ETH",236454
1,299.0,"Middle Africa",80126,0,80126,60122,100203,"AGO",80163
1,299.0,"Eastern Europe",3430764,3018562,412202,2333488,3889147,"POL",3111318
1,299.0,"Central Asia",1118877,1109413,9464,836585,1394308,"UZB",1115447
1,299.0,"Southern Europe",608751,0,608751,460668,767780,"ITA",614224
1,299.0,"Central America",273346,0,273346,206094,343491,"MEX",274793
1,299.0,"Southern Asia",814469,0,814469,607750,1012917,"IRN",810334
1,299.0,"Western Asia",887142,0,887142,661547,1102578,"IRQ",882063
1,299.0,"Eastern Asia",820045,0,820045,616705,1027842,"JPN",822274
1,299.0,"Southern Africa",60303,0,60303,45447,75745,"ZAF",60596
1,299.0,"South-Eastern Asia",806874,0,806874,607362,1012270,"IDN",809816
1,299.0,"Caribbean",177912,0,177912,134145,223576,"CUB",178861
1,300.0,"Pakistan",1715460,1659456,56004,1287847,2146412,"PAK",1717130
1,300.0,"India",5688328,5687189,1139,4382964,7304940,"IND",5843952
1,300.0,"Western Europe",3688433,3688148,285,2828643,4714406,"NLD",3771525
1,300.0,"China",9449945,9229306,220639,7048683,11747805,"CPR",9398244
1,300.0,"United States of America",3002575,3002575,0,2173086,3621810,"USA",2897448
1,300.0,"Northern Africa",1392565,0,1392565,1046895,1744825,"EGY",1395860
1,300.0,"Russian Federation",3087655,2836161,251494,2319828,3866381,"RUS",3093105
1,300.0,"Western Africa",305960,0,305960,227242,378737,"NGA",302990
1,300.0,"South America",1842303,1539675,302628,1376357,2293928,"BRA",1835143
1,300.0,"Northern Europe",2063677,2052096,11581,1503805,2506342,"GBR",2005074
1,300.0,"Northern America",627542,627442,100,468822,781370,"CAN",625096
1,300.0,"Oceania",467843,467843,0,338431,564052,"NZL",451242
1,300.0,"Eastern Africa",244012,0,244012,177336,295560,"ETH",236448
1,300.0,"Middle Africa",81470,0,81470,60128,100213,"AGO",80171
1,300.0,"Eastern Europe",3393163,3046407,346756,2333502,3889171,"POL",3111337
1,300.0,"Central Asia",1158900,1155914,2986,836599,1394332,"UZB",1115466
1,300.0,"Southern Europe",619267,0,619267,460664,767773,"ITA",614219
1,300.0,"Central America",284651,0,284651,206094,343491,"MEX",274793
1,300.0,"Southern Asia",816251,0,816251,607747,1012912,"IRN",810330
1,300.0,"Western Asia",888008,0,888008,661542,1102571,"IRQ",882057
1,300.0,"Eastern Asia",844099,0,844099,616714,1027857,"JPN",822286
1,300.0,"Southern Africa",61718,0,61718,45446,75743,"ZAF",60595
1,300.0,"South-Eastern Asia",837562,0,837562,607374,1012290,"IDN",809832
1,300.0,"Caribbean",185120,0,185120,134156,223593,"CUB",178875
1,301.0,"Pakistan",1722029,1672497,49532,1265181,2108636,"PAK",1686909
1,301.0,"India",5971195,5954601,16594,4426679,7377798,"IND",5902239
1,301.0,"Western Europe",3828351,3810653,17698,2912130,4853550,"NLD",3882840
1,301.0,"China",9501523,9241022,260501,7001593,11669322,"CPR",9335458
1,301.0,"United States of America",2919560,2919560,0,1985561,3309268,"USA",2647415
1,301.0,"Northern Africa",1417916,0,1417916,885569,1475948,"EGY",1180759
1,301.0,"Russian Federation",3156300,2849234,307066,2877198,4795331,"RUS",3836265
1,301.0,"Western Africa",306222,0,306222,236740,394567,"NGA",315654
1,301.0,"South America",1959082,1648028,311054,1399111,2331852,"BRA",1865482
1,301.0,"Northern Europe",2044592,2035264,9328,1494862,2491437,"GBR",1993150
1,301.0,"Northern America",641160,636624,4536,462835,771392,"CAN",617114
1,301.0,"Oceania",454759,454759,0,349100,581833,"NZL",465467
1,301.0,"Eastern Africa",235530,0,235530,163452,272421,"ETH",217937
1,301.0,"Middle Africa",80855,0,80855,57720,96201,"AGO",76961
1,301.0,"Eastern Europe",3129205,2962670,166535,2569224,4282041,"POL",3425633
1,301.0,"Central Asia",1048082,1047352,730,863983,1439972,"UZB",1151978
1,301.0,"Southern Europe",621736,0,621736,622622,1037703,"ITA",830163
1,301.0,"Central America",276970,0,276970,247711,412852,"MEX",330282
1,301.0,"Southern Asia",826258,0,826258,669354,1115591,"IRN",892473
1,301.0,"Western Asia",896716,0,896716,565075,941792,"IRQ",753434
1,301.0,"Eastern Asia",833726,0,833726,626717,1044528,"JPN",835623
1,301.0,"Southern Africa",61074,0,61074,402,670,"ZAF",536
1,301.0,"South-Eastern Asia",816794,0,816794,556530,927550,"IDN",742040
1,301.0,"Caribbean",180366,0,180366,137814,229690,"CUB",183752
1,302.0,"Pakistan",1736798,1672580,64218,1265181,2108636,"PAK",1686909
1,302.0,"India",5994459,5979460,14999,4426679,7377798,"IND",5902239
1,302.0,"Western Europe",3901915,3881259,20656,2912130,4853550,"NLD",3882840
1,302.0,"China",9541445,9243752,297693,7001593,11669322,"CPR",9335458
1,302.0,"United States of America",2880909,2880909,0,1985561,3309268,"USA",2647415
1,302.0,"Northern Africa",1423040,0,1423040,885569,1475948,"EGY",1180759
1,302.0,"Russian Federation",3190935,2853985,336950,2877198,4795331,"RUS",3836265
1,302.0,"Western Africa",301419,0,301419,236740,394567,"NGA",315654
1,302.0,"South America",1770523,1598425,172098,1399111,2331852,"BRA",1865482
1,302.0,"Northern Europe",1963299,1956700,6599,1494862,2491437,"GBR",1993150
1,302.0,"Northern America",628052,624215,3837,462835,771392,"CAN",617114
1,302.0,"Oceania",395323,395323,0,349100,581833,"NZL",465467
1,302.0,"Eastern Africa",216589,0,216589,163452,272421,"ETH",217937
1,302.0,"Middle Africa",74310,0,74310,57720,96201,"AGO",76961
1,302.0,"Eastern Europe",3125292,2985240,140052,2569224,4282041,"POL",3425633
1,302.0,"Central Asia",1163262,1133725,29537,863983,1439972,"UZB",1151978
1,302.0,"Southern Europe",621380,0,621380,622622,1037703,"ITA",830163
1,302.0,"Central America",272626,0,272626,247711,412852,"MEX",330282
1,302.0,"Southern Asia",798678,0,798678,669354,1115591,"IRN",892473
1,302.0,"Western Asia",891831,0,891831,565075,941792,"IRQ",753434
1,302.0,"Eastern Asia",800443,0,800443,626717,1044528,"JPN",835623
1,302.0,"Southern Africa",55940,0,55940,402,670,"ZAF",536
1,302.0,"South-Eastern Asia",717798,0,717798,556530,927550,"IDN",742040
1,302.0,"Caribbean",177752,0,177752,137814,229690,"CUB",183752
1,303.0,"Pakistan",1735171,1667884,67287,1265181,2108636,"PAK",1686909
1,303.0,"India",5929944,5924481,5463,4426679,7377798,"IND",5902239
1,303.0,"Western Europe",3806720,3800308,6412,2912130,4853550,"NLD",3882840
1,303.0,"China",9562555,9250471,312084,7001593,11669322,"CPR",9335458
1,303.0,"United States of America",2751197,2751197,0,1985561,3309268,"USA",2647415
1,303.0,"Northern Africa",1232286,0,1232286,885569,1475948,"EGY",1180759
1,303.0,"Russian Federation",3247374,2855992,391382,2877198,4795331,"RUS",3836265
1,303.0,"Western Africa",311939,0,311939,236740,394567,"NGA",315654
1,303.0,"South America",1813352,1615451,197901,1399111,2331852,"BRA",1865482
1,303.0,"Northern Europe",2053800,2037051,16749,1494862,2491437,"GBR",1993150
1,303.0,"Northern America",580972,579919,1053,462835,771392,"CAN",617114
1,303.0,"Oceania",504394,467797,36597,349100,581833,"NZL",465467
1,303.0,"Eastern Africa",238778,0,238778,163452,272421,"ETH",217937
1,303.0,"Middle Africa",82416,0,82416,57720,96201,"AGO",76961
1,303.0,"Eastern Europe",3142224,2996526,145698,2569224,4282041,"POL",3425633
1,303.0,"Central Asia",1113328,1104305,9023,863983,1439972,"UZB",1151978
1,303.0,"Southern Europe",743975,0,743975,622622,1037703,"ITA",830163
1,303.0,"Central America",317923,0,317923,247711,412852,"MEX",330282
1,303.0,"Southern Asia",851253,0,851253,669354,1115591,"IRN",892473
1,303.0,"Western Asia",777058,0,777058,565075,941792,"IRQ",753434
1,303.0,"Eastern Asia",839519,0,839519,626717,1044528,"JPN",835623
1,303.0,"Southern Africa",22020,0,22020,402,670,"ZAF",536
1,303.0,"South-Eastern Asia",827577,0,827577,556530,927550,"IDN",742040
1,303.0,"Caribbean",184026,0,184026,137814,229690,"CUB",183752
1,304.0,"Pakistan",1710945,1658707,52238,1265181,2108636,"PAK",1686909
1,304.0,"India",5878812,5876115,2697,4426679,7377798,"IND",5902239
1,304.0,"Western Europe",3807511,3796849,10662,2912130,4853550,"NLD",3882840
1,304.0,"China",9511691,9210991,300700,7001593,11669322,"CPR",9335458
1,304.0,"United States of America",2662657,2662657,0,1985561,3309268,"USA",2647415
1,304.0,"Northern Africa",1194487,0,1194487,885569,1475948,"EGY",1180759
1,304.0,"Russian Federation",3447671,2875545,572126,2877198,4795331,"RUS",3836265
1,304.0,"Western Africa",314737,0,314737,236740,394567,"NGA",315654
1,304.0,"South America",1857699,1637063,220636,1399111,2331852,"BRA",1865482
1,304.0,"Northern Europe",1931480,1926619,4861,1494862,2491437,"GBR",1993150
1,304.0,"Northern America",650688,622364,28324,462835,771392,"CAN",617114
1,304.0,"Oceania",452828,442414,10414,349100,581833,"NZL",465467
1,304.0,"Eastern Africa",216539,0,216539,163452,272421,"ETH",217937
1,304.0,"Middle Africa",75934,0,75934,57720,96201,"AGO",76961
1,304.0,"Eastern Europe",3230440,3024046,206394,2569224,4282041,"POL",3425633
1,304.0,"Central Asia",1155327,1133589,21738,863983,1439972,"UZB",1151978
1,304.0,"Southern Europe",827256,0,827256,622622,1037703,"ITA",830163
1,304.0,"Central America",325094,0,325094,247711,412852,"MEX",330282
1,304.0,"Southern Asia",904864,0,904864,669354,1115591,"IRN",892473
1,304.0,"Western Asia",773456,0,773456,565075,941792,"IRQ",753434
1,304.0,"Eastern Asia",844174,0,844174,626717,1044528,"JPN",835623
1,304.0,"Southern Africa",6597,0,6597,402,670,"ZAF",536
1,304.0,"South-Eastern Asia",734104,0,734104,556530,927550,"IDN",742040
1,304.0,"Caribbean",183351,0,183351,137814,229690,"CUB",183752
1,305.0,"Pakistan",1684451,1641349,43102,1265181,2108636,"PAK",1686909
1,305.0,"India",5768800,5767999,801,4426679,7377798,"IND",5902239
1,305.0,"Western Europe",3901138,3885102,16036,2912130,4853550,"NLD",3882840
1,305.0,"China",9411906,9164655,247251,7001593,11669322,"CPR",9335458
1,305.0,"United States of America",2554406,2554406,0,1985561,3309268,"USA",2647415
1,305.0,"Northern Africa",1178995,0,1178995,885569,1475948,"EGY",1180759
1,305.0,"Russian Federation",3645520,2877488,768032,2877198,4795331,"RUS",3836265
1,305.0,"Western Africa",312252,0,312252,236740,394567,"NGA",315654
1,305.0,"South America",1867315,1634983,232332,1399111,2331852,"BRA",1865482
1,305.0,"Northern Europe",2005963,1993910,12053,1494862,2491437,"GBR",1993150
1,305.0,"Northern America",610802,602710,8092,462835,771392,"CAN",617114
1,305.0,"Oceania",478415,461448,16967,349100,581833,"NZL",465467
1,305.0,"Eastern Africa",223081,0,223081,163452,272421,"ETH",217937
1,305.0,"Middle Africa",78779,0,78779,57720,96201,"AGO",76961
1,305.0,"Eastern Europe",3319781,3031722,288059,2569224,4282041,"POL",3425633
1,305.0,"Central Asia",1143395,1123245,20150,863983,1439972,"UZB",1151978
1,305.0,"Southern Europe",814696,0,814696,622622,1037703,"ITA",830163
1,305.0,"Central America",317237,0,317237,247711,412852,"MEX",330282
1,305.0,"Southern Asia",888148,0,888148,669354,1115591,"IRN",892473
1,305.0,"Western Asia",747098,0,747098,565075,941792,"IRQ",753434
1,305.0,"Eastern Asia",819280,0,819280,626717,1044528,"JPN",835623
1,305.0,"Southern Africa",2465,0,2465,402,670,"ZAF",536
1,305.0,"South-Eastern Asia",765372,0,765372,556530,927550,"IDN",742040
1,305.0,"Caribbean",177082,0,177082,137814,229690,"CUB",183752
1,306.0,"Pakistan",1600393,1585644,14749,1265181,2108636,"PAK",1686909
1,306.0,"India",5796051,5794360,1691,4426679,7377798,"IND",5902239
1,306.0,"Western Europe",3804326,3798553,5773,2912130,4853550,"NLD",3882840
1,306.0,"China",9281441,9099988,181453,7001593,11669322,"CPR",9335458
1,306.0,"United States of America",2704005,2703669,336,1985561,3309268,"USA",2647415
1,306.0,"Northern Africa",1170267,0,1170267,885569,1475948,"EGY",1180759
1,306.0,"Russian Federation",3826723,2880102,946621,2877198,4795331,"RUS",3836265
1,306.0,"Western Africa",311488,0,311488,236740,394567,"NGA",315654
1,306.0,"South America",1864780,1630828,233952,1399111,2331852,"BRA",1865482
1,306.0,"Northern Europe",1873258,1869598,3660,1494862,2491437,"GBR",1993150
1,306.0,"Northern America",595311,592919,2392,462835,771392,"CAN",617114
1,306.0,"Oceania",472011,466864,5147,349100,581833,"NZL",465467
1,306.0,"Eastern Africa",220225,0,220225,163452,272421,"ETH",217937
1,306.0,"Middle Africa",77346,0,77346,57720,96201,"AGO",76961
1,306.0,"Eastern Europe",3402602,3028348,374254,2569224,4282041,"POL",3425633
1,306.0,"Central Asia",1149199,1139667,9532,863983,1439972,"UZB",1151978
1,306.0,"Southern Europe",814508,0,814508,622622,1037703,"ITA",830163
1,306.0,"Central America",335551,0,335551,247711,412852,"MEX",330282
1,306.0,"Southern Asia",868640,0,868640,669354,1115591,"IRN",892473
1,306.0,"Western Asia",745460,0,745460,565075,941792,"IRQ",753434
1,306.0,"Eastern Asia",838190,0,838190,626717,1044528,"JPN",835623
1,306.0,"Southern Africa",1123,0,1123,402,670,"ZAF",536
1,306.0,"South-Eastern Asia",751882,0,751882,556530,927550,"IDN",742040
1,306.0,"Caribbean",186376,0,186376,137814,229690,"CUB",183752
1,307.0,"Pakistan",1657510,1621101,36409,1265181,2108636,"PAK",1686909
1,307.0,"India",5770751,5764672,6079,4426679,7377798,"IND",5902239
1,307.0,"Western Europe",3793723,3783675,10048,2912130,4853550,"NLD",3882840
1,307.0,"China",9213350,9059665,153685,7001593,11669322,"CPR",9335458
1,307.0,"United States of America",2600583,2600471,112,1985561,3309268,"USA",2647415
1,307.0,"Northern Africa",1159114,0,1159114,885569,1475948,"EGY",1180759
1,307.0,"Russian Federation",3961453,2878773,1082680,2877198,4795331,"RUS",3836265
1,307.0,"Western Africa",313581,0,313581,236740,394567,"NGA",315654
1,307.0,"South America",1847049,1623286,223763,1399111,2331852,"BRA",1865482
1,307.0,"Northern Europe",2029872,1998952,30920,1494862,2491437,"GBR",1993150
1,307.0,"Northern America",635263,625935,9328,462835,771392,"CAN",617114
1,307.0,"Oceania",439163,437642,1521,349100,581833,"NZL",465467
1,307.0,"Eastern Africa",207002,0,207002,163452,272421,"ETH",217937
1,307.0,"Middle Africa",73418,0,73418,57720,96201,"AGO",76961
1,307.0,"Eastern Europe",3461913,3024471,437442,2569224,4282041,"POL",3425633
1,307.0,"Central Asia",1098055,1089525,8530,863983,1439972,"UZB",1151978
1,307.0,"Southern Europe",828970,0,828970,622622,1037703,"ITA",830163
1,307.0,"Central America",324967,0,324967,247711,412852,"MEX",330282
1,307.0,"Southern Asia",897339,0,897339,669354,1115591,"IRN",892473
1,307.0,"Western Asia",749533,0,749533,565075,941792,"IRQ",753434
1,307.0,"Eastern Asia",826410,0,826410,626717,1044528,"JPN",835623
1,307.0,"Southern Africa",706,0,706,402,670,"ZAF",536
1,307.0,"South-Eastern Asia",704263,0,704263,556530,927550,"IDN",742040
1,307.0,"Caribbean",181275,0,181275,137814,229690,"CUB",183752
1,308.0,"Pakistan",1674422,1633103,41319,1265181,2108636,"PAK",1686909
1,308.0,"India",5824900,5818063,6837,4426679,7377798,"IND",5902239
1,308.0,"Western Europe",3754260,3740175,14085,2912130,4853550,"NLD",3882840
1,308.0,"China",9108321,9030737,77584,7001593,11669322,"CPR",9335458
1,308.0,"United States of America",2256286,2255912,374,1985561,3309268,"USA",2647415
1,308.0,"Northern Africa",1100194,0,1100194,885569,1475948,"EGY",1180759
1,308.0,"Russian Federation",4510525,3377085,1133440,2877198,4795331,"RUS",3836265
1,308.0,"Western Africa",289403,0,289403,236740,394567,"NGA",315654
1,308.0,"South America",1792123,1620232,171891,1399111,2331852,"BRA",1865482
1,308.0,"Northern Europe",2003100,1983084,20016,1494862,2491437,"GBR",1993150
1,308.0,"Northern America",564232,561858,2374,462835,771392,"CAN",617114
1,308.0,"Oceania",487900,483035,4865,349100,581833,"NZL",465467
1,308.0,"Eastern Africa",227087,0,227087,163452,272421,"ETH",217937
1,308.0,"Middle Africa",78499,0,78499,57720,96201,"AGO",76961
1,308.0,"Eastern Europe",3811748,3358487,453261,2569224,4282041,"POL",3425633
1,308.0,"Central Asia",1234165,1213018,21147,863983,1439972,"UZB",1151978
1,308.0,"Southern Europe",760939,0,760939,622622,1037703,"ITA",830163
1,308.0,"Central America",284085,0,284085,247711,412852,"MEX",330282
1,308.0,"Southern Asia",841386,0,841386,669354,1115591,"IRN",892473
1,308.0,"Western Asia",686885,0,686885,565075,941792,"IRQ",753434
1,308.0,"Eastern Asia",745960,0,745960,626717,1044528,"JPN",835623
1,308.0,"Southern Africa",490,0,490,402,670,"ZAF",536
1,308.0,"South-Eastern Asia",771760,0,771760,556530,927550,"IDN",742040
1,308.0,"Caribbean",157989,0,157989,137814,229690,"CUB",183752
1,309.0,"Pakistan",1690523,1642764,47759,1265181,2108636,"PAK",1686909
1,309.0,"India",5861482,5838921,22561,4426679,7377798,"IND",5902239
1,309.0,"Western Europe",3830023,3794520,35503,2912130,4853550,"NLD",3882840
1,309.0,"China",9156000,9074642,81358,7001593,11669322,"CPR",9335458
1,309.0,"United States of America",2713194,2620770,92424,1985561,3309268,"USA",2647415
1,309.0,"Northern Africa",1189468,0,1189468,885569,1475948,"EGY",1180759
1,309.0,"Russian Federation",4080534,3279020,801514,2877198,4795331,"RUS",3836265
1,309.0,"Western Africa",318734,0,318734,236740,394567,"NGA",315654
1,309.0,"South America",1742261,1638618,103643,1399111,2331852,"BRA",1865482
1,309.0,"Northern Europe",1872812,1851916,20896,1494862,2491437,"GBR",1993150
1,309.0,"Northern America",618305,580964,37341,462835,771392,"CAN",617114
1,309.0,"Oceania",471214,469328,1886,349100,581833,"NZL",465467
1,309.0,"Eastern Africa",221691,0,221691,163452,272421,"ETH",217937
1,309.0,"Middle Africa",77941,0,77941,57720,96201,"AGO",76961
1,309.0,"Eastern Europe",3578082,3354794,223288,2569224,4282041,"POL",3425633
1,309.0,"Central Asia",1152902,1145260,7642,863983,1439972,"UZB",1151978
1,309.0,"Southern Europe",838987,0,838987,622622,1037703,"ITA",830163
1,309.0,"Central America",339583,0,339583,247711,412852,"MEX",330282
1,309.0,"Southern Asia",898019,0,898019,669354,1115591,"IRN",892473
1,309.0,"Western Asia",763448,0,763448,565075,941792,"IRQ",753434
1,309.0,"Eastern Asia",856211,0,856211,626717,1044528,"JPN",835623
1,309.0,"Southern Africa",540,0,540,402,670,"ZAF",536
1,309.0,"South-Eastern Asia",750806,0,750806,556530,927550,"IDN",742040
1,309.0,"Caribbean",189008,0,189008,137814,229690,"CUB",183752
1,310.0,"Pakistan",1698075,1647948,50127,1265181,2108636,"PAK",1686909
1,310.0,"India",5921944,5883337,38607,4426679,7377798,"IND",5902239
1,310.0,"Western Europe",3942381,3887772,54609,2912130,4853550,"NLD",3882840
1,310.0,"China",9273160,9176707,96453,7001593,11669322,"CPR",9335458
1,310.0,"United States of America",2933145,2852064,81081,1985561,3309268,"USA",2647415
1,310.0,"Northern Africa",1222924,0,1222924,885569,1475948,"EGY",1180759
1,310.0,"Russian Federation",4012669,3484192,528477,2877198,4795331,"RUS",3836265
1,310.0,"Western Africa",327268,0,327268,236740,394567,"NGA",315654
1,310.0,"South America",1836859,1648737,188122,1399111,2331852,"BRA",1865482
1,310.0,"Northern Europe",2024850,1966782,58068,1494862,2491437,"GBR",1993150
1,310.0,"Northern America",627518,578356,49162,462835,771392,"CAN",617114
1,310.0,"Oceania",463606,462905,701,349100,581833,"NZL",465467
1,310.0,"Eastern Africa",215366,0,215366,163452,272421,"ETH",217937
1,310.0,"Middle Africa",76723,0,76723,57720,96201,"AGO",76961
1,310.0,"Eastern Europe",3198805,3122860,75945,2569224,4282041,"POL",3425633
1,310.0,"Central Asia",1057689,1050426,7263,863983,1439972,"UZB",1151978
1,310.0,"Southern Europe",856303,0,856303,622622,1037703,"ITA",830163
1,310.0,"Central America",357511,0,357511,247711,412852,"MEX",330282
1,310.0,"Southern Asia",904542,0,904542,669354,1115591,"IRN",892473
1,310.0,"Western Asia",781340,0,781340,565075,941792,"IRQ",753434
1,310.0,"Eastern Asia",891776,0,891776,626717,1044528,"JPN",835623
1,310.0,"Southern Africa",431,0,431,402,670,"ZAF",536
1,310.0,"South-Eastern Asia",740227,0,740227,556530,927550,"IDN",742040
1,310.0,"Caribbean",198860,0,198860,137814,229690,"CUB",183752
1,311.0,"Pakistan",1717729,1668623,49106,1265181,2108636,"PAK",1686909
1,311.0,"India",5974106,5932019,42087,4426679,7377798,"IND",5902239
1,311.0,"Western Europe",3967682,3915379,52303,2912130,4853550,"NLD",3882840
1,311.0,"China",9314357,9195218,119139,7001593,11669322,"CPR",9335458
1,311.0,"United States of America",2772692,2732972,39720,1985561,3309268,"USA",2647415
1,311.0,"Northern Africa",1213148,0,1213148,885569,1475948,"EGY",1180759
1,311.0,"Russian Federation",3508432,3235942,272490,2877198,4795331,"RUS",3836265
1,311.0,"Western Africa",329742,0,329742,236740,394567,"NGA",315654
1,311.0,"South America",1918543,1650039,268504,1399111,2331852,"BRA",1865482
1,311.0,"Northern Europe",2058780,2001877,56903,1494862,2491437,"GBR",1993150
1,311.0,"Northern America",666058,617580,48478,462835,771392,"CAN",617114
1,311.0,"Oceania",456150,453918,2232,349100,581833,"NZL",465467
1,311.0,"Eastern Africa",214763,0,214763,163452,272421,"ETH",217937
1,311.0,"Middle Africa",76375,0,76375,57720,96201,"AGO",76961
1,311.0,"Eastern Europe",3471233,3376024,95209,2569224,4282041,"POL",3425633
1,311.0,"Central Asia",1249014,1201065,47949,863983,1439972,"UZB",1151978
1,311.0,"Southern Europe",871280,0,871280,622622,1037703,"ITA",830163
1,311.0,"Central America",346002,0,346002,247711,412852,"MEX",330282
1,311.0,"Southern Asia",937873,0,937873,669354,1115591,"IRN",892473
1,311.0,"Western Asia",786530,0,786530,565075,941792,"IRQ",753434
1,311.0,"Eastern Asia",865528,0,865528,626717,1044528,"JPN",835623
1,311.0,"Southern Africa",493,0,493,402,670,"ZAF",536
1,311.0,"South-Eastern Asia",731982,0,731982,556530,927550,"IDN",742040
1,311.0,"Caribbean",192613,0,192613,137814,229690,"CUB",183752
1,312.0,"Pakistan",1711657,1667544,44113,1265188,2108647,"PAK",1686918
1,312.0,"India",5992806,5949758,43048,4426691,7377818,"IND",5902255
1,312.0,"Western Europe",4019604,3970641,48963,2912133,4853556,"NLD",3882845
1,312.0,"China",9385284,9227597,157687,7001597,11669328,"CPR",9335463
1,312.0,"United States of America",2580969,2567744,13225,1985563,3309272,"USA",2647418
1,312.0,"Northern Africa",1201905,0,1201905,885573,1475955,"EGY",1180764
1,312.0,"Russian Federation",3922104,3615068,307036,2877202,4795337,"RUS",3836270
1,312.0,"Western Africa",316400,0,316400,236739,394565,"NGA",315652
1,312.0,"South America",1968398,1651952,316446,1399121,2331868,"BRA",1865495
1,312.0,"Northern Europe",2042196,1998514,43682,1494871,2491452,"GBR",1993162
1,312.0,"Northern America",599580,578747,20833,462840,771401,"CAN",617121
1,312.0,"Oceania",473940,468067,5873,349107,581846,"NZL",465477
1,312.0,"Eastern Africa",222080,0,222080,163452,272421,"ETH",217937
1,312.0,"Middle Africa",78754,0,78754,57728,96213,"AGO",76971
1,312.0,"Eastern Europe",3467736,3403301,64435,2569237,4282062,"POL",3425650
1,312.0,"Central Asia",1129507,1114943,14564,863992,1439987,"UZB",1151990
1,312.0,"Southern Europe",826916,0,826916,622617,1037696,"ITA",830157
1,312.0,"Central America",324537,0,324537,247711,412852,"MEX",330282
1,312.0,"Southern Asia",885524,0,885524,669354,1115590,"IRN",892472
1,312.0,"Western Asia",753882,0,753882,565077,941795,"IRQ",753436
1,312.0,"Eastern Asia",825450,0,825450,626718,1044531,"JPN",835625
1,312.0,"Southern Africa",522,0,522,402,671,"ZAF",537
1,312.0,"South-Eastern Asia",753442,0,753442,556533,927556,"IDN",742045
1,312.0,"Caribbean",180509,0,180509,137820,229701,"CUB",183761
1,313.0,"Pakistan",1716589,1672718,43871,1256068,2093447,"PAK",1674758
1,313.0,"India",6060317,6019797,40520,4435988,7393313,"IND",5914651
1,313.0,"Western Europe",3871399,3851561,19838,2938031,4896718,"NLD",3917375
1,313.0,"China",9433434,9240528,192906,6919161,11531936,"CPR",9225549
1,313.0,"United States of America",2605834,2601948,3886,1881761,3136268,"USA",2509015
1,313.0,"Northern Africa",1171438,0,1171438,1111691,1852818,"EGY",1482255
1,313.0,"Russian Federation",3740490,3618417,122073,2230537,3717562,"RUS",2974050
1,313.0,"Western Africa",317314,0,317314,266435,444058,"NGA",355247
1,313.0,"South America",2093328,1777204,316124,1433529,2389215,"BRA",1911372
1,313.0,"Northern Europe",2035150,2005879,29271,1528156,2546927,"GBR",2037542
1,313.0,"Northern America",661885,645037,16848,510966,851610,"CAN",681288
1,313.0,"Oceania",432408,430602,1806,382440,637401,"NZL",509921
1,313.0,"Eastern Africa",204522,0,204522,161664,269440,"ETH",215552
1,313.0,"Middle Africa",73120,0,73120,68500,114167,"AGO",91334
1,313.0,"Eastern Europe",3457081,3406583,50498,2529255,4215425,"POL",3372340
1,313.0,"Central Asia",1141561,1131455,10106,996374,1660623,"UZB",1328499
1,313.0,"Southern Europe",847048,0,847048,764179,1273632,"ITA",1018906
1,313.0,"Central America",328493,0,328493,240644,401073,"MEX",320859
1,313.0,"Southern Asia",920284,0,920284,506019,843366,"IRN",674693
1,313.0,"Western Asia",761871,0,761871,663369,1105615,"IRQ",884492
1,313.0,"Eastern Asia",828229,0,828229,655845,1093076,"JPN",874461
1,313.0,"Southern Africa",452,0,452,55839,93066,"ZAF",74453
1,313.0,"South-Eastern Asia",695361,0,695361,714258,1190430,"IDN",952344
1,313.0,"Caribbean",182913,0,182913,115138,191897,"CUB",153518
1,314.0,"Pakistan",1697467,1676352,21115,1256068,2093447,"PAK",1674758
1,314.0,"India",5967976,5950005,17971,4435988,7393313,"IND",5914651
1,314.0,"Western Europe",3901506,3880561,20945,2938031,4896718,"NLD",3917375
1,314.0,"China",9452143,9234826,217317,6919161,11531936,"CPR",9225549
1,314.0,"United States of America",2741561,2734206,7355,1881761,3136268,"USA",2509015
1,314.0,"Northern Africa",1198710,0,1198710,1111691,1852818,"EGY",1482255
1,314.0,"Russian Federation",3839055,3716376,122679,2230537,3717562,"RUS",2974050
1,314.0,"Western Africa",321793,0,321793,266435,444058,"NGA",355247
1,314.0,"South America",1762201,1586776,175425,1433529,2389215,"BRA",1911372
1,314.0,"Northern Europe",1936958,1922120,14838,1528156,2546927,"GBR",2037542
1,314.0,"Northern America",628432,623119,5313,510966,851610,"CAN",681288
1,314.0,"Oceania",508362,477594,30768,382440,637401,"NZL",509921
1,314.0,"Eastern Africa",236935,0,236935,161664,269440,"ETH",215552
1,314.0,"Middle Africa",81900,0,81900,68500,114167,"AGO",91334
1,314.0,"Eastern Europe",3426828,3401426,25402,2529255,4215425,"POL",3372340
1,314.0,"Central Asia",1158520,1145161,13359,996374,1660623,"UZB",1328499
1,314.0,"Southern Europe",844240,0,844240,764179,1273632,"ITA",1018906
1,314.0,"Central America",342649,0,342649,240644,401073,"MEX",320859
1,314.0,"Southern Asia",910930,0,910930,506019,843366,"IRN",674693
1,314.0,"Western Asia",765083,0,765083,663369,1105615,"IRQ",884492
1,314.0,"Eastern Asia",861424,0,861424,655845,1093076,"JPN",874461
1,314.0,"Southern Africa",544,0,544,55839,93066,"ZAF",74453
1,314.0,"South-Eastern Asia",802639,0,802639,714258,1190430,"IDN",952344
1,314.0,"Caribbean",190474,0,190474,115138,191897,"CUB",153518
1,315.0,"Pakistan",1699354,1675775,23579,1256068,2093447,"PAK",1674758
1,315.0,"India",5914372,5897195,17177,4435988,7393313,"IND",5914651
1,315.0,"Western Europe",3912040,3884761,27279,2938031,4896718,"NLD",3917375
1,315.0,"China",9483849,9239868,243981,6919161,11531936,"CPR",9225549
1,315.0,"United States of America",2540790,2535080,5710,1881761,3136268,"USA",2509015
1,315.0,"Northern Africa",1386564,0,1386564,1111691,1852818,"EGY",1482255
1,315.0,"Russian Federation",3492000,3376524,115476,2230537,3717562,"RUS",2974050
1,315.0,"Western Africa",340029,0,340029,266435,444058,"NGA",355247
1,315.0,"South America",1892963,1701027,191936,1433529,2389215,"BRA",1911372
1,315.0,"Northern Europe",2032392,1996197,36195,1528156,2546927,"GBR",2037542
1,315.0,"Northern America",623484,621882,1602,510966,851610,"CAN",681288
1,315.0,"Oceania",469743,460620,9123,382440,637401,"NZL",509921
1,315.0,"Eastern Africa",204062,0,204062,161664,269440,"ETH",215552
1,315.0,"Middle Africa",83859,0,83859,68500,114167,"AGO",91334
1,315.0,"Eastern Europe",3407096,3378482,28614,2529255,4215425,"POL",3372340
1,315.0,"Central Asia",1170021,1150819,19202,996374,1660623,"UZB",1328499
1,315.0,"Southern Europe",941864,0,941864,764179,1273632,"ITA",1018906
1,315.0,"Central America",319482,0,319482,240644,401073,"MEX",320859
1,315.0,"Southern Asia",711606,0,711606,506019,843366,"IRN",674693
1,315.0,"Western Asia",834580,0,834580,663369,1105615,"IRQ",884492
1,315.0,"Eastern Asia",856286,0,856286,655845,1093076,"JPN",874461
1,315.0,"Southern Africa",51035,0,51035,55839,93066,"ZAF",74453
1,315.0,"South-Eastern Asia",848686,0,848686,714258,1190430,"IDN",952344
1,315.0,"Caribbean",160243,0,160243,115138,191897,"CUB",153518
1,316.0,"Pakistan",1655531,1644508,11023,1256068,2093447,"PAK",1674758
1,316.0,"India",5914849,5905421,9428,4435988,7393313,"IND",5914651
1,316.0,"Western Europe",3873163,3848272,24891,2938031,4896718,"NLD",3917375
1,316.0,"China",9460663,9224760,235903,6919161,11531936,"CPR",9225549
1,316.0,"United States of America",2412030,2409741,2289,1881761,3136268,"USA",2509015
1,316.0,"Northern Africa",1434024,0,1434024,1111691,1852818,"EGY",1482255
1,316.0,"Russian Federation",3097835,3065700,32135,2230537,3717562,"RUS",2974050
1,316.0,"Western Africa",348724,0,348724,266435,444058,"NGA",355247
1,316.0,"South America",1940170,1753921,186249,1433529,2389215,"BRA",1911372
1,316.0,"Northern Europe",2057746,2020836,36910,1528156,2546927,"GBR",2037542
1,316.0,"Northern America",690069,681818,8251,510966,851610,"CAN",681288
1,316.0,"Oceania",525280,509188,16092,382440,637401,"NZL",509921
1,316.0,"Eastern Africa",224175,0,224175,161664,269440,"ETH",215552
1,316.0,"Middle Africa",92770,0,92770,68500,114167,"AGO",91334
1,316.0,"Eastern Europe",3355611,3332040,23571,2529255,4215425,"POL",3372340
1,316.0,"Central Asia",1351162,1243717,107445,996374,1660623,"UZB",1328499
1,316.0,"Southern Europe",999396,0,999396,764179,1273632,"ITA",1018906
1,316.0,"Central America",312612,0,312612,240644,401073,"MEX",320859
1,316.0,"Southern Asia",701614,0,701614,506019,843366,"IRN",674693
1,316.0,"Western Asia",865658,0,865658,663369,1105615,"IRQ",884492
1,316.0,"Eastern Asia",856701,0,856701,655845,1093076,"JPN",874461
1,316.0,"Southern Africa",70049,0,70049,55839,93066,"ZAF",74453
1,316.0,"South-Eastern Asia",966875,0,966875,714258,1190430,"IDN",952344
1,316.0,"Caribbean",151455,0,151455,115138,191897,"CUB",153518
1,317.0,"Pakistan",1673194,1655778,17416,1256068,2093447,"PAK",1674758
1,317.0,"India",6042153,6030276,11877,4435988,7393313,"IND",5914651
1,317.0,"Western Europe",3892766,3861007,31759,2938031,4896718,"NLD",3917375
1,317.0,"China",9401287,9231090,170197,6919161,11531936,"CPR",9225549
1,317.0,"United States of America",2607510,2597960,9550,1881761,3136268,"USA",2509015
1,317.0,"Northern Africa",1484908,0,1484908,1111691,1852818,"EGY",1482255
1,317.0,"Russian Federation",3001980,2992445,9535,2230537,3717562,"RUS",2974050
1,317.0,"Western Africa",355789,0,355789,266435,444058,"NGA",355247
1,317.0,"South America",1848145,1763145,85000,1433529,2389215,"BRA",1911372
1,317.0,"Northern Europe",2027666,2004712,22954,1528156,2546927,"GBR",2037542
1,317.0,"Northern America",655446,652947,2499,510966,851610,"CAN",681288
1,317.0,"Oceania",495815,491154,4661,382440,637401,"NZL",509921
1,317.0,"Eastern Africa",211614,0,211614,161664,269440,"ETH",215552
1,317.0,"Middle Africa",89685,0,89685,68500,114167,"AGO",91334
1,317.0,"Eastern Europe",3385588,3366117,19471,2529255,4215425,"POL",3372340
1,317.0,"Central Asia",1381022,1274275,106747,996374,1660623,"UZB",1328499
1,317.0,"Southern Europe",1010796,0,1010796,764179,1273632,"ITA",1018906
1,317.0,"Central America",328069,0,328069,240644,401073,"MEX",320859
1,317.0,"Southern Asia",670578,0,670578,506019,843366,"IRN",674693
1,317.0,"Western Asia",883795,0,883795,663369,1105615,"IRQ",884492
1,317.0,"Eastern Asia",888436,0,888436,655845,1093076,"JPN",874461
1,317.0,"Southern Africa",71502,0,71502,55839,93066,"ZAF",74453
1,317.0,"South-Eastern Asia",927384,0,927384,714258,1190430,"IDN",952344
1,317.0,"Caribbean",157801,0,157801,115138,191897,"CUB",153518
1,318.0,"Pakistan",1687906,1663857,24049,1256068,2093447,"PAK",1674758
1,318.0,"India",5935853,5927867,7986,4435988,7393313,"IND",5914651
1,318.0,"Western Europe",4124382,4071104,53278,2938031,4896718,"NLD",3917375
1,318.0,"China",9377191,9232071,145120,6919161,11531936,"CPR",9225549
1,318.0,"United States of America",2557215,2554398,2817,1881761,3136268,"USA",2509015
1,318.0,"Northern Africa",1528140,0,1528140,1111691,1852818,"EGY",1482255
1,318.0,"Russian Federation",2857167,2854307,2860,2230537,3717562,"RUS",2974050
1,318.0,"Western Africa",362171,0,362171,266435,444058,"NGA",355247
1,318.0,"South America",1898389,1780643,117746,1433529,2389215,"BRA",1911372
1,318.0,"Northern Europe",2039945,2010083,29862,1528156,2546927,"GBR",2037542
1,318.0,"Northern America",705955,694322,11633,510966,851610,"CAN",681288
1,318.0,"Oceania",526977,517310,9667,382440,637401,"NZL",509921
1,318.0,"Eastern Africa",219999,0,219999,161664,269440,"ETH",215552
1,318.0,"Middle Africa",93184,0,93184,68500,114167,"AGO",91334
1,318.0,"Eastern Europe",3394667,3371709,22958,2529255,4215425,"POL",3372340
1,318.0,"Central Asia",1341099,1273151,67948,996374,1660623,"UZB",1328499
1,318.0,"Southern Europe",1047175,0,1047175,764179,1273632,"ITA",1018906
1,318.0,"Central America",327096,0,327096,240644,401073,"MEX",320859
1,318.0,"Southern Asia",692038,0,692038,506019,843366,"IRN",674693
1,318.0,"Western Asia",903842,0,903842,663369,1105615,"IRQ",884492
1,318.0,"Eastern Asia",884857,0,884857,655845,1093076,"JPN",874461
1,318.0,"Southern Africa",74907,0,74907,55839,93066,"ZAF",74453
1,318.0,"South-Eastern Asia",974493,0,974493,714258,1190430,"IDN",952344
1,318.0,"Caribbean",156732,0,156732,115138,191897,"CUB",153518
1,319.0,"Pakistan",1701144,1674154,26990,1256068,2093447,"PAK",1674758
1,319.0,"India",5920987,5917859,3128,4435988,7393313,"IND",5914651
1,319.0,"Western Europe",3914050,3895770,18280,2938031,4896718,"NLD",3917375
1,319.0,"China",9344478,9233840,110638,6919161,11531936,"CPR",9225549
1,319.0,"United States of America",2502682,2502028,654,1881761,3136268,"USA",2509015
1,319.0,"Northern Africa",1475240,0,1475240,1111691,1852818,"EGY",1482255
1,319.0,"Russian Federation",3065106,3041343,23763,2230537,3717562,"RUS",2974050
1,319.0,"Western Africa",341994,0,341994,266435,444058,"NGA",355247
1,319.0,"South America",1933245,1782321,150924,1433529,2389215,"BRA",1911372
1,319.0,"Northern Europe",2065659,2026386,39273,1528156,2546927,"GBR",2037542
1,319.0,"Northern America",542239,538872,3367,510966,851610,"CAN",681288
1,319.0,"Oceania",506885,504071,2814,382440,637401,"NZL",509921
1,319.0,"Eastern Africa",215534,0,215534,161664,269440,"ETH",215552
1,319.0,"Middle Africa",91584,0,91584,68500,114167,"AGO",91334
1,319.0,"Eastern Europe",3424170,3398333,25837,2529255,4215425,"POL",3372340
1,319.0,"Central Asia",1338677,1280633,58044,996374,1660623,"UZB",1328499
1,319.0,"Southern Europe",942990,0,942990,764179,1273632,"ITA",1018906
1,319.0,"Central America",312754,0,312754,240644,401073,"MEX",320859
1,319.0,"Southern Asia",595198,0,595198,506019,843366,"IRN",674693
1,319.0,"Western Asia",844038,0,844038,663369,1105615,"IRQ",884492
1,319.0,"Eastern Asia",850462,0,850462,655845,1093076,"JPN",874461
1,319.0,"Southern Africa",74160,0,74160,55839,93066,"ZAF",74453
1,319.0,"South-Eastern Asia",938928,0,938928,714258,1190430,"IDN",952344
1,319.0,"Caribbean",150140,0,150140,115138,191897,"CUB",153518
1,320.0,"Pakistan",1696006,1674813,21193,1256068,2093447,"PAK",1674758
1,320.0,"India",5916408,5913832,2576,4435988,7393313,"IND",5914651
1,320.0,"Western Europe",3802103,3787817,14286,2938031,4896718,"NLD",3917375
1,320.0,"China",9113697,9069928,43769,6919161,11531936,"CPR",9225549
1,320.0,"United States of America",2369208,2368961,247,1881761,3136268,"USA",2509015
1,320.0,"Northern Africa",1450057,0,1450057,1111691,1852818,"EGY",1482255
1,320.0,"Russian Federation",2929751,2922742,7009,2230537,3717562,"RUS",2974050
1,320.0,"Western Africa",353121,0,353121,266435,444058,"NGA",355247
1,320.0,"South America",1943633,1786517,157116,1433529,2389215,"BRA",1911372
1,320.0,"Northern Europe",2067296,2027028,40268,1528156,2546927,"GBR",2037542
1,320.0,"Northern America",723581,665893,57688,510966,851610,"CAN",681288
1,320.0,"Oceania",510347,509559,788,382440,637401,"NZL",509921
1,320.0,"Eastern Africa",214927,0,214927,161664,269440,"ETH",215552
1,320.0,"Middle Africa",90893,0,90893,68500,114167,"AGO",91334
1,320.0,"Eastern Europe",3423350,3405219,18131,2529255,4215425,"POL",3372340
1,320.0,"Central Asia",1342169,1285489,56680,996374,1660623,"UZB",1328499
1,320.0,"Southern Europe",1024742,0,1024742,764179,1273632,"ITA",1018906
1,320.0,"Central America",308814,0,308814,240644,401073,"MEX",320859
1,320.0,"Southern Asia",702735,0,702735,506019,843366,"IRN",674693
1,320.0,"Western Asia",886707,0,886707,663369,1105615,"IRQ",884492
1,320.0,"Eastern Asia",854716,0,854716,655845,1093076,"JPN",874461
1,320.0,"Southern Africa",74554,0,74554,55839,93066,"ZAF",74453
1,320.0,"South-Eastern Asia",957720,0,957720,714258,1190430,"IDN",952344
1,320.0,"Caribbean",147445,0,147445,115138,191897,"CUB",153518
1,321.0,"Pakistan",1610099,1603816,6283,1256068,2093447,"PAK",1674758
1,321.0,"India",5821071,5820366,705,4435988,7393313,"IND",5914651
1,321.0,"Western Europe",3849524,3820992,28532,2938031,4896718,"NLD",3917375
1,321.0,"China",9117424,9073335,44089,6919161,11531936,"CPR",9225549
1,321.0,"United States of America",2505235,2491693,13542,1881761,3136268,"USA",2509015
1,321.0,"Northern Africa",1468452,0,1468452,1111691,1852818,"EGY",1482255
1,321.0,"Russian Federation",2984640,2979021,5619,2230537,3717562,"RUS",2974050
1,321.0,"Western Africa",359187,0,359187,266435,444058,"NGA",355247
1,321.0,"South America",1866904,1782487,84417,1433529,2389215,"BRA",1911372
1,321.0,"Northern Europe",1987290,1971712,15578,1528156,2546927,"GBR",2037542
1,321.0,"Northern America",741303,646624,94679,510966,851610,"CAN",681288
1,321.0,"Oceania",505785,505785,0,382440,637401,"NZL",509921
1,321.0,"Eastern Africa",214915,0,214915,161664,269440,"ETH",215552
1,321.0,"Middle Africa",91017,0,91017,68500,114167,"AGO",91334
1,321.0,"Eastern Europe",3360830,3355154,5676,2529255,4215425,"POL",3372340
1,321.0,"Central Asia",1294577,1254311,40266,996374,1660623,"UZB",1328499
1,321.0,"Southern Europe",1043653,0,1043653,764179,1273632,"ITA",1018906
1,321.0,"Central America",323424,0,323424,240644,401073,"MEX",320859
1,321.0,"Southern Asia",706475,0,706475,506019,843366,"IRN",674693
1,321.0,"Western Asia",895925,0,895925,663369,1105615,"IRQ",884492
1,321.0,"Eastern Asia",883842,0,883842,655845,1093076,"JPN",874461
1,321.0,"Southern Africa",74265,0,74265,55839,93066,"ZAF",74453
1,321.0,"South-Eastern Asia",950987,0,950987,714258,1190430,"IDN",952344
1,321.0,"Caribbean",154650,0,154650,115138,191897,"CUB",153518
1,322.0,"Pakistan",1654263,1633620,20643,1256068,2093447,"PAK",1674758
1,322.0,"India",5822856,5822108,748,4435988,7393313,"IND",5914651
1,322.0,"Western Europe",3906332,3863004,43328,2938031,4896718,"NLD",3917375
1,322.0,"China",9116614,9070235,46379,6919161,11531936,"CPR",9225549
1,322.0,"United States of America",2582861,2572532,10329,1881761,3136268,"USA",2509015
1,322.0,"Northern Africa",1481373,0,1481373,1111691,1852818,"EGY",1482255
1,322.0,"Russian Federation",2905670,2904178,1492,2230537,3717562,"RUS",2974050
1,322.0,"Western Africa",359015,0,359015,266435,444058,"NGA",355247
1,322.0,"South America",1882351,1784752,97599,1433529,2389215,"BRA",1911372
1,322.0,"Northern Europe",1994095,1975466,18629,1528156,2546927,"GBR",2037542
1,322.0,"Northern America",701632,656829,44803,510966,851610,"CAN",681288
1,322.0,"Oceania",508698,508698,0,382440,637401,"NZL",509921
1,322.0,"Eastern Africa",214579,0,214579,161664,269440,"ETH",215552
1,322.0,"Middle Africa",91014,0,91014,68500,114167,"AGO",91334
1,322.0,"Eastern Europe",3377999,3376223,1776,2529255,4215425,"POL",3372340
1,322.0,"Central Asia",1362839,1313760,49079,996374,1660623,"UZB",1328499
1,322.0,"Southern Europe",1036165,0,1036165,764179,1273632,"ITA",1018906
1,322.0,"Central America",330117,0,330117,240644,401073,"MEX",320859
1,322.0,"Southern Asia",683864,0,683864,506019,843366,"IRN",674693
1,322.0,"Western Asia",892094,0,892094,663369,1105615,"IRQ",884492
1,322.0,"Eastern Asia",889962,0,889962,655845,1093076,"JPN",874461
1,322.0,"Southern Africa",74126,0,74126,55839,93066,"ZAF",74453
1,322.0,"South-Eastern Asia",949514,0,949514,714258,1190430,"IDN",952344
1,322.0,"Caribbean",157996,0,157996,115138,191897,"CUB",153518
1,323.0,"Pakistan",1695735,1664185,31550,1256068,2093447,"PAK",1674758
1,323.0,"India",5854283,5850385,3898,4435988,7393313,"IND",5914651
1,323.0,"Western Europe",4096025,4043048,52977,2938031,4896718,"NLD",3917375
1,323.0,"China",9116048,9068978,47070,6919161,11531936,"CPR",9225549
1,323.0,"United States of America",2570666,2567855,2811,1881761,3136268,"USA",2509015
1,323.0,"Northern Africa",1515863,0,1515863,1111691,1852818,"EGY",1482255
1,323.0,"Russian Federation",3073537,3066702,6835,2230537,3717562,"RUS",2974050
1,323.0,"Western Africa",361703,0,361703,266435,444058,"NGA",355247
1,323.0,"South America",1908127,1785966,122161,1433529,2389215,"BRA",1911372
1,323.0,"Northern Europe",2029672,1993653,36019,1528156,2546927,"GBR",2037542
1,323.0,"Northern America",698400,685140,13260,510966,851610,"CAN",681288
1,323.0,"Oceania",498728,498728,0,382440,637401,"NZL",509921
1,323.0,"Eastern Africa",213258,0,213258,161664,269440,"ETH",215552
1,323.0,"Middle Africa",89883,0,89883,68500,114167,"AGO",91334
1,323.0,"Eastern Europe",3275565,3275134,431,2529255,4215425,"POL",3372340
1,323.0,"Central Asia",1360234,1345528,14706,996374,1660623,"UZB",1328499
1,323.0,"Southern Europe",1043595,0,1043595,764179,1273632,"ITA",1018906
1,323.0,"Central America",328632,0,328632,240644,401073,"MEX",320859
1,323.0,"Southern Asia",683086,0,683086,506019,843366,"IRN",674693
1,323.0,"Western Asia",898954,0,898954,663369,1105615,"IRQ",884492
1,323.0,"Eastern Asia",890503,0,890503,655845,1093076,"JPN",874461
1,323.0,"Southern Africa",73493,0,73493,55839,93066,"ZAF",74453
1,323.0,"South-Eastern Asia",936398,0,936398,714258,1190430,"IDN",952344
1,323.0,"Caribbean",157218,0,157218,115138,191897,"CUB",153518
1,324.0,"Pakistan",1690526,1662894,27632,1256071,2093452,"PAK",1674762
1,324.0,"India",6024854,6010613,14241,4435995,7393326,"IND",5914661
1,324.0,"Western Europe",3959268,3927866,31402,2938041,4896736,"NLD",3917389
1,324.0,"China",9140850,9073996,66854,6919167,11531945,"CPR",9225556
1,324.0,"United States of America",2486649,2486055,594,1881769,3136282,"USA",2509026
1,324.0,"Northern Africa",1496302,0,1496302,1111691,1852818,"EGY",1482255
1,324.0,"Russian Federation",2915795,2913189,2606,2230545,3717576,"RUS",2974061
1,324.0,"Western Africa",355506,0,355506,266447,444078,"NGA",355263
1,324.0,"South America",1937503,1786503,151000,1433537,2389228,"BRA",1911383
1,324.0,"Northern Europe",2058120,2002099,56021,1528158,2546931,"GBR",2037545
1,324.0,"Northern America",670022,666421,3601,510966,851611,"CAN",681289
1,324.0,"Oceania",519042,512857,6185,382451,637418,"NZL",509935
1,324.0,"Eastern Africa",218029,0,218029,161665,269442,"ETH",215554
1,324.0,"Middle Africa",92794,0,92794,68514,114190,"AGO",91352
1,324.0,"Eastern Europe",3442392,3426865,15527,2529263,4215438,"POL",3372351
1,324.0,"Central Asia",1316938,1312501,4437,996379,1660632,"UZB",1328506
1,324.0,"Southern Europe",1016898,0,1016898,764173,1273622,"ITA",1018898
1,324.0,"Central America",318212,0,318212,240648,401081,"MEX",320865
1,324.0,"Southern Asia",672603,0,672603,506019,843366,"IRN",674693
1,324.0,"Western Asia",885667,0,885667,663369,1105615,"IRQ",884492
1,324.0,"Eastern Asia",869786,0,869786,655855,1093092,"JPN",874474
1,324.0,"Southern Africa",75439,0,75439,55842,93070,"ZAF",74456
1,324.0,"South-Eastern Asia",967341,0,967341,714265,1190442,"IDN",952354
1,324.0,"Caribbean",152262,0,152262,115149,191916,"CUB",153533
1,325.0,"Pakistan",1688098,1667197,20901,1323933,2206555,"PAK",1765244
1,325.0,"India",5915625,5909037,6588,4653037,7755062,"IND",6204050
1,325.0,"Western Europe",3856776,3844115,12661,2844379,4740632,"NLD",3792506
1,325.0,"China",9172598,9082464,90134,7127979,11879966,"CPR",9503973
1,325.0,"United States of America",2462625,2462505,120,2119098,3531830,"USA",2825464
1,325.0,"Northern Africa",1462865,0,1462865,927747,1546246,"EGY",1236997
1,325.0,"Russian Federation",2964079,2959505,4574,2086467,3477445,"RUS",2781956
1,325.0,"Western Africa",349730,0,349730,286364,477273,"NGA",381819
1,325.0,"South America",1815468,1651641,163827,1506587,2510978,"BRA",2008783
1,325.0,"Northern Europe",2075963,2005661,70302,1588807,2648012,"GBR",2118410
1,325.0,"Northern America",672354,670647,1707,489658,816097,"CAN",652878
1,325.0,"Oceania",504478,502685,1793,422364,703940,"NZL",563152
1,325.0,"Eastern Africa",212022,0,212022,232220,387033,"ETH",309627
1,325.0,"Middle Africa",89854,0,89854,73356,122260,"AGO",97808
1,325.0,"Eastern Europe",3285119,3277629,7490,2116415,3527358,"POL",2821887
1,325.0,"Central Asia",1279411,1278201,1210,1098084,1830140,"UZB",1464112
1,325.0,"Southern Europe",1002423,0,1002423,679796,1132993,"ITA",906395
1,325.0,"Central America",315051,0,315051,274239,457065,"MEX",365652
1,325.0,"Southern Asia",665195,0,665195,413344,688907,"IRN",551126
1,325.0,"Western Asia",870765,0,870765,769031,1281718,"IRQ",1025375
1,325.0,"Eastern Asia",860728,0,860728,632205,1053675,"JPN",842940
1,325.0,"Southern Africa",73106,0,73106,79797,132996,"ZAF",106397
1,325.0,"South-Eastern Asia",941545,0,941545,632426,1054043,"IDN",843235
1,325.0,"Caribbean",150729,0,150729,124173,206955,"CUB",165564
1,326.0,"Pakistan",1570713,1564406,6307,1323933,2206555,"PAK",1765244
1,326.0,"India",5851299,5849259,2040,4653037,7755062,"IND",6204050
1,326.0,"Western Europe",3741081,3737188,3893,2844379,4740632,"NLD",3792506
1,326.0,"China",9181098,9077285,103813,7127979,11879966,"CPR",9503973
1,326.0,"United States of America",2468011,2468011,0,2119098,3531830,"USA",2825464
1,326.0,"Northern Africa",1439040,0,1439040,927747,1546246,"EGY",1236997
1,326.0,"Russian Federation",2939048,2937646,1402,2086467,3477445,"RUS",2781956
1,326.0,"Western Africa",348039,0,348039,286364,477273,"NGA",381819
1,326.0,"South America",1876136,1648029,228107,1506587,2510978,"BRA",2008783
1,326.0,"Northern Europe",2015992,1986902,29090,1588807,2648012,"GBR",2118410
1,326.0,"Northern America",671265,670742,523,489658,816097,"CAN",652878
1,326.0,"Oceania",394621,394240,381,422364,703940,"NZL",563152
1,326.0,"Eastern Africa",186033,0,186033,232220,387033,"ETH",309627
1,326.0,"Middle Africa",79744,0,79744,73356,122260,"AGO",97808
1,326.0,"Eastern Europe",3362988,3352047,10941,2116415,3527358,"POL",2821887
1,326.0,"Central Asia",1323793,1316227,7566,1098084,1830140,"UZB",1464112
1,326.0,"Southern Europe",995452,0,995452,679796,1132993,"ITA",906395
1,326.0,"Central America",315688,0,315688,274239,457065,"MEX",365652
1,326.0,"Southern Asia",664832,0,664832,413344,688907,"IRN",551126
1,326.0,"Western Asia",867585,0,867585,769031,1281718,"IRQ",1025375
1,326.0,"Eastern Asia",844187,0,844187,632205,1053675,"JPN",842940
1,326.0,"Southern Africa",63993,0,63993,79797,132996,"ZAF",106397
1,326.0,"South-Eastern Asia",764485,0,764485,632426,1054043,"IDN",843235
1,326.0,"Caribbean",151045,0,151045,124173,206955,"CUB",165564
1,327.0,"Pakistan",1669852,1630318,39534,1323933,2206555,"PAK",1765244
1,327.0,"India",5795370,5794987,383,4653037,7755062,"IND",6204050
1,327.0,"Western Europe",3955473,3937516,17957,2844379,4740632,"NLD",3792506
1,327.0,"China",9188507,9085602,102905,7127979,11879966,"CPR",9503973
1,327.0,"United States of America",2751179,2751075,104,2119098,3531830,"USA",2825464
1,327.0,"Northern Africa",1324542,0,1324542,927747,1546246,"EGY",1236997
1,327.0,"Russian Federation",2869321,2868974,347,2086467,3477445,"RUS",2781956
1,327.0,"Western Africa",379324,0,379324,286364,477273,"NGA",381819
1,327.0,"South America",1929589,1651142,278447,1506587,2510978,"BRA",2008783
1,327.0,"Northern Europe",1977658,1962327,15331,1588807,2648012,"GBR",2118410
1,327.0,"Northern America",667414,667414,0,489658,816097,"CAN",652878
1,327.0,"Oceania",490004,443047,46957,422364,703940,"NZL",563152
1,327.0,"Eastern Africa",260720,0,260720,232220,387033,"ETH",309627
1,327.0,"Middle Africa",92686,0,92686,73356,122260,"AGO",97808
1,327.0,"Eastern Europe",3031172,3027986,3186,2116415,3527358,"POL",2821887
1,327.0,"Central Asia",1304573,1302081,2492,1098084,1830140,"UZB",1464112
1,327.0,"Southern Europe",952912,0,952912,679796,1132993,"ITA",906395
1,327.0,"Central America",354905,0,354905,274239,457065,"MEX",365652
1,327.0,"Southern Asia",589855,0,589855,413344,688907,"IRN",551126
1,327.0,"Western Asia",985748,0,985748,769031,1281718,"IRQ",1025375
1,327.0,"Eastern Asia",858643,0,858643,632205,1053675,"JPN",842940
1,327.0,"Southern Africa",90330,0,90330,79797,132996,"ZAF",106397
1,327.0,"South-Eastern Asia",808373,0,808373,632426,1054043,"IDN",843235
1,327.0,"Caribbean",163209,0,163209,124173,206955,"CUB",165564
1,328.0,"Pakistan",1733954,1655255,78699,1323933,2206555,"PAK",1765244
1,328.0,"India",5943805,5920189,23616,4653037,7755062,"IND",6204050
1,328.0,"Western Europe",3811120,3802169,8951,2844379,4740632,"NLD",3792506
1,328.0,"China",9158179,9059571,98608,7127979,11879966,"CPR",9503973
1,328.0,"United States of America",2825578,2825578,0,2119098,3531830,"USA",2825464
1,328.0,"Northern Africa",1262878,0,1262878,927747,1546246,"EGY",1236997
1,328.0,"Russian Federation",2876119,2876119,0,2086467,3477445,"RUS",2781956
1,328.0,"Western Africa",383021,0,383021,286364,477273,"NGA",381819
1,328.0,"South America",1980728,1647688,333040,1506587,2510978,"BRA",2008783
1,328.0,"Northern Europe",2036088,1986886,49202,1588807,2648012,"GBR",2118410
1,328.0,"Northern America",673163,673163,0,489658,816097,"CAN",652878
1,328.0,"Oceania",563740,469979,93761,422364,703940,"NZL",563152
1,328.0,"Eastern Africa",304727,0,304727,232220,387033,"ETH",309627
1,328.0,"Middle Africa",99093,0,99093,73356,122260,"AGO",97808
1,328.0,"Eastern Europe",2869351,2867464,1887,2116415,3527358,"POL",2821887
1,328.0,"Central Asia",1482281,1423043,59238,1098084,1830140,"UZB",1464112
1,328.0,"Southern Europe",929177,0,929177,679796,1132993,"ITA",906395
1,328.0,"Central America",365488,0,365488,274239,457065,"MEX",365652
1,328.0,"Southern Asia",573693,0,573693,413344,688907,"IRN",551126
1,328.0,"Western Asia",1024445,0,1024445,769031,1281718,"IRQ",1025375
1,328.0,"Eastern Asia",868458,0,868458,632205,1053675,"JPN",842940
1,328.0,"Southern Africa",104373,0,104373,79797,132996,"ZAF",106397
1,328.0,"South-Eastern Asia",873582,0,873582,632426,1054043,"IDN",843235
1,328.0,"Caribbean",166226,0,166226,124173,206955,"CUB",165564
1,329.0,"Pakistan",1766287,1662850,103437,1323933,2206555,"PAK",1765244
1,329.0,"India",5972163,5911360,60803,4653037,7755062,"IND",6204050
1,329.0,"Western Europe",3849522,3837998,11524,2844379,4740632,"NLD",3792506
1,329.0,"China",9191010,9060857,130153,7127979,11879966,"CPR",9503973
1,329.0,"United States of America",2810521,2809964,557,2119098,3531830,"USA",2825464
1,329.0,"Northern Africa",1251864,0,1251864,927747,1546246,"EGY",1236997
1,329.0,"Russian Federation",2771978,2771978,0,2086467,3477445,"RUS",2781956
1,329.0,"Western Africa",379356,0,379356,286364,477273,"NGA",381819
1,329.0,"South America",2035330,1648232,387098,1506587,2510978,"BRA",2008783
1,329.0,"Northern Europe",2092152,1996596,95556,1588807,2648012,"GBR",2118410
1,329.0,"Northern America",624130,624130,0,489658,816097,"CAN",652878
1,329.0,"Oceania",617377,486131,131246,422364,703940,"NZL",563152
1,329.0,"Eastern Africa",324037,0,324037,232220,387033,"ETH",309627
1,329.0,"Middle Africa",102658,0,102658,73356,122260,"AGO",97808
1,329.0,"Eastern Europe",2805880,2802217,3663,2116415,3527358,"POL",2821887
1,329.0,"Central Asia",1522274,1451996,70278,1098084,1830140,"UZB",1464112
1,329.0,"Southern Europe",899276,0,899276,679796,1132993,"ITA",906395
1,329.0,"Central America",362667,0,362667,274239,457065,"MEX",365652
1,329.0,"Southern Asia",544089,0,544089,413344,688907,"IRN",551126
1,329.0,"Western Asia",1014622,0,1014622,769031,1281718,"IRQ",1025375
1,329.0,"Eastern Asia",843890,0,843890,632205,1053675,"JPN",842940
1,329.0,"Southern Africa",110904,0,110904,79797,132996,"ZAF",106397
1,329.0,"South-Eastern Asia",924739,0,924739,632426,1054043,"IDN",843235
1,329.0,"Caribbean",164328,0,164328,124173,206955,"CUB",165564
1,330.0,"Pakistan",1859987,1732215,127772,1323933,2206555,"PAK",1765244
1,330.0,"India",6155319,6049869,105450,4653037,7755062,"IND",6204050
1,330.0,"Western Europe",3656961,3653593,3368,2844379,4740632,"NLD",3792506
1,330.0,"China",9248614,9075951,172663,7127979,11879966,"CPR",9503973
1,330.0,"United States of America",2783323,2783030,293,2119098,3531830,"USA",2825464
1,330.0,"Northern Africa",1215073,0,1215073,927747,1546246,"EGY",1236997
1,330.0,"Russian Federation",2579637,2579637,0,2086467,3477445,"RUS",2781956
1,330.0,"Western Africa",370692,0,370692,286364,477273,"NGA",381819
1,330.0,"South America",2015375,1651463,363912,1506587,2510978,"BRA",2008783
1,330.0,"Northern Europe",2138298,2002883,135415,1588807,2648012,"GBR",2118410
1,330.0,"Northern America",671879,663033,8846,489658,816097,"CAN",652878
1,330.0,"Oceania",641704,504010,137694,422364,703940,"NZL",563152
1,330.0,"Eastern Africa",324036,0,324036,232220,387033,"ETH",309627
1,330.0,"Middle Africa",101673,0,101673,73356,122260,"AGO",97808
1,330.0,"Eastern Europe",2801265,2793223,8042,2116415,3527358,"POL",2821887
1,330.0,"Central Asia",1460967,1416945,44022,1098084,1830140,"UZB",1464112
1,330.0,"Southern Europe",898801,0,898801,679796,1132993,"ITA",906395
1,330.0,"Central America",361205,0,361205,274239,457065,"MEX",365652
1,330.0,"Southern Asia",549980,0,549980,413344,688907,"IRN",551126
1,330.0,"Western Asia",1006359,0,1006359,769031,1281718,"IRQ",1025375
1,330.0,"Eastern Asia",822109,0,822109,632205,1053675,"JPN",842940
1,330.0,"Southern Africa",111885,0,111885,79797,132996,"ZAF",106397
1,330.0,"South-Eastern Asia",943429,0,943429,632426,1054043,"IDN",843235
1,330.0,"Caribbean",163832,0,163832,124173,206955,"CUB",165564
1,331.0,"Pakistan",1728543,1681061,47482,1323933,2206555,"PAK",1765244
1,331.0,"India",6295702,6156267,139435,4653037,7755062,"IND",6204050
1,331.0,"Western Europe",3696254,3688178,8076,2844379,4740632,"NLD",3792506
1,331.0,"China",9326459,9100250,226209,7127979,11879966,"CPR",9503973
1,331.0,"United States of America",2766557,2765567,990,2119098,3531830,"USA",2825464
1,331.0,"Northern Africa",1210503,0,1210503,927747,1546246,"EGY",1236997
1,331.0,"Russian Federation",2905784,2889022,16762,2086467,3477445,"RUS",2781956
1,331.0,"Western Africa",376200,0,376200,286364,477273,"NGA",381819
1,331.0,"South America",2024623,1648558,376065,1506587,2510978,"BRA",2008783
1,331.0,"Northern Europe",2159955,2000779,159176,1588807,2648012,"GBR",2118410
1,331.0,"Northern America",623966,621153,2813,489658,816097,"CAN",652878
1,331.0,"Oceania",570705,478842,91863,422364,703940,"NZL",563152
1,331.0,"Eastern Africa",306296,0,306296,232220,387033,"ETH",309627
1,331.0,"Middle Africa",96810,0,96810,73356,122260,"AGO",97808
1,331.0,"Eastern Europe",2723011,2718671,4340,2116415,3527358,"POL",2821887
1,331.0,"Central Asia",1404264,1383528,20736,1098084,1830140,"UZB",1464112
1,331.0,"Southern Europe",881517,0,881517,679796,1132993,"ITA",906395
1,331.0,"Central America",357219,0,357219,274239,457065,"MEX",365652
1,331.0,"Southern Asia",540637,0,540637,413344,688907,"IRN",551126
1,331.0,"Western Asia",1003586,0,1003586,769031,1281718,"IRQ",1025375
1,331.0,"Eastern Asia",840966,0,840966,632205,1053675,"JPN",842940
1,331.0,"Southern Africa",105216,0,105216,79797,132996,"ZAF",106397
1,331.0,"South-Eastern Asia",859606,0,859606,632426,1054043,"IDN",843235
1,331.0,"Caribbean",161446,0,161446,124173,206955,"CUB",165564
1,332.0,"Pakistan",1746151,1704455,41696,1323933,2206555,"PAK",1765244
1,332.0,"India",6343118,6207017,136101,4653037,7755062,"IND",6204050
1,332.0,"Western Europe",3557878,3549806,8072,2844379,4740632,"NLD",3792506
1,332.0,"China",9321670,9074024,247646,7127979,11879966,"CPR",9503973
1,332.0,"United States of America",2891675,2890092,1583,2119098,3531830,"USA",2825464
1,332.0,"Northern Africa",1077950,0,1077950,927747,1546246,"EGY",1236997
1,332.0,"Russian Federation",2270203,2265279,4924,2086467,3477445,"RUS",2781956
1,332.0,"Western Africa",334679,0,334679,286364,477273,"NGA",381819
1,332.0,"South America",1996317,1650655,345662,1506587,2510978,"BRA",2008783
1,332.0,"Northern Europe",2140116,1999447,140669,1588807,2648012,"GBR",2118410
1,332.0,"Northern America",671223,665521,5702,489658,816097,"CAN",652878
1,332.0,"Oceania",517670,466474,51196,422364,703940,"NZL",563152
1,332.0,"Eastern Africa",268076,0,268076,232220,387033,"ETH",309627
1,332.0,"Middle Africa",78545,0,78545,73356,122260,"AGO",97808
1,332.0,"Eastern Europe",1660419,1649721,10698,2116415,3527358,"POL",2821887
1,332.0,"Central Asia",1512163,1484574,27589,1098084,1830140,"UZB",1464112
1,332.0,"Southern Europe",821524,0,821524,679796,1132993,"ITA",906395
1,332.0,"Central America",369430,0,369430,274239,457065,"MEX",365652
1,332.0,"Southern Asia",459665,0,459665,413344,688907,"IRN",551126
1,332.0,"Western Asia",828577,0,828577,769031,1281718,"IRQ",1025375
1,332.0,"Eastern Asia",806031,0,806031,632205,1053675,"JPN",842940
1,332.0,"Southern Africa",86398,0,86398,79797,132996,"ZAF",106397
1,332.0,"South-Eastern Asia",759969,0,759969,632426,1054043,"IDN",843235
1,332.0,"Caribbean",167380,0,167380,124173,206955,"CUB",165564
1,333.0,"Pakistan",1700746,1668086,32660,1323933,2206555,"PAK",1765244
1,333.0,"India",6203068,6112946,90122,4653037,7755062,"IND",6204050
1,333.0,"Western Europe",3586437,3555361,31076,2844379,4740632,"NLD",3792506
1,333.0,"China",9263653,9025309,238344,7127979,11879966,"CPR",9503973
1,333.0,"United States of America",2738665,2738190,475,2119098,3531830,"USA",2825464
1,333.0,"Northern Africa",1164405,0,1164405,927747,1546246,"EGY",1236997
1,333.0,"Russian Federation",2520929,2424015,96914,2086467,3477445,"RUS",2781956
1,333.0,"Western Africa",358659,0,358659,286364,477273,"NGA",381819
1,333.0,"South America",1882543,1634613,247930,1506587,2510978,"BRA",2008783
1,333.0,"Northern Europe",2263488,2170292,93196,1588807,2648012,"GBR",2118410
1,333.0,"Northern America",591984,589885,2099,489658,816097,"CAN",652878
1,333.0,"Oceania",520966,452874,68092,422364,703940,"NZL",563152
1,333.0,"Eastern Africa",285820,0,285820,232220,387033,"ETH",309627
1,333.0,"Middle Africa",87944,0,87944,73356,122260,"AGO",97808
1,333.0,"Eastern Europe",2109830,1868681,241149,2116415,3527358,"POL",2821887
1,333.0,"Central Asia",1368732,1356268,12464,1098084,1830140,"UZB",1464112
1,333.0,"Southern Europe",851070,0,851070,679796,1132993,"ITA",906395
1,333.0,"Central America",352658,0,352658,274239,457065,"MEX",365652
1,333.0,"Southern Asia",492927,0,492927,413344,688907,"IRN",551126
1,333.0,"Western Asia",924699,0,924699,769031,1281718,"IRQ",1025375
1,333.0,"Eastern Asia",809356,0,809356,632205,1053675,"JPN",842940
1,333.0,"Southern Africa",95840,0,95840,79797,132996,"ZAF",106397
1,333.0,"South-Eastern Asia",782920,0,782920,632426,1054043,"IDN",843235
1,333.0,"Caribbean",160502,0,160502,124173,206955,"CUB",165564
1,334.0,"Pakistan",1675894,1642869,33025,1323933,2206555,"PAK",1765244
1,334.0,"India",6063622,6004047,59575,4653037,7755062,"IND",6204050
1,334.0,"Western Europe",3587210,3531213,55997,2844379,4740632,"NLD",3792506
1,334.0,"China",9202138,8958653,243485,7127979,11879966,"CPR",9503973
1,334.0,"United States of America",2548213,2546078,2135,2119098,3531830,"USA",2825464
1,334.0,"Northern Africa",1195749,0,1195749,927747,1546246,"EGY",1236997
1,334.0,"Russian Federation",2728983,2554573,174410,2086467,3477445,"RUS",2781956
1,334.0,"Western Africa",367912,0,367912,286364,477273,"NGA",381819
1,334.0,"South America",1880088,1629819,250269,1506587,2510978,"BRA",2008783
1,334.0,"Northern Europe",1937895,1903668,34227,1588807,2648012,"GBR",2118410
1,334.0,"Northern America",608230,593640,14590,489658,816097,"CAN",652878
1,334.0,"Oceania",534800,436814,97986,422364,703940,"NZL",563152
1,334.0,"Eastern Africa",307371,0,307371,232220,387033,"ETH",309627
1,334.0,"Middle Africa",94557,0,94557,73356,122260,"AGO",97808
1,334.0,"Eastern Europe",2484213,2026518,457695,2116415,3527358,"POL",2821887
1,334.0,"Central Asia",1559238,1540603,18635,1098084,1830140,"UZB",1464112
1,334.0,"Southern Europe",866944,0,866944,679796,1132993,"ITA",906395
1,334.0,"Central America",333520,0,333520,274239,457065,"MEX",365652
1,334.0,"Southern Asia",537058,0,537058,413344,688907,"IRN",551126
1,334.0,"Western Asia",981014,0,981014,769031,1281718,"IRQ",1025375
1,334.0,"Eastern Asia",787863,0,787863,632205,1053675,"JPN",842940
1,334.0,"Southern Africa",103507,0,103507,79797,132996,"ZAF",106397
1,334.0,"South-Eastern Asia",811382,0,811382,632426,1054043,"IDN",843235
1,334.0,"Caribbean",150871,0,150871,124173,206955,"CUB",165564
1,335.0,"Pakistan",1650919,1621760,29159,1323933,2206555,"PAK",1765244
1,335.0,"India",5792642,5762843,29799,4653037,7755062,"IND",6204050
1,335.0,"Western Europe",3612097,3537357,74740,2844379,4740632,"NLD",3792506
1,335.0,"China",9133454,8911463,221991,7127979,11879966,"CPR",9503973
1,335.0,"United States of America",2585714,2578750,6964,2119098,3531830,"USA",2825464
1,335.0,"Northern Africa",1203855,0,1203855,927747,1546246,"EGY",1236997
1,335.0,"Russian Federation",2861473,2663794,197679,2086467,3477445,"RUS",2781956
1,335.0,"Western Africa",373932,0,373932,286364,477273,"NGA",381819
1,335.0,"South America",1898554,1636025,262529,1506587,2510978,"BRA",2008783
1,335.0,"Northern Europe",1866614,1846318,20296,1588807,2648012,"GBR",2118410
1,335.0,"Northern America",619211,596676,22535,489658,816097,"CAN",652878
1,335.0,"Oceania",555340,438558,116782,422364,703940,"NZL",563152
1,335.0,"Eastern Africa",307065,0,307065,232220,387033,"ETH",309627
1,335.0,"Middle Africa",98924,0,98924,73356,122260,"AGO",97808
1,335.0,"Eastern Europe",2790777,2155973,634804,2116415,3527358,"POL",2821887
1,335.0,"Central Asia",1329644,1322832,6812,1098084,1830140,"UZB",1464112
1,335.0,"Southern Europe",873866,0,873866,679796,1132993,"ITA",906395
1,335.0,"Central America",337579,0,337579,274239,457065,"MEX",365652
1,335.0,"Southern Asia",554403,0,554403,413344,688907,"IRN",551126
1,335.0,"Western Asia",1018464,0,1018464,769031,1281718,"IRQ",1025375
1,335.0,"Eastern Asia",795743,0,795743,632205,1053675,"JPN",842940
1,335.0,"Southern Africa",107386,0,107386,79797,132996,"ZAF",106397
1,335.0,"South-Eastern Asia",835009,0,835009,632426,1054043,"IDN",843235
1,335.0,"Caribbean",152434,0,152434,124173,206955,"CUB",165564
1,336.0,"Pakistan",1655617,1629925,25692,1323947,2206578,"PAK",1765263
1,336.0,"India",5603275,5585675,17600,4653049,7755082,"IND",6204066
1,336.0,"Western Europe",3628519,3549722,78797,2844382,4740637,"NLD",3792510
1,336.0,"China",9124038,8915980,208058,7127994,11879991,"CPR",9503993
1,336.0,"United States of America",2733725,2727642,6083,2119102,3531837,"USA",2825470
1,336.0,"Northern Africa",1203059,0,1203059,927742,1546237,"EGY",1236990
1,336.0,"Russian Federation",2724866,2637095,87771,2086482,3477470,"RUS",2781976
1,336.0,"Western Africa",369513,0,369513,286368,477280,"NGA",381824
1,336.0,"South America",1905680,1629663,276017,1506597,2510995,"BRA",2008796
1,336.0,"Northern Europe",1954107,1930003,24104,1588821,2648035,"GBR",2118428
1,336.0,"Northern America",622483,610266,12217,489666,816111,"CAN",652889
1,336.0,"Oceania",542399,460882,81517,422364,703941,"NZL",563153
1,336.0,"Eastern Africa",294438,0,294438,232215,387025,"ETH",309620
1,336.0,"Middle Africa",97108,0,97108,73363,122272,"AGO",97818
1,336.0,"Eastern Europe",3024629,2253969,770660,2116420,3527367,"POL",2821894
1,336.0,"Central Asia",1215225,1212099,3126,1098093,1830155,"UZB",1464124
1,336.0,"Southern Europe",880273,0,880273,679797,1132995,"ITA",906396
1,336.0,"Central America",349240,0,349240,274236,457061,"MEX",365649
1,336.0,"Southern Asia",540842,0,540842,413347,688912,"IRN",551130
1,336.0,"Western Asia",1026704,0,1026704,769031,1281718,"IRQ",1025375
1,336.0,"Eastern Asia",810419,0,810419,632221,1053702,"JPN",842962
1,336.0,"Southern Africa",104857,0,104857,79797,132996,"ZAF",106397
1,336.0,"South-Eastern Asia",810527,0,810527,632428,1054047,"IDN",843238
1,336.0,"Caribbean",157900,0,157900,124185,206975,"CUB",165580
1,337.0,"Pakistan",1648487,1632017,16470,1163534,1939223,"PAK",1551379
1,337.0,"India",5755878,5739357,16521,4108544,6847573,"IND",5478059
1,337.0,"Western Europe",3619796,3563878,55918,2607523,4345872,"NLD",3476698
1,337.0,"China",9046452,8884819,161633,6007915,10013192,"CPR",8010554
1,337.0,"United States of America",2573770,2570871,2899,1815236,3025393,"USA",2420315
1,337.0,"Northern Africa",1185934,0,1185934,736623,1227706,"EGY",982165
1,337.0,"Russian Federation",2633034,2585379,47655,2434441,4057402,"RUS",3245922
1,337.0,"Western Africa",363664,0,363664,254452,424087,"NGA",339270
1,337.0,"South America",1748336,1492924,255412,1326645,2211075,"BRA",1768860
1,337.0,"Northern Europe",1977243,1954398,22845,1403837,2339728,"GBR",1871783
1,337.0,"Northern America",605019,596797,8222,516565,860942,"CAN",688754
1,337.0,"Oceania",527534,477024,50510,384338,640563,"NZL",512451
1,337.0,"Eastern Africa",298083,0,298083,152082,253471,"ETH",202777
1,337.0,"Middle Africa",96246,0,96246,69061,115102,"AGO",92082
1,337.0,"Eastern Europe",3168489,2344481,824008,2320617,3867696,"POL",3094157
1,337.0,"Central Asia",1422198,1388807,33391,972766,1621277,"UZB",1297022
1,337.0,"Southern Europe",856844,0,856844,479268,798780,"ITA",639024
1,337.0,"Central America",336446,0,336446,244388,407313,"MEX",325851
1,337.0,"Southern Asia",535335,0,535335,73128,121880,"IRN",97504
1,337.0,"Western Asia",1006030,0,1006030,510276,850461,"IRQ",680369
1,337.0,"Eastern Asia",778490,0,778490,549060,915100,"JPN",732080
1,337.0,"Southern Africa",104339,0,104339,70762,117937,"ZAF",94350
1,337.0,"South-Eastern Asia",793523,0,793523,692538,1154230,"IDN",923384
1,337.0,"Caribbean",152379,0,152379,106587,177645,"CUB",142116
1,338.0,"Pakistan",1651240,1639233,12007,1163534,1939223,"PAK",1551379
1,338.0,"India",5787141,5775182,11959,4108544,6847573,"IND",5478059
1,338.0,"Western Europe",3548289,3518925,29364,2607523,4345872,"NLD",3476698
1,338.0,"China",8998394,8910503,87891,6007915,10013192,"CPR",8010554
1,338.0,"United States of America",2737718,2734990,2728,1815236,3025393,"USA",2420315
1,338.0,"Northern Africa",1173625,0,1173625,736623,1227706,"EGY",982165
1,338.0,"Russian Federation",2575184,2548649,26535,2434441,4057402,"RUS",3245922
1,338.0,"Western Africa",361881,0,361881,254452,424087,"NGA",339270
1,338.0,"South America",1834279,1507940,326339,1326645,2211075,"BRA",1768860
1,338.0,"Northern Europe",1988493,1971274,17219,1403837,2339728,"GBR",1871783
1,338.0,"Northern America",615745,610620,5125,516565,860942,"CAN",688754
1,338.0,"Oceania",693781,667321,26460,384338,640563,"NZL",512451
1,338.0,"Eastern Africa",318686,0,318686,152082,253471,"ETH",202777
1,338.0,"Middle Africa",103795,0,103795,69061,115102,"AGO",92082
1,338.0,"Eastern Europe",3191237,2403937,787300,2320617,3867696,"POL",3094157
1,338.0,"Central Asia",1302207,1286809,15398,972766,1621277,"UZB",1297022
1,338.0,"Southern Europe",864178,0,864178,479268,798780,"ITA",639024
1,338.0,"Central America",352086,0,352086,244388,407313,"MEX",325851
1,338.0,"Southern Asia",535799,0,535799,73128,121880,"IRN",97504
1,338.0,"Western Asia",1003536,0,1003536,510276,850461,"IRQ",680369
1,338.0,"Eastern Asia",819157,0,819157,549060,915100,"JPN",732080
1,338.0,"Southern Africa",113194,0,113194,70762,117937,"ZAF",94350
1,338.0,"South-Eastern Asia",969584,0,969584,692538,1154230,"IDN",923384
1,338.0,"Caribbean",159197,0,159197,106587,177645,"CUB",142116
1,339.0,"Pakistan",1671196,1651727,19469,1163534,1939223,"PAK",1551379
1,339.0,"India",5873382,5853026,20356,4108544,6847573,"IND",5478059
1,339.0,"Western Europe",3640923,3601896,39027,2607523,4345872,"NLD",3476698
1,339.0,"China",9040983,8967320,73663,6007915,10013192,"CPR",8010554
1,339.0,"United States of America",2733009,2723757,9252,1815236,3025393,"USA",2420315
1,339.0,"Northern Africa",1123818,0,1123818,736623,1227706,"EGY",982165
1,339.0,"Russian Federation",2791717,2754618,37099,2434441,4057402,"RUS",3245922
1,339.0,"Western Africa",372445,0,372445,254452,424087,"NGA",339270
1,339.0,"South America",1909827,1508102,401725,1326645,2211075,"BRA",1768860
1,339.0,"Northern Europe",2020240,1995520,24720,1403837,2339728,"GBR",1871783
1,339.0,"Northern America",723027,707244,15783,516565,860942,"CAN",688754
1,339.0,"Oceania",566275,555186,11089,384338,640563,"NZL",512451
1,339.0,"Eastern Africa",266780,0,266780,152082,253471,"ETH",202777
1,339.0,"Middle Africa",100840,0,100840,69061,115102,"AGO",92082
1,339.0,"Eastern Europe",2972105,2314825,657280,2320617,3867696,"POL",3094157
1,339.0,"Central Asia",1534500,1490960,43540,972766,1621277,"UZB",1297022
1,339.0,"Southern Europe",796564,0,796564,479268,798780,"ITA",639024
1,339.0,"Central America",366482,0,366482,244388,407313,"MEX",325851
1,339.0,"Southern Asia",319117,0,319117,73128,121880,"IRN",97504
1,339.0,"Western Asia",863306,0,863306,510276,850461,"IRQ",680369
1,339.0,"Eastern Asia",809187,0,809187,549060,915100,"JPN",732080
1,339.0,"Southern Africa",106635,0,106635,70762,117937,"ZAF",94350
1,339.0,"South-Eastern Asia",945000,0,945000,692538,1154230,"IDN",923384
1,339.0,"Caribbean",162907,0,162907,106587,177645,"CUB",142116
1,340.0,"Pakistan",1691752,1657103,34649,1163534,1939223,"PAK",1551379
1,340.0,"India",5916704,5880438,36266,4108544,6847573,"IND",5478059
1,340.0,"Western Europe",3690922,3633823,57099,2607523,4345872,"NLD",3476698
1,340.0,"China",8990939,8913907,77032,6007915,10013192,"CPR",8010554
1,340.0,"United States of America",2707217,2693986,13231,1815236,3025393,"USA",2420315
1,340.0,"Northern Africa",1095857,0,1095857,736623,1227706,"EGY",982165
1,340.0,"Russian Federation",3074761,2965404,109357,2434441,4057402,"RUS",3245922
1,340.0,"Western Africa",372248,0,372248,254452,424087,"NGA",339270
1,340.0,"South America",1965961,1514000,451961,1326645,2211075,"BRA",1768860
1,340.0,"Northern Europe",2034478,1997432,37046,1403837,2339728,"GBR",1871783
1,340.0,"Northern America",708138,690858,17280,516565,860942,"CAN",688754
1,340.0,"Oceania",530828,526300,4528,384338,640563,"NZL",512451
1,340.0,"Eastern Africa",237165,0,237165,152082,253471,"ETH",202777
1,340.0,"Middle Africa",99149,0,99149,69061,115102,"AGO",92082
1,340.0,"Eastern Europe",3135882,2395320,740562,2320617,3867696,"POL",3094157
1,340.0,"Central Asia",1477818,1448849,28969,972766,1621277,"UZB",1297022
1,340.0,"Southern Europe",737845,0,737845,479268,798780,"ITA",639024
1,340.0,"Central America",363362,0,363362,244388,407313,"MEX",325851
1,340.0,"Southern Asia",198529,0,198529,73128,121880,"IRN",97504
1,340.0,"Western Asia",796833,0,796833,510276,850461,"IRQ",680369
1,340.0,"Eastern Asia",808193,0,808193,549060,915100,"JPN",732080
1,340.0,"Southern Africa",103006,0,103006,70762,117937,"ZAF",94350
1,340.0,"South-Eastern Asia",947818,0,947818,692538,1154230,"IDN",923384
1,340.0,"Caribbean",160083,0,160083,106587,177645,"CUB",142116
1,341.0,"Pakistan",1696508,1646464,50044,1163534,1939223,"PAK",1551379
1,341.0,"India",5820656,5765748,54908,4108544,6847573,"IND",5478059
1,341.0,"Western Europe",3774355,3693692,80663,2607523,4345872,"NLD",3476698
1,341.0,"China",8926683,8850060,76623,6007915,10013192,"CPR",8010554
1,341.0,"United States of America",2629262,2614400,14862,1815236,3025393,"USA",2420315
1,341.0,"Northern Africa",1087714,0,1087714,736623,1227706,"EGY",982165
1,341.0,"Russian Federation",3314580,3111896,202684,2434441,4057402,"RUS",3245922
1,341.0,"Western Africa",370566,0,370566,254452,424087,"NGA",339270
1,341.0,"South America",2007419,1513718,493701,1326645,2211075,"BRA",1768860
1,341.0,"Northern Europe",2043305,1993538,49767,1403837,2339728,"GBR",1871783
1,341.0,"Northern America",735802,708413,27389,516565,860942,"CAN",688754
1,341.0,"Oceania",507277,505554,1723,384338,640563,"NZL",512451
1,341.0,"Eastern Africa",219967,0,219967,152082,253471,"ETH",202777
1,341.0,"Middle Africa",96802,0,96802,69061,115102,"AGO",92082
1,341.0,"Eastern Europe",3251127,2421687,829440,2320617,3867696,"POL",3094157
1,341.0,"Central Asia",1364711,1342671,22040,972766,1621277,"UZB",1297022
1,341.0,"Southern Europe",714739,0,714739,479268,798780,"ITA",639024
1,341.0,"Central America",352015,0,352015,244388,407313,"MEX",325851
1,341.0,"Southern Asia",145557,0,145557,73128,121880,"IRN",97504
1,341.0,"Western Asia",766983,0,766983,510276,850461,"IRQ",680369
1,341.0,"Eastern Asia",796480,0,796480,549060,915100,"JPN",732080
1,341.0,"Southern Africa",99363,0,99363,70762,117937,"ZAF",94350
1,341.0,"South-Eastern Asia",933476,0,933476,692538,1154230,"IDN",923384
1,341.0,"Caribbean",154117,0,154117,106587,177645,"CUB",142116
1,342.0,"Pakistan",1653657,1592837,60820,1163534,1939223,"PAK",1551379
1,342.0,"India",5893343,5812525,80818,4108544,6847573,"IND",5478059
1,342.0,"Western Europe",3844720,3747858,96862,2607523,4345872,"NLD",3476698
1,342.0,"China",8832590,8761388,71202,6007915,10013192,"CPR",8010554
1,342.0,"United States of America",2552308,2538868,13440,1815236,3025393,"USA",2420315
1,342.0,"Northern Africa",1078854,0,1078854,736623,1227706,"EGY",982165
1,342.0,"Russian Federation",3482817,3187920,294897,2434441,4057402,"RUS",3245922
1,342.0,"Western Africa",363603,0,363603,254452,424087,"NGA",339270
1,342.0,"South America",2000750,1510045,490705,1326645,2211075,"BRA",1768860
1,342.0,"Northern Europe",2040505,1982335,58170,1403837,2339728,"GBR",1871783
1,342.0,"Northern America",754670,726647,28023,516565,860942,"CAN",688754
1,342.0,"Oceania",483659,483040,619,384338,640563,"NZL",512451
1,342.0,"Eastern Africa",207909,0,207909,152082,253471,"ETH",202777
1,342.0,"Middle Africa",93503,0,93503,69061,115102,"AGO",92082
1,342.0,"Eastern Europe",3380740,2465670,915070,2320617,3867696,"POL",3094157
1,342.0,"Central Asia",1321507,1302533,18974,972766,1621277,"UZB",1297022
1,342.0,"Southern Europe",698081,0,698081,479268,798780,"ITA",639024
1,342.0,"Central America",339460,0,339460,244388,407313,"MEX",325851
1,342.0,"Southern Asia",121434,0,121434,73128,121880,"IRN",97504
1,342.0,"Western Asia",749625,0,749625,510276,850461,"IRQ",680369
1,342.0,"Eastern Asia",777348,0,777348,549060,915100,"JPN",732080
1,342.0,"Southern Africa",95179,0,95179,70762,117937,"ZAF",94350
1,342.0,"South-Eastern Asia",902209,0,902209,692538,1154230,"IDN",923384
1,342.0,"Caribbean",147746,0,147746,106587,177645,"CUB",142116
1,343.0,"Pakistan",1705229,1625079,80150,1163534,1939223,"PAK",1551379
1,343.0,"India",5936295,5830041,106254,4108544,6847573,"IND",5478059
1,343.0,"Western Europe",3813074,3733535,79539,2607523,4345872,"NLD",3476698
1,343.0,"China",8459554,8435008,24546,6007915,10013192,"CPR",8010554
1,343.0,"United States of America",2515430,2509944,5486,1815236,3025393,"USA",2420315
1,343.0,"Northern Africa",1061803,0,1061803,736623,1227706,"EGY",982165
1,343.0,"Russian Federation",3606731,3227338,379393,2434441,4057402,"RUS",3245922
1,343.0,"Western Africa",362590,0,362590,254452,424087,"NGA",339270
1,343.0,"South America",1979856,1506962,472894,1326645,2211075,"BRA",1768860
1,343.0,"Northern Europe",2019283,1974658,44625,1403837,2339728,"GBR",1871783
1,343.0,"Northern America",713866,703946,9920,516565,860942,"CAN",688754
1,343.0,"Oceania",530080,524119,5961,384338,640563,"NZL",512451
1,343.0,"Eastern Africa",215564,0,215564,152082,253471,"ETH",202777
1,343.0,"Middle Africa",97437,0,97437,69061,115102,"AGO",92082
1,343.0,"Eastern Europe",3464883,2497680,967203,2320617,3867696,"POL",3094157
1,343.0,"Central Asia",1383595,1365327,18268,972766,1621277,"UZB",1297022
1,343.0,"Southern Europe",678347,0,678347,479268,798780,"ITA",639024
1,343.0,"Central America",339047,0,339047,244388,407313,"MEX",325851
1,343.0,"Southern Asia",110623,0,110623,73128,121880,"IRN",97504
1,343.0,"Western Asia",737322,0,737322,510276,850461,"IRQ",680369
1,343.0,"Eastern Asia",770348,0,770348,549060,915100,"JPN",732080
1,343.0,"Southern Africa",99799,0,99799,70762,117937,"ZAF",94350
1,343.0,"South-Eastern Asia",961166,0,961166,692538,1154230,"IDN",923384
1,343.0,"Caribbean",148078,0,148078,106587,177645,"CUB",142116
1,344.0,"Pakistan",1583763,1539540,44223,1163534,1939223,"PAK",1551379
1,344.0,"India",5752884,5638844,114040,4108544,6847573,"IND",5478059
1,344.0,"Western Europe",3507516,3483503,24013,2607523,4345872,"NLD",3476698
1,344.0,"China",7724912,7717523,7389,6007915,10013192,"CPR",8010554
1,344.0,"United States of America",2389968,2388245,1723,1815236,3025393,"USA",2420315
1,344.0,"Northern Africa",985741,0,985741,736623,1227706,"EGY",982165
1,344.0,"Russian Federation",3654169,3242400,411769,2434441,4057402,"RUS",3245922
1,344.0,"Western Africa",339265,0,339265,254452,424087,"NGA",339270
1,344.0,"South America",1822147,1488903,333244,1326645,2211075,"BRA",1768860
1,344.0,"Northern Europe",1899383,1879399,19984,1403837,2339728,"GBR",1871783
1,344.0,"Northern America",679405,676383,3022,516565,860942,"CAN",688754
1,344.0,"Oceania",505201,503354,1847,384338,640563,"NZL",512451
1,344.0,"Eastern Africa",202187,0,202187,152082,253471,"ETH",202777
1,344.0,"Middle Africa",91634,0,91634,69061,115102,"AGO",92082
1,344.0,"Eastern Europe",3314920,2398931,915989,2320617,3867696,"POL",3094157
1,344.0,"Central Asia",1295720,1290316,5404,972766,1621277,"UZB",1297022
1,344.0,"Southern Europe",636780,0,636780,479268,798780,"ITA",639024
1,344.0,"Central America",321838,0,321838,244388,407313,"MEX",325851
1,344.0,"Southern Asia",100750,0,100750,73128,121880,"IRN",97504
1,344.0,"Western Asia",687782,0,687782,510276,850461,"IRQ",680369
1,344.0,"Eastern Asia",726021,0,726021,549060,915100,"JPN",732080
1,344.0,"Southern Africa",93894,0,93894,70762,117937,"ZAF",94350
1,344.0,"South-Eastern Asia",911186,0,911186,692538,1154230,"IDN",923384
1,344.0,"Caribbean",140472,0,140472,106587,177645,"CUB",142116
1,345.0,"Pakistan",1567491,1551932,15559,1163534,1939223,"PAK",1551379
1,345.0,"India",5590243,5550994,39249,4108544,6847573,"IND",5478059
1,345.0,"Western Europe",3497514,3488062,9452,2607523,4345872,"NLD",3476698
1,345.0,"China",8023439,8008439,15000,6007915,10013192,"CPR",8010554
1,345.0,"United States of America",2416649,2416098,551,1815236,3025393,"USA",2420315
1,345.0,"Northern Africa",986232,0,986232,736623,1227706,"EGY",982165
1,345.0,"Russian Federation",3399728,3211750,187978,2434441,4057402,"RUS",3245922
1,345.0,"Western Africa",340239,0,340239,254452,424087,"NGA",339270
1,345.0,"South America",1725045,1510543,214502,1326645,2211075,"BRA",1768860
1,345.0,"Northern Europe",1886807,1879875,6932,1403837,2339728,"GBR",1871783
1,345.0,"Northern America",687474,686412,1062,516565,860942,"CAN",688754
1,345.0,"Oceania",511415,510746,669,384338,640563,"NZL",512451
1,345.0,"Eastern Africa",203224,0,203224,152082,253471,"ETH",202777
1,345.0,"Middle Africa",92272,0,92272,69061,115102,"AGO",92082
1,345.0,"Eastern Europe",3183672,2495194,688478,2320617,3867696,"POL",3094157
1,345.0,"Central Asia",1300341,1298411,1930,972766,1621277,"UZB",1297022
1,345.0,"Southern Europe",640074,0,640074,479268,798780,"ITA",639024
1,345.0,"Central America",325384,0,325384,244388,407313,"MEX",325851
1,345.0,"Southern Asia",98962,0,98962,73128,121880,"IRN",97504
1,345.0,"Western Asia",684907,0,684907,510276,850461,"IRQ",680369
1,345.0,"Eastern Asia",733112,0,733112,549060,915100,"JPN",732080
1,345.0,"Southern Africa",94456,0,94456,70762,117937,"ZAF",94350
1,345.0,"South-Eastern Asia",923125,0,923125,692538,1154230,"IDN",923384
1,345.0,"Caribbean",141895,0,141895,106587,177645,"CUB",142116
1,346.0,"Pakistan",1512385,1507193,5192,1163534,1939223,"PAK",1551379
1,346.0,"India",5358987,5345864,13123,4108544,6847573,"IND",5478059
1,346.0,"Western Europe",3384179,3379995,4184,2607523,4345872,"NLD",3476698
1,346.0,"China",7921304,7908008,13296,6007915,10013192,"CPR",8010554
1,346.0,"United States of America",2349800,2349616,184,1815236,3025393,"USA",2420315
1,346.0,"Northern Africa",951665,0,951665,736623,1227706,"EGY",982165
1,346.0,"Russian Federation",3204682,3143439,61243,2434441,4057402,"RUS",3245922
1,346.0,"Western Africa",328523,0,328523,254452,424087,"NGA",339270
1,346.0,"South America",1737454,1513849,223605,1326645,2211075,"BRA",1768860
1,346.0,"Northern Europe",1823235,1820927,2308,1403837,2339728,"GBR",1871783
1,346.0,"Northern America",668506,668251,255,516565,860942,"CAN",688754
1,346.0,"Oceania",497337,497208,129,384338,640563,"NZL",512451
1,346.0,"Eastern Africa",194031,0,194031,152082,253471,"ETH",202777
1,346.0,"Middle Africa",88957,0,88957,69061,115102,"AGO",92082
1,346.0,"Eastern Europe",3034454,2572385,462069,2320617,3867696,"POL",3094157
1,346.0,"Central Asia",1190313,1189791,522,972766,1621277,"UZB",1297022
1,346.0,"Southern Europe",618368,0,618368,479268,798780,"ITA",639024
1,346.0,"Central America",316326,0,316326,244388,407313,"MEX",325851
1,346.0,"Southern Asia",94127,0,94127,73128,121880,"IRN",97504
1,346.0,"Western Asia",656501,0,656501,510276,850461,"IRQ",680369
1,346.0,"Eastern Asia",707686,0,707686,549060,915100,"JPN",732080
1,346.0,"Southern Africa",90566,0,90566,70762,117937,"ZAF",94350
1,346.0,"South-Eastern Asia",896170,0,896170,692538,1154230,"IDN",923384
1,346.0,"Caribbean",137963,0,137963,106587,177645,"CUB",142116
1,347.0,"Pakistan",1577956,1575988,1968,1163534,1939223,"PAK",1551379
1,347.0,"India",5578857,5573919,4938,4108544,6847573,"IND",5478059
1,347.0,"Western Europe",3534296,3531747,2549,2607523,4345872,"NLD",3476698
1,347.0,"China",8072271,8067204,5067,6007915,10013192,"CPR",8010554
1,347.0,"United States of America",2458098,2458098,0,1815236,3025393,"USA",2420315
1,347.0,"Northern Africa",1000675,0,1000675,736623,1227706,"EGY",982165
1,347.0,"Russian Federation",3317083,3293554,23529,2434441,4057402,"RUS",3245922
1,347.0,"Western Africa",345651,0,345651,254452,424087,"NGA",339270
1,347.0,"South America",1739808,1514457,225351,1326645,2211075,"BRA",1768860
1,347.0,"Northern Europe",1903175,1902420,755,1403837,2339728,"GBR",1871783
1,347.0,"Northern America",699454,699349,105,516565,860942,"CAN",688754
1,347.0,"Oceania",520336,520336,0,384338,640563,"NZL",512451
1,347.0,"Eastern Africa",208059,0,208059,152082,253471,"ETH",202777
1,347.0,"Middle Africa",93915,0,93915,69061,115102,"AGO",92082
1,347.0,"Eastern Europe",3156044,2840526,315518,2320617,3867696,"POL",3094157
1,347.0,"Central Asia",1364308,1322236,42072,972766,1621277,"UZB",1297022
1,347.0,"Southern Europe",651047,0,651047,479268,798780,"ITA",639024
1,347.0,"Central America",331069,0,331069,244388,407313,"MEX",325851
1,347.0,"Southern Asia",99934,0,99934,73128,121880,"IRN",97504
1,347.0,"Western Asia",695573,0,695573,510276,850461,"IRQ",680369
1,347.0,"Eastern Asia",745771,0,745771,549060,915100,"JPN",732080
1,347.0,"Southern Africa",96595,0,96595,70762,117937,"ZAF",94350
1,347.0,"South-Eastern Asia",938485,0,938485,692538,1154230,"IDN",923384
1,347.0,"Caribbean",144333,0,144333,106587,177645,"CUB",142116
1,348.0,"Pakistan",1587408,1586797,611,1163541,1939235,"PAK",1551388
1,348.0,"India",5607798,5606266,1532,4108551,6847586,"IND",5478069
1,348.0,"Western Europe",3556724,3554971,1753,2607528,4345880,"NLD",3476704
1,348.0,"China",8079310,8073330,5980,6007921,10013202,"CPR",8010562
1,348.0,"United States of America",2475343,2475343,0,1815241,3025402,"USA",2420322
1,348.0,"Northern Africa",1005066,0,1005066,736630,1227717,"EGY",982174
1,348.0,"Russian Federation",3326914,3318757,8157,2434449,4057415,"RUS",3245932
1,348.0,"Western Africa",347157,0,347157,254459,424098,"NGA",339279
1,348.0,"South America",1777711,1514297,263414,1326659,2211098,"BRA",1768879
1,348.0,"Northern Europe",1887821,1887821,0,1403841,2339735,"GBR",1871788
1,348.0,"Northern America",704365,704365,0,516571,860952,"CAN",688762
1,348.0,"Oceania",524070,524070,0,384344,640573,"NZL",512459
1,348.0,"Eastern Africa",208035,0,208035,152082,253470,"ETH",202776
1,348.0,"Middle Africa",94246,0,94246,69074,115123,"AGO",92099
1,348.0,"Eastern Europe",3168302,2916430,251872,2320633,3867722,"POL",3094178
1,348.0,"Central Asia",1343151,1327279,15872,972774,1621290,"UZB",1297032
1,348.0,"Southern Europe",652892,0,652892,479265,798776,"ITA",639021
1,348.0,"Central America",333308,0,333308,244389,407316,"MEX",325853
1,348.0,"Southern Asia",99956,0,99956,73128,121880,"IRN",97504
1,348.0,"Western Asia",697183,0,697183,510276,850461,"IRQ",680369
1,348.0,"Eastern Asia",748921,0,748921,549076,915127,"JPN",732102
1,348.0,"Southern Africa",96694,0,96694,70757,117928,"ZAF",94343
1,348.0,"South-Eastern Asia",944385,0,944385,692551,1154252,"IDN",923402
1,348.0,"Caribbean",145355,0,145355,106596,177661,"CUB",142129
1,349.0,"Pakistan",1532510,1532396,114,1188552,1980921,"PAK",1584737
1,349.0,"India",5412478,5412031,447,4096593,6827656,"IND",5462125
1,349.0,"Western Europe",3434321,3433783,538,2887638,4812731,"NLD",3850185
1,349.0,"China",8081303,8067831,13472,5915516,9859193,"CPR",7887355
1,349.0,"United States of America",2390612,2390612,0,1768298,2947163,"USA",2357731
1,349.0,"Northern Africa",970763,0,970763,834553,1390922,"EGY",1112738
1,349.0,"Russian Federation",3208252,3205805,2447,2123415,3539025,"RUS",2831220
1,349.0,"Western Africa",335376,0,335376,284417,474028,"NGA",379223
1,349.0,"South America",1844860,1549764,295096,1322376,2203961,"BRA",1763169
1,349.0,"Northern Europe",1866718,1864476,2242,1429562,2382603,"GBR",1906083
1,349.0,"Northern America",680295,680295,0,457278,762130,"CAN",609704
1,349.0,"Oceania",506160,506160,0,427065,711776,"NZL",569421
1,349.0,"Eastern Africa",200519,0,200519,154500,257500,"ETH",206000
1,349.0,"Middle Africa",91015,0,91015,70772,117953,"AGO",94363
1,349.0,"Eastern Europe",3058423,2880002,178421,2184942,3641570,"POL",2913256
1,349.0,"Central Asia",1286679,1280048,6631,1075254,1792091,"UZB",1433673
1,349.0,"Southern Europe",632231,0,632231,706650,1177751,"ITA",942201
1,349.0,"Central America",321844,0,321844,233764,389607,"MEX",311686
1,349.0,"Southern Asia",96393,0,96393,93939,156565,"IRN",125252
1,349.0,"Western Asia",672730,0,672730,427140,711900,"IRQ",569520
1,349.0,"Eastern Asia",724542,0,724542,545734,909557,"JPN",727646
1,349.0,"Southern Africa",93367,0,93367,69290,115483,"ZAF",92387
1,349.0,"South-Eastern Asia",912597,0,912597,637875,1063125,"IDN",850500
1,349.0,"Caribbean",140380,0,140380,118990,198317,"CUB",158654
1,350.0,"Pakistan",1526969,1526969,0,1188552,1980921,"PAK",1584737
1,350.0,"India",5392212,5392212,0,4096593,6827656,"IND",5462125
1,350.0,"Western Europe",3422049,3421513,536,2887638,4812731,"NLD",3850185
1,350.0,"China",7942626,7938081,4545,5915516,9859193,"CPR",7887355
1,350.0,"United States of America",2382202,2382202,0,1768298,2947163,"USA",2357731
1,350.0,"Northern Africa",966927,0,966927,834553,1390922,"EGY",1112738
1,350.0,"Russian Federation",3195384,3194709,675,2123415,3539025,"RUS",2831220
1,350.0,"Western Africa",333931,0,333931,284417,474028,"NGA",379223
1,350.0,"South America",1774704,1601287,173417,1322376,2203961,"BRA",1763169
1,350.0,"Northern Europe",1848427,1847707,720,1429562,2382603,"GBR",1906083
1,350.0,"Northern America",677904,677904,0,457278,762130,"CAN",609704
1,350.0,"Oceania",504381,504381,0,427065,711776,"NZL",569421
1,350.0,"Eastern Africa",199664,0,199664,154500,257500,"ETH",206000
1,350.0,"Middle Africa",90665,0,90665,70772,117953,"AGO",94363
1,350.0,"Eastern Europe",3046133,2875668,170465,2184942,3641570,"POL",2913256
1,350.0,"Central Asia",1278317,1274836,3481,1075254,1792091,"UZB",1433673
1,350.0,"Southern Europe",629317,0,629317,706650,1177751,"ITA",942201
1,350.0,"Central America",320711,0,320711,233764,389607,"MEX",311686
1,350.0,"Southern Asia",95996,0,95996,93939,156565,"IRN",125252
1,350.0,"Western Asia",669898,0,669898,427140,711900,"IRQ",569520
1,350.0,"Eastern Asia",721061,0,721061,545734,909557,"JPN",727646
1,350.0,"Southern Africa",92823,0,92823,69290,115483,"ZAF",92387
1,350.0,"South-Eastern Asia",909042,0,909042,637875,1063125,"IDN",850500
1,350.0,"Caribbean",139884,0,139884,118990,198317,"CUB",158654
1,351.0,"Pakistan",1509471,1509471,0,1188552,1980921,"PAK",1584737
1,351.0,"India",5247174,5247174,0,4096593,6827656,"IND",5462125
1,351.0,"Western Europe",3492999,3492442,557,2887638,4812731,"NLD",3850185
1,351.0,"China",7630559,7629126,1433,5915516,9859193,"CPR",7887355
1,351.0,"United States of America",2283741,2283741,0,1768298,2947163,"USA",2357731
1,351.0,"Northern Africa",1007258,0,1007258,834553,1390922,"EGY",1112738
1,351.0,"Russian Federation",2857282,2857282,0,2123415,3539025,"RUS",2831220
1,351.0,"Western Africa",346389,0,346389,284417,474028,"NGA",379223
1,351.0,"South America",1705427,1646137,59290,1322376,2203961,"BRA",1763169
1,351.0,"Northern Europe",1819538,1819378,160,1429562,2382603,"GBR",1906083
1,351.0,"Northern America",611890,611890,0,457278,762130,"CAN",609704
1,351.0,"Oceania",527101,527101,0,427065,711776,"NZL",569421
1,351.0,"Eastern Africa",196539,0,196539,154500,257500,"ETH",206000
1,351.0,"Middle Africa",89040,0,89040,70772,117953,"AGO",94363
1,351.0,"Eastern Europe",2854275,2699500,154775,2184942,3641570,"POL",2913256
1,351.0,"Central Asia",1329884,1327414,2470,1075254,1792091,"UZB",1433673
1,351.0,"Southern Europe",796138,0,796138,706650,1177751,"ITA",942201
1,351.0,"Central America",303904,0,303904,233764,389607,"MEX",311686
1,351.0,"Southern Asia",110795,0,110795,93939,156565,"IRN",125252
1,351.0,"Western Asia",581200,0,581200,427140,711900,"IRQ",569520
1,351.0,"Eastern Asia",699948,0,699948,545734,909557,"JPN",727646
1,351.0,"Southern Africa",89352,0,89352,69290,115483,"ZAF",92387
1,351.0,"South-Eastern Asia",840813,0,840813,637875,1063125,"IDN",850500
1,351.0,"Caribbean",146618,0,146618,118990,198317,"CUB",158654
1,352.0,"Pakistan",1528029,1528029,0,1188552,1980921,"PAK",1584737
1,352.0,"India",5380695,5380695,0,4096593,6827656,"IND",5462125
1,352.0,"Western Europe",3699258,3693241,6017,2887638,4812731,"NLD",3850185
1,352.0,"China",7789889,7789532,357,5915516,9859193,"CPR",7887355
1,352.0,"United States of America",2329698,2329698,0,1768298,2947163,"USA",2357731
1,352.0,"Northern Africa",1057943,0,1057943,834553,1390922,"EGY",1112738
1,352.0,"Russian Federation",2841094,2841094,0,2123415,3539025,"RUS",2831220
1,352.0,"Western Africa",360669,0,360669,284417,474028,"NGA",379223
1,352.0,"South America",1741319,1718369,22950,1322376,2203961,"BRA",1763169
1,352.0,"Northern Europe",1873222,1873222,0,1429562,2382603,"GBR",1906083
1,352.0,"Northern America",610535,610535,0,457278,762130,"CAN",609704
1,352.0,"Oceania",553354,553354,0,427065,711776,"NZL",569421
1,352.0,"Eastern Africa",196422,0,196422,154500,257500,"ETH",206000
1,352.0,"Middle Africa",90533,0,90533,70772,117953,"AGO",94363
1,352.0,"Eastern Europe",2764518,2690358,74160,2184942,3641570,"POL",2913256
1,352.0,"Central Asia",1339587,1337299,2288,1075254,1792091,"UZB",1433673
1,352.0,"Southern Europe",873644,0,873644,706650,1177751,"ITA",942201
1,352.0,"Central America",308722,0,308722,233764,389607,"MEX",311686
1,352.0,"Southern Asia",117674,0,117674,93939,156565,"IRN",125252
1,352.0,"Western Asia",560906,0,560906,427140,711900,"IRQ",569520
1,352.0,"Eastern Asia",714207,0,714207,545734,909557,"JPN",727646
1,352.0,"Southern Africa",89984,0,89984,69290,115483,"ZAF",92387
1,352.0,"South-Eastern Asia",846637,0,846637,637875,1063125,"IDN",850500
1,352.0,"Caribbean",154061,0,154061,118990,198317,"CUB",158654
1,353.0,"Pakistan",1529404,1525170,4234,1188552,1980921,"PAK",1584737
1,353.0,"India",5529631,5529631,0,4096593,6827656,"IND",5462125
1,353.0,"Western Europe",3697350,3687921,9429,2887638,4812731,"NLD",3850185
1,353.0,"China",7945072,7945072,0,5915516,9859193,"CPR",7887355
1,353.0,"United States of America",2389612,2389612,0,1768298,2947163,"USA",2357731
1,353.0,"Northern Africa",1079982,0,1079982,834553,1390922,"EGY",1112738
1,353.0,"Russian Federation",2886299,2886299,0,2123415,3539025,"RUS",2831220
1,353.0,"Western Africa",370426,0,370426,284417,474028,"NGA",379223
1,353.0,"South America",1786390,1777754,8636,1322376,2203961,"BRA",1763169
1,353.0,"Northern Europe",1796471,1796471,0,1429562,2382603,"GBR",1906083
1,353.0,"Northern America",621065,621065,0,457278,762130,"CAN",609704
1,353.0,"Oceania",573624,573523,101,427065,711776,"NZL",569421
1,353.0,"Eastern Africa",205222,0,205222,154500,257500,"ETH",206000
1,353.0,"Middle Africa",93676,0,93676,70772,117953,"AGO",94363
1,353.0,"Eastern Europe",2938878,2843755,95123,2184942,3641570,"POL",2913256
1,353.0,"Central Asia",1401295,1381676,19619,1075254,1792091,"UZB",1433673
1,353.0,"Southern Europe",912591,0,912591,706650,1177751,"ITA",942201
1,353.0,"Central America",316180,0,316180,233764,389607,"MEX",311686
1,353.0,"Southern Asia",121812,0,121812,93939,156565,"IRN",125252
1,353.0,"Western Asia",569670,0,569670,427140,711900,"IRQ",569520
1,353.0,"Eastern Asia",735734,0,735734,545734,909557,"JPN",727646
1,353.0,"Southern Africa",92112,0,92112,69290,115483,"ZAF",92387
1,353.0,"South-Eastern Asia",864376,0,864376,637875,1063125,"IDN",850500
1,353.0,"Caribbean",159744,0,159744,118990,198317,"CUB",158654
1,354.0,"Pakistan",1543781,1516324,27457,1188552,1980921,"PAK",1584737
1,354.0,"India",5291752,5291752,0,4096593,6827656,"IND",5462125
1,354.0,"Western Europe",3788504,3751484,37020,2887638,4812731,"NLD",3850185
1,354.0,"China",7672938,7672938,0,5915516,9859193,"CPR",7887355
1,354.0,"United States of America",2285163,2285163,0,1768298,2947163,"USA",2357731
1,354.0,"Northern Africa",1097662,0,1097662,834553,1390922,"EGY",1112738
1,354.0,"Russian Federation",2750035,2750035,0,2123415,3539025,"RUS",2831220
1,354.0,"Western Africa",374278,0,374278,284417,474028,"NGA",379223
1,354.0,"South America",1708501,1705645,2856,1322376,2203961,"BRA",1763169
1,354.0,"Northern Europe",1926702,1897237,29465,1429562,2382603,"GBR",1906083
1,354.0,"Northern America",592050,592050,0,457278,762130,"CAN",609704
1,354.0,"Oceania",550623,550623,0,427065,711776,"NZL",569421
1,354.0,"Eastern Africa",203225,0,203225,154500,257500,"ETH",206000
1,354.0,"Middle Africa",93060,0,93060,70772,117953,"AGO",94363
1,354.0,"Eastern Europe",2889449,2833851,55598,2184942,3641570,"POL",2913256
1,354.0,"Central Asia",1433692,1394176,39516,1075254,1792091,"UZB",1433673
1,354.0,"Southern Europe",926060,0,926060,706650,1177751,"ITA",942201
1,354.0,"Central America",302209,0,302209,233764,389607,"MEX",311686
1,354.0,"Southern Asia",121981,0,121981,93939,156565,"IRN",125252
1,354.0,"Western Asia",565073,0,565073,427140,711900,"IRQ",569520
1,354.0,"Eastern Asia",707313,0,707313,545734,909557,"JPN",727646
1,354.0,"Southern Africa",90368,0,90368,69290,115483,"ZAF",92387
1,354.0,"South-Eastern Asia",825218,0,825218,637875,1063125,"IDN",850500
1,354.0,"Caribbean",153409,0,153409,118990,198317,"CUB",158654
1,355.0,"Pakistan",1596983,1560622,36361,1188552,1980921,"PAK",1584737
1,355.0,"India",5312742,5312742,0,4096593,6827656,"IND",5462125
1,355.0,"Western Europe",3884384,3840298,44086,2887638,4812731,"NLD",3850185
1,355.0,"China",7683786,7683786,0,5915516,9859193,"CPR",7887355
1,355.0,"United States of America",2293618,2293618,0,1768298,2947163,"USA",2357731
1,355.0,"Northern Africa",1111023,0,1111023,834553,1390922,"EGY",1112738
1,355.0,"Russian Federation",2756519,2756519,0,2123415,3539025,"RUS",2831220
1,355.0,"Western Africa",375572,0,375572,284417,474028,"NGA",379223
1,355.0,"South America",1715018,1713950,1068,1322376,2203961,"BRA",1763169
1,355.0,"Northern Europe",1861326,1850074,11252,1429562,2382603,"GBR",1906083
1,355.0,"Northern America",593542,593542,0,457278,762130,"CAN",609704
1,355.0,"Oceania",553436,553436,0,427065,711776,"NZL",569421
1,355.0,"Eastern Africa",202370,0,202370,154500,257500,"ETH",206000
1,355.0,"Middle Africa",92773,0,92773,70772,117953,"AGO",94363
1,355.0,"Eastern Europe",2832316,2804119,28197,2184942,3641570,"POL",2913256
1,355.0,"Central Asia",1424410,1391374,33036,1075254,1792091,"UZB",1433673
1,355.0,"Southern Europe",924850,0,924850,706650,1177751,"ITA",942201
1,355.0,"Central America",303250,0,303250,233764,389607,"MEX",311686
1,355.0,"Southern Asia",124249,0,124249,93939,156565,"IRN",125252
1,355.0,"Western Asia",561618,0,561618,427140,711900,"IRQ",569520
1,355.0,"Eastern Asia",708702,0,708702,545734,909557,"JPN",727646
1,355.0,"Southern Africa",90983,0,90983,69290,115483,"ZAF",92387
1,355.0,"South-Eastern Asia",827718,0,827718,637875,1063125,"IDN",850500
1,355.0,"Caribbean",154192,0,154192,118990,198317,"CUB",158654
1,356.0,"Pakistan",1535004,1521086,13918,1188552,1980921,"PAK",1584737
1,356.0,"India",5216938,5216938,0,4096593,6827656,"IND",5462125
1,356.0,"Western Europe",3731265,3714249,17016,2887638,4812731,"NLD",3850185
1,356.0,"China",7537990,7537990,0,5915516,9859193,"CPR",7887355
1,356.0,"United States of America",2252034,2252034,0,1768298,2947163,"USA",2357731
1,356.0,"Northern Africa",1077061,0,1077061,834553,1390922,"EGY",1112738
1,356.0,"Russian Federation",2705180,2705180,0,2123415,3539025,"RUS",2831220
1,356.0,"Western Africa",366918,0,366918,284417,474028,"NGA",379223
1,356.0,"South America",1684002,1683624,378,1322376,2203961,"BRA",1763169
1,356.0,"Northern Europe",1840085,1834723,5362,1429562,2382603,"GBR",1906083
1,356.0,"Northern America",582523,582523,0,457278,762130,"CAN",609704
1,356.0,"Oceania",543691,543691,0,427065,711776,"NZL",569421
1,356.0,"Eastern Africa",198601,0,198601,154500,257500,"ETH",206000
1,356.0,"Middle Africa",91124,0,91124,70772,117953,"AGO",94363
1,356.0,"Eastern Europe",2833791,2805996,27795,2184942,3641570,"POL",2913256
1,356.0,"Central Asia",1376292,1363655,12637,1075254,1792091,"UZB",1433673
1,356.0,"Southern Europe",908783,0,908783,706650,1177751,"ITA",942201
1,356.0,"Central America",297719,0,297719,233764,389607,"MEX",311686
1,356.0,"Southern Asia",120543,0,120543,93939,156565,"IRN",125252
1,356.0,"Western Asia",550081,0,550081,427140,711900,"IRQ",569520
1,356.0,"Eastern Asia",695314,0,695314,545734,909557,"JPN",727646
1,356.0,"Southern Africa",88685,0,88685,69290,115483,"ZAF",92387
1,356.0,"South-Eastern Asia",812500,0,812500,637875,1063125,"IDN",850500
1,356.0,"Caribbean",151476,0,151476,118990,198317,"CUB",158654
1,357.0,"Pakistan",1513399,1507526,5873,1188552,1980921,"PAK",1584737
1,357.0,"India",5359130,5359130,0,4096593,6827656,"IND",5462125
1,357.0,"Western Europe",3800081,3792958,7123,2887638,4812731,"NLD",3850185
1,357.0,"China",7740604,7740604,0,5915516,9859193,"CPR",7887355
1,357.0,"United States of America",2313323,2313323,0,1768298,2947163,"USA",2357731
1,357.0,"Northern Africa",1095283,0,1095283,834553,1390922,"EGY",1112738
1,357.0,"Russian Federation",2778266,2778266,0,2123415,3539025,"RUS",2831220
1,357.0,"Western Africa",373884,0,373884,284417,474028,"NGA",379223
1,357.0,"South America",1729902,1729740,162,1322376,2203961,"BRA",1763169
1,357.0,"Northern Europe",1884251,1881453,2798,1429562,2382603,"GBR",1906083
1,357.0,"Northern America",598269,598269,0,457278,762130,"CAN",609704
1,357.0,"Oceania",558596,558596,0,427065,711776,"NZL",569421
1,357.0,"Eastern Africa",200551,0,200551,154500,257500,"ETH",206000
1,357.0,"Middle Africa",92911,0,92911,70772,117953,"AGO",94363
1,357.0,"Eastern Europe",2879903,2868014,11889,2184942,3641570,"POL",2913256
1,357.0,"Central Asia",1372835,1367454,5381,1075254,1792091,"UZB",1433673
1,357.0,"Southern Europe",927176,0,927176,706650,1177751,"ITA",942201
1,357.0,"Central America",305802,0,305802,233764,389607,"MEX",311686
1,357.0,"Southern Asia",120755,0,120755,93939,156565,"IRN",125252
1,357.0,"Western Asia",557791,0,557791,427140,711900,"IRQ",569520
1,357.0,"Eastern Asia",713748,0,713748,545734,909557,"JPN",727646
1,357.0,"Southern Africa",90031,0,90031,69290,115483,"ZAF",92387
1,357.0,"South-Eastern Asia",834512,0,834512,637875,1063125,"IDN",850500
1,357.0,"Caribbean",155620,0,155620,118990,198317,"CUB",158654
1,358.0,"Pakistan",1569340,1553259,16081,1188552,1980921,"PAK",1584737
1,358.0,"India",5506448,5506448,0,4096593,6827656,"IND",5462125
1,358.0,"Western Europe",3915736,3912468,3268,2887638,4812731,"NLD",3850185
1,358.0,"China",8002803,8002803,0,5915516,9859193,"CPR",7887355
1,358.0,"United States of America",2392005,2392005,0,1768298,2947163,"USA",2357731
1,358.0,"Northern Africa",1131648,0,1131648,834553,1390922,"EGY",1112738
1,358.0,"Russian Federation",2872537,2872537,0,2123415,3539025,"RUS",2831220
1,358.0,"Western Africa",385354,0,385354,284417,474028,"NGA",379223
1,358.0,"South America",1788703,1788703,0,1322376,2203961,"BRA",1763169
1,358.0,"Northern Europe",1927404,1926371,1033,1429562,2382603,"GBR",1906083
1,358.0,"Northern America",618584,618584,0,457278,762130,"CAN",609704
1,358.0,"Oceania",577646,577646,0,427065,711776,"NZL",569421
1,358.0,"Eastern Africa",208890,0,208890,154500,257500,"ETH",206000
1,358.0,"Middle Africa",95943,0,95943,70772,117953,"AGO",94363
1,358.0,"Eastern Europe",2964598,2959713,4885,2184942,3641570,"POL",2913256
1,358.0,"Central Asia",1481941,1465474,16467,1075254,1792091,"UZB",1433673
1,358.0,"Southern Europe",957508,0,957508,706650,1177751,"ITA",942201
1,358.0,"Central America",316210,0,316210,233764,389607,"MEX",311686
1,358.0,"Southern Asia",126052,0,126052,93939,156565,"IRN",125252
1,358.0,"Western Asia",579885,0,579885,427140,711900,"IRQ",569520
1,358.0,"Eastern Asia",738478,0,738478,545734,909557,"JPN",727646
1,358.0,"Southern Africa",93530,0,93530,69290,115483,"ZAF",92387
1,358.0,"South-Eastern Asia",862654,0,862654,637875,1063125,"IDN",850500
1,358.0,"Caribbean",160940,0,160940,118990,198317,"CUB",158654
1,359.0,"Pakistan",1630713,1594603,36110,1188552,1980921,"PAK",1584737
1,359.0,"India",5567504,5567504,0,4096593,6827656,"IND",5462125
1,359.0,"Western Europe",3950390,3949051,1339,2887638,4812731,"NLD",3850185
1,359.0,"China",7984498,7984498,0,5915516,9859193,"CPR",7887355
1,359.0,"United States of America",2416666,2416666,0,1768298,2947163,"USA",2357731
1,359.0,"Northern Africa",1141197,0,1141197,834553,1390922,"EGY",1112738
1,359.0,"Russian Federation",2902059,2902059,0,2123415,3539025,"RUS",2831220
1,359.0,"Western Africa",388627,0,388627,284417,474028,"NGA",379223
1,359.0,"South America",1807205,1807205,0,1322376,2203961,"BRA",1763169
1,359.0,"Northern Europe",1932874,1932113,761,1429562,2382603,"GBR",1906083
1,359.0,"Northern America",624955,624955,0,457278,762130,"CAN",609704
1,359.0,"Oceania",583640,583640,0,427065,711776,"NZL",569421
1,359.0,"Eastern Africa",211387,0,211387,154500,257500,"ETH",206000
1,359.0,"Middle Africa",96800,0,96800,70772,117953,"AGO",94363
1,359.0,"Eastern Europe",2989731,2986598,3133,2184942,3641570,"POL",2913256
1,359.0,"Central Asia",1457962,1451321,6641,1075254,1792091,"UZB",1433673
1,359.0,"Southern Europe",964553,0,964553,706650,1177751,"ITA",942201
1,359.0,"Central America",319476,0,319476,233764,389607,"MEX",311686
1,359.0,"Southern Asia",128578,0,128578,93939,156565,"IRN",125252
1,359.0,"Western Asia",583276,0,583276,427140,711900,"IRQ",569520
1,359.0,"Eastern Asia",740422,0,740422,545734,909557,"JPN",727646
1,359.0,"Southern Africa",94911,0,94911,69290,115483,"ZAF",92387
1,359.0,"South-Eastern Asia",871501,0,871501,637875,1063125,"IDN",850500
1,359.0,"Caribbean",162713,0,162713,118990,198317,"CUB",158654
1,360.0,"Pakistan",1643977,1601877,42100,1188558,1980930,"PAK",1584744
1,360.0,"India",5521653,5521653,0,4096599,6827665,"IND",5462132
1,360.0,"Western Europe",3865294,3865178,116,2887647,4812745,"NLD",3850196
1,360.0,"China",7976373,7976085,288,5915524,9859207,"CPR",7887366
1,360.0,"United States of America",2366280,2366280,0,1768310,2947183,"USA",2357747
1,360.0,"Northern Africa",1119076,0,1119076,834561,1390935,"EGY",1112748
1,360.0,"Russian Federation",2841513,2841513,0,2123417,3539028,"RUS",2831223
1,360.0,"Western Africa",381310,0,381310,284421,474036,"NGA",379229
1,360.0,"South America",1769551,1769551,0,1322386,2203977,"BRA",1763182
1,360.0,"Northern Europe",1935116,1932475,2641,1429575,2382626,"GBR",1906101
1,360.0,"Northern America",611928,611928,0,457292,762153,"CAN",609723
1,360.0,"Oceania",571489,571489,0,427076,711793,"NZL",569435
1,360.0,"Eastern Africa",208556,0,208556,154503,257506,"ETH",206005
1,360.0,"Middle Africa",94869,0,94869,70777,117962,"AGO",94370
1,360.0,"Eastern Europe",2925131,2922846,2285,2184946,3641577,"POL",2913262
1,360.0,"Central Asia",1457467,1450527,6940,1075263,1792106,"UZB",1433685
1,360.0,"Southern Europe",948242,0,948242,706653,1177756,"ITA",942205
1,360.0,"Central America",312826,0,312826,233762,389603,"MEX",311683
1,360.0,"Southern Asia",127997,0,127997,93935,156558,"IRN",125247
1,360.0,"Western Asia",574336,0,574336,427145,711908,"IRQ",569527
1,360.0,"Eastern Asia",733655,0,733655,545744,909573,"JPN",727659
1,360.0,"Southern Africa",93308,0,93308,69290,115483,"ZAF",92387
1,360.0,"South-Eastern Asia",853901,0,853901,637882,1063137,"IDN",850510
1,360.0,"Caribbean",159180,0,159180,119004,198340,"CUB",158672
1,361.0,"Pakistan",1547965,1532313,15652,1202130,2003550,"PAK",1602840
1,361.0,"India",5280396,5280396,0,4214443,7024072,"IND",5619258
1,361.0,"Western Europe",3711720,3711720,0,2903454,4839091,"NLD",3871273
1,361.0,"China",7626111,7626001,110,5908146,9846910,"CPR",7877528
1,361.0,"United States of America",2272697,2272697,0,1714091,2856818,"USA",2285455
1,361.0,"Northern Africa",1073454,0,1073454,888629,1481048,"EGY",1184839
1,361.0,"Russian Federation",2729118,2729118,0,2052978,3421631,"RUS",2737305
1,361.0,"Western Africa",365778,0,365778,302257,503762,"NGA",403010
1,361.0,"South America",1699574,1699574,0,1359385,2265642,"BRA",1812514
1,361.0,"Northern Europe",1845846,1844839,1007,1402336,2337227,"GBR",1869782
1,361.0,"Northern America",587722,587722,0,449856,749761,"CAN",599809
1,361.0,"Oceania",548886,548886,0,457963,763272,"NZL",610618
1,361.0,"Eastern Africa",199270,0,199270,174789,291316,"ETH",233053
1,361.0,"Middle Africa",90950,0,90950,78501,130835,"AGO",104668
1,361.0,"Eastern Europe",2808689,2806670,2019,1970602,3284337,"POL",2627470
1,361.0,"Central Asia",1389073,1386475,2598,1120667,1867778,"UZB",1494223
1,361.0,"Southern Europe",909232,0,909232,553041,921736,"ITA",737389
1,361.0,"Central America",300453,0,300453,202577,337628,"MEX",270103
1,361.0,"Southern Asia",121626,0,121626,185961,309936,"IRN",247949
1,361.0,"Western Asia",550041,0,550041,390099,650165,"IRQ",520132
1,361.0,"Eastern Asia",702703,0,702703,529520,882533,"JPN",706027
1,361.0,"Southern Africa",89285,0,89285,50018,83363,"ZAF",66691
1,361.0,"South-Eastern Asia",819949,0,819949,684884,1141473,"IDN",913179
1,361.0,"Caribbean",152916,0,152916,105745,176242,"CUB",140994
1,362.0,"Pakistan",1594586,1587866,6720,1202130,2003550,"PAK",1602840
1,362.0,"India",5472781,5472781,0,4214443,7024072,"IND",5619258
1,362.0,"Western Europe",3853248,3853248,0,2903454,4839091,"NLD",3871273
1,362.0,"China",7903204,7903204,0,5908146,9846910,"CPR",7877528
1,362.0,"United States of America",2359507,2359507,0,1714091,2856818,"USA",2285455
1,362.0,"Northern Africa",1113936,0,1113936,888629,1481048,"EGY",1184839
1,362.0,"Russian Federation",2833348,2833348,0,2052978,3421631,"RUS",2737305
1,362.0,"Western Africa",379600,0,379600,302257,503762,"NGA",403010
1,362.0,"South America",1764490,1764490,0,1359385,2265642,"BRA",1812514
1,362.0,"Northern Europe",1911073,1910728,345,1402336,2337227,"GBR",1869782
1,362.0,"Northern America",610162,610162,0,449856,749761,"CAN",599809
1,362.0,"Oceania",569844,569844,0,457963,763272,"NZL",610618
1,362.0,"Eastern Africa",206396,0,206396,174789,291316,"ETH",233053
1,362.0,"Middle Africa",94424,0,94424,78501,130835,"AGO",104668
1,362.0,"Eastern Europe",2915608,2914774,834,1970602,3284337,"POL",2627470
1,362.0,"Central Asia",1437796,1436666,1130,1120667,1867778,"UZB",1494223
1,362.0,"Southern Europe",943258,0,943258,553041,921736,"ITA",737389
1,362.0,"Central America",311909,0,311909,202577,337628,"MEX",270103
1,362.0,"Southern Asia",125718,0,125718,185961,309936,"IRN",247949
1,362.0,"Western Asia",570399,0,570399,390099,650165,"IRQ",520132
1,362.0,"Eastern Asia",728752,0,728752,529520,882533,"JPN",706027
1,362.0,"Southern Africa",92543,0,92543,50018,83363,"ZAF",66691
1,362.0,"South-Eastern Asia",851194,0,851194,684884,1141473,"IDN",913179
1,362.0,"Caribbean",158764,0,158764,105745,176242,"CUB",140994
1,363.0,"Pakistan",1568839,1566080,2759,1202130,2003550,"PAK",1602840
1,363.0,"India",5523344,5523344,0,4214443,7024072,"IND",5619258
1,363.0,"Western Europe",3839174,3839174,0,2903454,4839091,"NLD",3871273
1,363.0,"China",7837772,7837772,0,5908146,9846910,"CPR",7877528
1,363.0,"United States of America",2301228,2301228,0,1714091,2856818,"USA",2285455
1,363.0,"Northern Africa",1148190,0,1148190,888629,1481048,"EGY",1184839
1,363.0,"Russian Federation",2759210,2759210,0,2052978,3421631,"RUS",2737305
1,363.0,"Western Africa",390827,0,390827,302257,503762,"NGA",403010
1,363.0,"South America",1781250,1781250,0,1359385,2265642,"BRA",1812514
1,363.0,"Northern Europe",1874782,1874641,141,1402336,2337227,"GBR",1869782
1,363.0,"Northern America",600231,600231,0,449856,749761,"CAN",599809
1,363.0,"Oceania",589978,589978,0,457963,763272,"NZL",610618
1,363.0,"Eastern Africa",219785,0,219785,174789,291316,"ETH",233053
1,363.0,"Middle Africa",99777,0,99777,78501,130835,"AGO",104668
1,363.0,"Eastern Europe",2728833,2728512,321,1970602,3284337,"POL",2627470
1,363.0,"Central Asia",1461422,1461075,347,1120667,1867778,"UZB",1494223
1,363.0,"Southern Europe",817113,0,817113,553041,921736,"ITA",737389
1,363.0,"Central America",285552,0,285552,202577,337628,"MEX",270103
1,363.0,"Southern Asia",195348,0,195348,185961,309936,"IRN",247949
1,363.0,"Western Asia",537397,0,537397,390099,650165,"IRQ",520132
1,363.0,"Eastern Asia",710842,0,710842,529520,882533,"JPN",706027
1,363.0,"Southern Africa",76845,0,76845,50018,83363,"ZAF",66691
1,363.0,"South-Eastern Asia",881923,0,881923,684884,1141473,"IDN",913179
1,363.0,"Caribbean",147326,0,147326,105745,176242,"CUB",140994
1,364.0,"Pakistan",1536644,1534041,2603,1202130,2003550,"PAK",1602840
1,364.0,"India",5328436,5328436,0,4214443,7024072,"IND",5619258
1,364.0,"Western Europe",3684425,3684425,0,2903454,4839091,"NLD",3871273
1,364.0,"China",7507487,7507487,0,5908146,9846910,"CPR",7877528
1,364.0,"United States of America",2188956,2188956,0,1714091,2856818,"USA",2285455
1,364.0,"Northern Africa",1116994,0,1116994,888629,1481048,"EGY",1184839
1,364.0,"Russian Federation",2622925,2622925,0,2052978,3421631,"RUS",2737305
1,364.0,"Western Africa",380039,0,380039,302257,503762,"NGA",403010
1,364.0,"South America",1718574,1718574,0,1359385,2265642,"BRA",1812514
1,364.0,"Northern Europe",1787634,1787634,0,1402336,2337227,"GBR",1869782
1,364.0,"Northern America",573005,573005,0,449856,749761,"CAN",599809
1,364.0,"Oceania",574939,574939,0,457963,763272,"NZL",610618
1,364.0,"Eastern Africa",217959,0,217959,174789,291316,"ETH",233053
1,364.0,"Middle Africa",97894,0,97894,78501,130835,"AGO",104668
1,364.0,"Eastern Europe",2549625,2549500,125,1970602,3284337,"POL",2627470
1,364.0,"Central Asia",1413845,1413845,0,1120667,1867778,"UZB",1494223
1,364.0,"Southern Europe",735943,0,735943,553041,921736,"ITA",737389
1,364.0,"Central America",264112,0,264112,202577,337628,"MEX",270103
1,364.0,"Southern Asia",216662,0,216662,185961,309936,"IRN",247949
1,364.0,"Western Asia",503573,0,503573,390099,650165,"IRQ",520132
1,364.0,"Eastern Asia",676137,0,676137,529520,882533,"JPN",706027
1,364.0,"Southern Africa",67703,0,67703,50018,83363,"ZAF",66691
1,364.0,"South-Eastern Asia",859683,0,859683,684884,1141473,"IDN",913179
1,364.0,"Caribbean",137184,0,137184,105745,176242,"CUB",140994
1,365.0,"Pakistan",1562824,1561783,1041,1202130,2003550,"PAK",1602840
1,365.0,"India",5453618,5453618,0,4214443,7024072,"IND",5619258
1,365.0,"Western Europe",3763090,3763090,0,2903454,4839091,"NLD",3871273
1,365.0,"China",7661879,7661879,0,5908146,9846910,"CPR",7877528
1,365.0,"United States of America",2227657,2227657,0,1714091,2856818,"USA",2285455
1,365.0,"Northern Africa",1146964,0,1146964,888629,1481048,"EGY",1184839
1,365.0,"Russian Federation",2668606,2668606,0,2052978,3421631,"RUS",2737305
1,365.0,"Western Africa",390187,0,390187,302257,503762,"NGA",403010
1,365.0,"South America",1759014,1759014,0,1359385,2265642,"BRA",1812514
1,365.0,"Northern Europe",1821082,1821082,0,1402336,2337227,"GBR",1869782
1,365.0,"Northern America",583977,583977,0,449856,749761,"CAN",599809
1,365.0,"Oceania",590804,590804,0,457963,763272,"NZL",610618
1,365.0,"Eastern Africa",224836,0,224836,174789,291316,"ETH",233053
1,365.0,"Middle Africa",100962,0,100962,78501,130835,"AGO",104668
1,365.0,"Eastern Europe",2575518,2575518,0,1970602,3284337,"POL",2627470
1,365.0,"Central Asia",1448823,1448823,0,1120667,1867778,"UZB",1494223
1,365.0,"Southern Europe",731792,0,731792,553041,921736,"ITA",737389
1,365.0,"Central America",265647,0,265647,202577,337628,"MEX",270103
1,365.0,"Southern Asia",232616,0,232616,185961,309936,"IRN",247949
1,365.0,"Western Asia",509348,0,509348,390099,650165,"IRQ",520132
1,365.0,"Eastern Asia",688078,0,688078,529520,882533,"JPN",706027
1,365.0,"Southern Africa",66694,0,66694,50018,83363,"ZAF",66691
1,365.0,"South-Eastern Asia",883510,0,883510,684884,1141473,"IDN",913179
1,365.0,"Caribbean",138362,0,138362,105745,176242,"CUB",140994
1,366.0,"Pakistan",1590216,1589870,346,1202130,2003550,"PAK",1602840
1,366.0,"India",5564107,5564107,0,4214443,7024072,"IND",5619258
1,366.0,"Western Europe",3835931,3835931,0,2903454,4839091,"NLD",3871273
1,366.0,"China",7754936,7754936,0,5908146,9846910,"CPR",7877528
1,366.0,"United States of America",2267304,2267304,0,1714091,2856818,"USA",2285455
1,366.0,"Northern Africa",1171782,0,1171782,888629,1481048,"EGY",1184839
1,366.0,"Russian Federation",2715804,2715804,0,2052978,3421631,"RUS",2737305
1,366.0,"Western Africa",398560,0,398560,302257,503762,"NGA",403010
1,366.0,"South America",1794685,1794685,0,1359385,2265642,"BRA",1812514
1,366.0,"Northern Europe",1854297,1854297,0,1402336,2337227,"GBR",1869782
1,366.0,"Northern America",594741,594741,0,449856,749761,"CAN",599809
1,366.0,"Oceania",603801,603801,0,457963,763272,"NZL",610618
1,366.0,"Eastern Africa",230033,0,230033,174789,291316,"ETH",233053
1,366.0,"Middle Africa",103354,0,103354,78501,130835,"AGO",104668
1,366.0,"Eastern Europe",2613096,2613096,0,1970602,3284337,"POL",2627470
1,366.0,"Central Asia",1463969,1463969,0,1120667,1867778,"UZB",1494223
1,366.0,"Southern Europe",737379,0,737379,553041,921736,"ITA",737389
1,366.0,"Central America",269013,0,269013,202577,337628,"MEX",270103
1,366.0,"Southern Asia",240352,0,240352,185961,309936,"IRN",247949
1,366.0,"Western Asia",516210,0,516210,390099,650165,"IRQ",520132
1,366.0,"Eastern Asia",695889,0,695889,529520,882533,"JPN",706027
1,366.0,"Southern Africa",66899,0,66899,50018,83363,"ZAF",66691
1,366.0,"South-Eastern Asia",902939,0,902939,684884,1141473,"IDN",913179
1,366.0,"Caribbean",140288,0,140288,105745,176242,"CUB",140994
1,367.0,"Pakistan",1554107,1553956,151,1202130,2003550,"PAK",1602840
1,367.0,"India",5443708,5443708,0,4214443,7024072,"IND",5619258
1,367.0,"Western Europe",3751477,3751477,0,2903454,4839091,"NLD",3871273
1,367.0,"China",7663121,7663121,0,5908146,9846910,"CPR",7877528
1,367.0,"United States of America",2215906,2215906,0,1714091,2856818,"USA",2285455
1,367.0,"Northern Africa",1147149,0,1147149,888629,1481048,"EGY",1184839
1,367.0,"Russian Federation",2654107,2654107,0,2052978,3421631,"RUS",2737305
1,367.0,"Western Africa",390150,0,390150,302257,503762,"NGA",403010
1,367.0,"South America",1755869,1755869,0,1359385,2265642,"BRA",1812514
1,367.0,"Northern Europe",1812606,1812606,0,1402336,2337227,"GBR",1869782
1,367.0,"Northern America",581422,581422,0,449856,749761,"CAN",599809
1,367.0,"Oceania",591180,591180,0,457963,763272,"NZL",610618
1,367.0,"Eastern Africa",225571,0,225571,174789,291316,"ETH",233053
1,367.0,"Middle Africa",101270,0,101270,78501,130835,"AGO",104668
1,367.0,"Eastern Europe",2550321,2550321,0,1970602,3284337,"POL",2627470
1,367.0,"Central Asia",1455550,1454628,922,1120667,1867778,"UZB",1494223
1,367.0,"Southern Europe",717336,0,717336,553041,921736,"ITA",737389
1,367.0,"Central America",262339,0,262339,202577,337628,"MEX",270103
1,367.0,"Southern Asia",239373,0,239373,185961,309936,"IRN",247949
1,367.0,"Western Asia",505081,0,505081,390099,650165,"IRQ",520132
1,367.0,"Eastern Asia",686876,0,686876,529520,882533,"JPN",706027
1,367.0,"Southern Africa",65004,0,65004,50018,83363,"ZAF",66691
1,367.0,"South-Eastern Asia",884130,0,884130,684884,1141473,"IDN",913179
1,367.0,"Caribbean",136881,0,136881,105745,176242,"CUB",140994
1,368.0,"Pakistan",1585853,1585853,0,1202130,2003550,"PAK",1602840
1,368.0,"India",5557813,5557813,0,4214443,7024072,"IND",5619258
1,368.0,"Western Europe",3829465,3829465,0,2903454,4839091,"NLD",3871273
1,368.0,"China",7806006,7806006,0,5908146,9846910,"CPR",7877528
1,368.0,"United States of America",2261312,2261312,0,1714091,2856818,"USA",2285455
1,368.0,"Northern Africa",1162825,0,1162825,888629,1481048,"EGY",1184839
1,368.0,"Russian Federation",2708437,2708437,0,2052978,3421631,"RUS",2737305
1,368.0,"Western Africa",397436,0,397436,302257,503762,"NGA",403010
1,368.0,"South America",1792676,1792676,0,1359385,2265642,"BRA",1812514
1,368.0,"Northern Europe",1849898,1849898,0,1402336,2337227,"GBR",1869782
1,368.0,"Northern America",593401,593401,0,449856,749761,"CAN",599809
1,368.0,"Oceania",603761,603761,0,457963,763272,"NZL",610618
1,368.0,"Eastern Africa",227692,0,227692,174789,291316,"ETH",233053
1,368.0,"Middle Africa",102403,0,102403,78501,130835,"AGO",104668
1,368.0,"Eastern Europe",2547072,2547072,0,1970602,3284337,"POL",2627470
1,368.0,"Central Asia",1481564,1481139,425,1120667,1867778,"UZB",1494223
1,368.0,"Southern Europe",728127,0,728127,553041,921736,"ITA",737389
1,368.0,"Central America",267458,0,267458,202577,337628,"MEX",270103
1,368.0,"Southern Asia",244583,0,244583,185961,309936,"IRN",247949
1,368.0,"Western Asia",505379,0,505379,390099,650165,"IRQ",520132
1,368.0,"Eastern Asia",699640,0,699640,529520,882533,"JPN",706027
1,368.0,"Southern Africa",66117,0,66117,50018,83363,"ZAF",66691
1,368.0,"South-Eastern Asia",902948,0,902948,684884,1141473,"IDN",913179
1,368.0,"Caribbean",139576,0,139576,105745,176242,"CUB",140994
1,369.0,"Pakistan",1617115,1617115,0,1202130,2003550,"PAK",1602840
1,369.0,"India",5610466,5610466,0,4214443,7024072,"IND",5619258
1,369.0,"Western Europe",3852241,3852140,101,2903454,4839091,"NLD",3871273
1,369.0,"China",8143050,8143050,0,5908146,9846910,"CPR",7877528
1,369.0,"United States of America",2423764,2423764,0,1714091,2856818,"USA",2285455
1,369.0,"Northern Africa",1188292,0,1188292,888629,1481048,"EGY",1184839
1,369.0,"Russian Federation",2902981,2902981,0,2052978,3421631,"RUS",2737305
1,369.0,"Western Africa",401723,0,401723,302257,503762,"NGA",403010
1,369.0,"South America",1921862,1921862,0,1359385,2265642,"BRA",1812514
1,369.0,"Northern Europe",1982871,1982871,0,1402336,2337227,"GBR",1869782
1,369.0,"Northern America",636069,636069,0,449856,749761,"CAN",599809
1,369.0,"Oceania",647470,647368,102,457963,763272,"NZL",610618
1,369.0,"Eastern Africa",235704,0,235704,174789,291316,"ETH",233053
1,369.0,"Middle Africa",105204,0,105204,78501,130835,"AGO",104668
1,369.0,"Eastern Europe",2672341,2669233,3108,1970602,3284337,"POL",2627470
1,369.0,"Central Asia",1488234,1488234,0,1120667,1867778,"UZB",1494223
1,369.0,"Southern Europe",737168,0,737168,553041,921736,"ITA",737389
1,369.0,"Central America",286532,0,286532,202577,337628,"MEX",270103
1,369.0,"Southern Asia",247988,0,247988,185961,309936,"IRN",247949
1,369.0,"Western Asia",527944,0,527944,390099,650165,"IRQ",520132
1,369.0,"Eastern Asia",731107,0,731107,529520,882533,"JPN",706027
1,369.0,"Southern Africa",70227,0,70227,50018,83363,"ZAF",66691
1,369.0,"South-Eastern Asia",965604,0,965604,684884,1141473,"IDN",913179
1,369.0,"Caribbean",149557,0,149557,105745,176242,"CUB",140994
1,370.0,"Pakistan",1621047,1614528,6519,1202130,2003550,"PAK",1602840
1,370.0,"India",5635779,5624814,10965,4214443,7024072,"IND",5619258
1,370.0,"Western Europe",3957297,3942653,14644,2903454,4839091,"NLD",3871273
1,370.0,"China",8179933,8178791,1142,5908146,9846910,"CPR",7877528
1,370.0,"United States of America",2412234,2412234,0,1714091,2856818,"USA",2285455
1,370.0,"Northern Africa",1215116,0,1215116,888629,1481048,"EGY",1184839
1,370.0,"Russian Federation",2889161,2889161,0,2052978,3421631,"RUS",2737305
1,370.0,"Western Africa",413489,0,413489,302257,503762,"NGA",403010
1,370.0,"South America",1912922,1912922,0,1359385,2265642,"BRA",1812514
1,370.0,"Northern Europe",1973483,1973483,0,1402336,2337227,"GBR",1869782
1,370.0,"Northern America",633084,633084,0,449856,749761,"CAN",599809
1,370.0,"Oceania",644425,644425,0,457963,763272,"NZL",610618
1,370.0,"Eastern Africa",237847,0,237847,174789,291316,"ETH",233053
1,370.0,"Middle Africa",107226,0,107226,78501,130835,"AGO",104668
1,370.0,"Eastern Europe",2675811,2664287,11524,1970602,3284337,"POL",2627470
1,370.0,"Central Asia",1636234,1621007,15227,1120667,1867778,"UZB",1494223
1,370.0,"Southern Europe",756885,0,756885,553041,921736,"ITA",737389
1,370.0,"Central America",285146,0,285146,202577,337628,"MEX",270103
1,370.0,"Southern Asia",262482,0,262482,185961,309936,"IRN",247949
1,370.0,"Western Asia",533882,0,533882,390099,650165,"IRQ",520132
1,370.0,"Eastern Asia",735260,0,735260,529520,882533,"JPN",706027
1,370.0,"Southern Africa",70232,0,70232,50018,83363,"ZAF",66691
1,370.0,"South-Eastern Asia",961610,0,961610,684884,1141473,"IDN",913179
1,370.0,"Caribbean",148846,0,148846,105745,176242,"CUB",140994
1,371.0,"Pakistan",1666071,1641427,24644,1202130,2003550,"PAK",1602840
1,371.0,"India",5667222,5631692,35530,4214443,7024072,"IND",5619258
1,371.0,"Western Europe",4015376,3983643,31733,2903454,4839091,"NLD",3871273
1,371.0,"China",8188221,8184121,4100,5908146,9846910,"CPR",7877528
1,371.0,"United States of America",2329456,2329456,0,1714091,2856818,"USA",2285455
1,371.0,"Northern Africa",1234242,0,1234242,888629,1481048,"EGY",1184839
1,371.0,"Russian Federation",2790008,2790008,0,2052978,3421631,"RUS",2737305
1,371.0,"Western Africa",418946,0,418946,302257,503762,"NGA",403010
1,371.0,"South America",1847361,1847361,0,1359385,2265642,"BRA",1812514
1,371.0,"Northern Europe",1905778,1905778,0,1402336,2337227,"GBR",1869782
1,371.0,"Northern America",611376,611376,0,449856,749761,"CAN",599809
1,371.0,"Oceania",622364,622364,0,457963,763272,"NZL",610618
1,371.0,"Eastern Africa",243076,0,243076,174789,291316,"ETH",233053
1,371.0,"Middle Africa",109117,0,109117,78501,130835,"AGO",104668
1,371.0,"Eastern Europe",2747895,2716633,31262,1970602,3284337,"POL",2627470
1,371.0,"Central Asia",1547017,1541035,5982,1120667,1867778,"UZB",1494223
1,371.0,"Southern Europe",766862,0,766862,553041,921736,"ITA",737389
1,371.0,"Central America",275341,0,275341,202577,337628,"MEX",270103
1,371.0,"Southern Asia",257635,0,257635,185961,309936,"IRN",247949
1,371.0,"Western Asia",544260,0,544260,390099,650165,"IRQ",520132
1,371.0,"Eastern Asia",732751,0,732751,529520,882533,"JPN",706027
1,371.0,"Southern Africa",68231,0,68231,50018,83363,"ZAF",66691
1,371.0,"South-Eastern Asia",930470,0,930470,684884,1141473,"IDN",913179
1,371.0,"Caribbean",143737,0,143737,105745,176242,"CUB",140994
1,372.0,"Pakistan",1661071,1634814,26257,1202136,2003561,"PAK",1602849
1,372.0,"India",5718117,5656420,61697,4214458,7024097,"IND",5619278
1,372.0,"Western Europe",4022422,3985927,36495,2903470,4839117,"NLD",3871294
1,372.0,"China",7928692,7927086,1606,5908160,9846933,"CPR",7877547
1,372.0,"United States of America",2266957,2266957,0,1714100,2856833,"USA",2285467
1,372.0,"Northern Africa",1225180,0,1225180,888627,1481046,"EGY",1184837
1,372.0,"Russian Federation",2715149,2715149,0,2052990,3421651,"RUS",2737321
1,372.0,"Western Africa",417362,0,417362,302262,503771,"NGA",403017
1,372.0,"South America",1797829,1797829,0,1359386,2265643,"BRA",1812515
1,372.0,"Northern Europe",1854651,1854651,0,1402345,2337242,"GBR",1869794
1,372.0,"Northern America",594967,594967,0,449859,749766,"CAN",599813
1,372.0,"Oceania",605679,605679,0,457973,763288,"NZL",610631
1,372.0,"Eastern Africa",240616,0,240616,174789,291316,"ETH",233053
1,372.0,"Middle Africa",108256,0,108256,78506,130843,"AGO",104675
1,372.0,"Eastern Europe",2721516,2688360,33156,1970614,3284357,"POL",2627486
1,372.0,"Central Asia",1491590,1489404,2186,1120673,1867788,"UZB",1494231
1,372.0,"Southern Europe",763283,0,763283,553036,921727,"ITA",737382
1,372.0,"Central America",267937,0,267937,202575,337626,"MEX",270101
1,372.0,"Southern Asia",251124,0,251124,185960,309933,"IRN",247947
1,372.0,"Western Asia",536125,0,536125,390099,650166,"IRQ",520133
1,372.0,"Eastern Asia",709305,0,709305,529524,882541,"JPN",706033
1,372.0,"Southern Africa",66378,0,66378,50013,83355,"ZAF",66684
1,372.0,"South-Eastern Asia",906940,0,906940,684885,1141476,"IDN",913181
1,372.0,"Caribbean",139872,0,139872,105753,176256,"CUB",141005
1,373.0,"Pakistan",1663843,1652720,11123,1470894,2451490,"PAK",1961192
1,373.0,"India",5722479,5647993,74486,5101704,8502841,"IND",6802273
1,373.0,"Western Europe",4073179,4054099,19080,3192165,5320276,"NLD",4256221
1,373.0,"China",8152448,8151848,600,7067869,11779782,"CPR",9423826
1,373.0,"United States of America",2387495,2387495,0,1869079,3115132,"USA",2492106
1,373.0,"Northern Africa",1233870,0,1233870,1391310,2318851,"EGY",1855081
1,373.0,"Russian Federation",2859519,2859519,0,2312401,3854002,"RUS",3083202
1,373.0,"Western Africa",421697,0,421697,365776,609627,"NGA",487702
1,373.0,"South America",1806397,1806397,0,1628025,2713376,"BRA",2170701
1,373.0,"Northern Europe",1893407,1893407,0,1671334,2785557,"GBR",2228446
1,373.0,"Northern America",626593,626593,0,425507,709178,"CAN",567343
1,373.0,"Oceania",637879,637879,0,490465,817442,"NZL",653954
1,373.0,"Eastern Africa",240780,0,240780,239460,399101,"ETH",319281
1,373.0,"Middle Africa",108570,0,108570,77279,128798,"AGO",103039
1,373.0,"Eastern Europe",2692714,2678661,14053,2506299,4177165,"POL",3341732
1,373.0,"Central Asia",1564899,1564110,789,1379986,2299977,"UZB",1839982
1,373.0,"Southern Europe",773177,0,773177,693606,1156011,"ITA",924809
1,373.0,"Central America",282169,0,282169,263614,439357,"MEX",351486
1,373.0,"Southern Asia",259243,0,259243,397600,662667,"IRN",530134
1,373.0,"Western Asia",534102,0,534102,938569,1564282,"IRQ",1251426
1,373.0,"Eastern Asia",731449,0,731449,596886,994810,"JPN",795848
1,373.0,"Southern Africa",66700,0,66700,97392,162320,"ZAF",129856
1,373.0,"South-Eastern Asia",952911,0,952911,797915,1329858,"IDN",1063887
1,373.0,"Caribbean",147292,0,147292,128425,214042,"CUB",171234
1,374.0,"Pakistan",1622013,1611752,10261,1470894,2451490,"PAK",1961192
1,374.0,"India",5755747,5651934,103813,5101704,8502841,"IND",6802273
1,374.0,"Western Europe",3889746,3879923,9823,3192165,5320276,"NLD",4256221
1,374.0,"China",7887399,7886166,1233,7067869,11779782,"CPR",9423826
1,374.0,"United States of America",2260956,2260956,0,1869079,3115132,"USA",2492106
1,374.0,"Northern Africa",1195111,0,1195111,1391310,2318851,"EGY",1855081
1,374.0,"Russian Federation",2707965,2707965,0,2312401,3854002,"RUS",3083202
1,374.0,"Western Africa",405488,0,405488,365776,609627,"NGA",487702
1,374.0,"South America",1821980,1814506,7474,1628025,2713376,"BRA",2170701
1,374.0,"Northern Europe",1885619,1880870,4749,1671334,2785557,"GBR",2228446
1,374.0,"Northern America",593395,593395,0,425507,709178,"CAN",567343
1,374.0,"Oceania",467030,467030,0,490465,817442,"NZL",653954
1,374.0,"Eastern Africa",235784,0,235784,239460,399101,"ETH",319281
1,374.0,"Middle Africa",105812,0,105812,77279,128798,"AGO",103039
1,374.0,"Eastern Europe",2679015,2657908,21107,2506299,4177165,"POL",3341732
1,374.0,"Central Asia",1460877,1460768,109,1379986,2299977,"UZB",1839982
1,374.0,"Southern Europe",740337,0,740337,693606,1156011,"ITA",924809
1,374.0,"Central America",266577,0,266577,263614,439357,"MEX",351486
1,374.0,"Southern Asia",245012,0,245012,397600,662667,"IRN",530134
1,374.0,"Western Asia",527938,0,527938,938569,1564282,"IRQ",1251426
1,374.0,"Eastern Asia",704844,0,704844,596886,994810,"JPN",795848
1,374.0,"Southern Africa",66957,0,66957,97392,162320,"ZAF",129856
1,374.0,"South-Eastern Asia",709540,0,709540,797915,1329858,"IDN",1063887
1,374.0,"Caribbean",139107,0,139107,128425,214042,"CUB",171234
1,375.0,"Pakistan",1576921,1572612,4309,1470894,2451490,"PAK",1961192
1,375.0,"India",5754211,5647790,106421,5101704,8502841,"IND",6802273
1,375.0,"Western Europe",3771321,3765939,5382,3192165,5320276,"NLD",4256221
1,375.0,"China",8080401,8079866,535,7067869,11779782,"CPR",9423826
1,375.0,"United States of America",2353110,2353110,0,1869079,3115132,"USA",2492106
1,375.0,"Northern Africa",1437026,0,1437026,1391310,2318851,"EGY",1855081
1,375.0,"Russian Federation",2875757,2875757,0,2312401,3854002,"RUS",3083202
1,375.0,"Western Africa",416162,0,416162,365776,609627,"NGA",487702
1,375.0,"South America",1794173,1790916,3257,1628025,2713376,"BRA",2170701
1,375.0,"Northern Europe",1931578,1929554,2024,1671334,2785557,"GBR",2228446
1,375.0,"Northern America",566985,566985,0,425507,709178,"CAN",567343
1,375.0,"Oceania",502759,460371,42388,490465,817442,"NZL",653954
1,375.0,"Eastern Africa",246188,0,246188,239460,399101,"ETH",319281
1,375.0,"Middle Africa",92791,0,92791,77279,128798,"AGO",103039
1,375.0,"Eastern Europe",2599902,2588787,11115,2506299,4177165,"POL",3341732
1,375.0,"Central Asia",1511805,1509906,1899,1379986,2299977,"UZB",1839982
1,375.0,"Southern Europe",779243,0,779243,693606,1156011,"ITA",924809
1,375.0,"Central America",310667,0,310667,263614,439357,"MEX",351486
1,375.0,"Southern Asia",369050,0,369050,397600,662667,"IRN",530134
1,375.0,"Western Asia",826042,0,826042,938569,1564282,"IRQ",1251426
1,375.0,"Eastern Asia",701525,0,701525,596886,994810,"JPN",795848
1,375.0,"Southern Africa",91750,0,91750,97392,162320,"ZAF",129856
1,375.0,"South-Eastern Asia",796569,0,796569,797915,1329858,"IDN",1063887
1,375.0,"Caribbean",154966,0,154966,128425,214042,"CUB",171234
1,376.0,"Pakistan",1623382,1589242,34140,1470894,2451490,"PAK",1961192
1,376.0,"India",5778336,5652723,125613,5101704,8502841,"IND",6802273
1,376.0,"Western Europe",3691016,3677005,14011,3192165,5320276,"NLD",4256221
1,376.0,"China",8089055,8080987,8068,7067869,11779782,"CPR",9423826
1,376.0,"United States of America",2363860,2363860,0,1869079,3115132,"USA",2492106
1,376.0,"Northern Africa",1546060,0,1546060,1391310,2318851,"EGY",1855081
1,376.0,"Russian Federation",2910195,2910195,0,2312401,3854002,"RUS",3083202
1,376.0,"Western Africa",420396,0,420396,365776,609627,"NGA",487702
1,376.0,"South America",1806622,1782915,23707,1628025,2713376,"BRA",2170701
1,376.0,"Northern Europe",1910052,1901339,8713,1671334,2785557,"GBR",2228446
1,376.0,"Northern America",550797,550797,0,425507,709178,"CAN",567343
1,376.0,"Oceania",544824,459018,85806,490465,817442,"NZL",653954
1,376.0,"Eastern Africa",263219,0,263219,239460,399101,"ETH",319281
1,376.0,"Middle Africa",91096,0,91096,77279,128798,"AGO",103039
1,376.0,"Eastern Europe",2735937,2679385,56552,2506299,4177165,"POL",3341732
1,376.0,"Central Asia",1532040,1509403,22637,1379986,2299977,"UZB",1839982
1,376.0,"Southern Europe",794070,0,794070,693606,1156011,"ITA",924809
1,376.0,"Central America",324628,0,324628,263614,439357,"MEX",351486
1,376.0,"Southern Asia",420785,0,420785,397600,662667,"IRN",530134
1,376.0,"Western Asia",976701,0,976701,938569,1564282,"IRQ",1251426
1,376.0,"Eastern Asia",701327,0,701327,596886,994810,"JPN",795848
1,376.0,"Southern Africa",102983,0,102983,97392,162320,"ZAF",129856
1,376.0,"South-Eastern Asia",874774,0,874774,797915,1329858,"IDN",1063887
1,376.0,"Caribbean",159595,0,159595,128425,214042,"CUB",171234
1,377.0,"Pakistan",1681956,1610393,71563,1470894,2451490,"PAK",1961192
1,377.0,"India",6334115,6183882,150233,5101704,8502841,"IND",6802273
1,377.0,"Western Europe",3693431,3660913,32518,3192165,5320276,"NLD",4256221
1,377.0,"China",8138684,8114119,24565,7067869,11779782,"CPR",9423826
1,377.0,"United States of America",2436544,2436544,0,1869079,3115132,"USA",2492106
1,377.0,"Northern Africa",1615036,0,1615036,1391310,2318851,"EGY",1855081
1,377.0,"Russian Federation",2868946,2868946,0,2312401,3854002,"RUS",3083202
1,377.0,"Western Africa",426986,0,426986,365776,609627,"NGA",487702
1,377.0,"South America",1836079,1781687,54392,1628025,2713376,"BRA",2170701
1,377.0,"Northern Europe",1910577,1884204,26373,1671334,2785557,"GBR",2228446
1,377.0,"Northern America",560168,560168,0,425507,709178,"CAN",567343
1,377.0,"Oceania",585601,457375,128226,490465,817442,"NZL",653954
1,377.0,"Eastern Africa",277777,0,277777,239460,399101,"ETH",319281
1,377.0,"Middle Africa",92099,0,92099,77279,128798,"AGO",103039
1,377.0,"Eastern Europe",2900569,2796668,103901,2506299,4177165,"POL",3341732
1,377.0,"Central Asia",1567198,1512746,54452,1379986,2299977,"UZB",1839982
1,377.0,"Southern Europe",812244,0,812244,693606,1156011,"ITA",924809
1,377.0,"Central America",339705,0,339705,263614,439357,"MEX",351486
1,377.0,"Southern Asia",449583,0,449583,397600,662667,"IRN",530134
1,377.0,"Western Asia",1076330,0,1076330,938569,1564282,"IRQ",1251426
1,377.0,"Eastern Asia",708646,0,708646,596886,994810,"JPN",795848
1,377.0,"Southern Africa",109209,0,109209,97392,162320,"ZAF",129856
1,377.0,"South-Eastern Asia",948226,0,948226,797915,1329858,"IDN",1063887
1,377.0,"Caribbean",166108,0,166108,128425,214042,"CUB",171234
1,378.0,"Pakistan",1793070,1680516,112554,1470894,2451490,"PAK",1961192
1,378.0,"India",6255422,6128576,126846,5101704,8502841,"IND",6802273
1,378.0,"Western Europe",3736033,3678637,57396,3192165,5320276,"NLD",4256221
1,378.0,"China",8214320,8164571,49749,7067869,11779782,"CPR",9423826
1,378.0,"United States of America",2419052,2419052,0,1869079,3115132,"USA",2492106
1,378.0,"Northern Africa",1656835,0,1656835,1391310,2318851,"EGY",1855081
1,378.0,"Russian Federation",2746984,2745030,1954,2312401,3854002,"RUS",3083202
1,378.0,"Western Africa",434996,0,434996,365776,609627,"NGA",487702
1,378.0,"South America",1880640,1787041,93599,1628025,2713376,"BRA",2170701
1,378.0,"Northern Europe",1962275,1909720,52555,1671334,2785557,"GBR",2228446
1,378.0,"Northern America",553032,553032,0,425507,709178,"CAN",567343
1,378.0,"Oceania",624682,459808,164874,490465,817442,"NZL",653954
1,378.0,"Eastern Africa",291806,0,291806,239460,399101,"ETH",319281
1,378.0,"Middle Africa",93576,0,93576,77279,128798,"AGO",103039
1,378.0,"Eastern Europe",3009574,2865452,144122,2506299,4177165,"POL",3341732
1,378.0,"Central Asia",1630920,1535490,95430,1379986,2299977,"UZB",1839982
1,378.0,"Southern Europe",830454,0,830454,693606,1156011,"ITA",924809
1,378.0,"Central America",339558,0,339558,263614,439357,"MEX",351486
1,378.0,"Southern Asia",473041,0,473041,397600,662667,"IRN",530134
1,378.0,"Western Asia",1129200,0,1129200,938569,1564282,"IRQ",1251426
1,378.0,"Eastern Asia",715413,0,715413,596886,994810,"JPN",795848
1,378.0,"Southern Africa",113768,0,113768,97392,162320,"ZAF",129856
1,378.0,"South-Eastern Asia",1010211,0,1010211,797915,1329858,"IDN",1063887
1,378.0,"Caribbean",165687,0,165687,128425,214042,"CUB",171234
1,379.0,"Pakistan",1805399,1682343,123056,1470894,2451490,"PAK",1961192
1,379.0,"India",6241545,6119509,122036,5101704,8502841,"IND",6802273
1,379.0,"Western Europe",3798341,3715227,83114,3192165,5320276,"NLD",4256221
1,379.0,"China",8298724,8223238,75486,7067869,11779782,"CPR",9423826
1,379.0,"United States of America",2368332,2368332,0,1869079,3115132,"USA",2492106
1,379.0,"Northern Africa",1682190,0,1682190,1391310,2318851,"EGY",1855081
1,379.0,"Russian Federation",2662957,2652765,10192,2312401,3854002,"RUS",3083202
1,379.0,"Western Africa",442601,0,442601,365776,609627,"NGA",487702
1,379.0,"South America",1917340,1786340,131000,1628025,2713376,"BRA",2170701
1,379.0,"Northern Europe",1986310,1909804,76506,1671334,2785557,"GBR",2228446
1,379.0,"Northern America",540151,540151,0,425507,709178,"CAN",567343
1,379.0,"Oceania",653895,460622,193273,490465,817442,"NZL",653954
1,379.0,"Eastern Africa",297701,0,297701,239460,399101,"ETH",319281
1,379.0,"Middle Africa",94866,0,94866,77279,128798,"AGO",103039
1,379.0,"Eastern Europe",3098103,2934315,163788,2506299,4177165,"POL",3341732
1,379.0,"Central Asia",1720370,1596718,123652,1379986,2299977,"UZB",1839982
1,379.0,"Southern Europe",845617,0,845617,693606,1156011,"ITA",924809
1,379.0,"Central America",333503,0,333503,263614,439357,"MEX",351486
1,379.0,"Southern Asia",492149,0,492149,397600,662667,"IRN",530134
1,379.0,"Western Asia",1158082,0,1158082,938569,1564282,"IRQ",1251426
1,379.0,"Eastern Asia",721059,0,721059,596886,994810,"JPN",795848
1,379.0,"Southern Africa",116912,0,116912,97392,162320,"ZAF",129856
1,379.0,"South-Eastern Asia",1054595,0,1054595,797915,1329858,"IDN",1063887
1,379.0,"Caribbean",162594,0,162594,128425,214042,"CUB",171234
1,380.0,"Pakistan",1845671,1704505,141166,1470894,2451490,"PAK",1961192
1,380.0,"India",6220857,6090539,130318,5101704,8502841,"IND",6802273
1,380.0,"Western Europe",3387877,3277574,110303,3192165,5320276,"NLD",4256221
1,380.0,"China",8576463,8471450,105013,7067869,11779782,"CPR",9423826
1,380.0,"United States of America",2494263,2494263,0,1869079,3115132,"USA",2492106
1,380.0,"Northern Africa",1611071,0,1611071,1391310,2318851,"EGY",1855081
1,380.0,"Russian Federation",2868030,2844621,23409,2312401,3854002,"RUS",3083202
1,380.0,"Western Africa",421414,0,421414,365776,609627,"NGA",487702
1,380.0,"South America",1972502,1800523,171979,1628025,2713376,"BRA",2170701
1,380.0,"Northern Europe",2094422,1991305,103117,1671334,2785557,"GBR",2228446
1,380.0,"Northern America",568289,568289,0,425507,709178,"CAN",567343
1,380.0,"Oceania",685287,464674,220613,490465,817442,"NZL",653954
1,380.0,"Eastern Africa",297306,0,297306,239460,399101,"ETH",319281
1,380.0,"Middle Africa",90175,0,90175,77279,128798,"AGO",103039
1,380.0,"Eastern Europe",2748382,2574867,173515,2506299,4177165,"POL",3341732
1,380.0,"Central Asia",1726492,1587332,139160,1379986,2299977,"UZB",1839982
1,380.0,"Southern Europe",807442,0,807442,693606,1156011,"ITA",924809
1,380.0,"Central America",351555,0,351555,263614,439357,"MEX",351486
1,380.0,"Southern Asia",508424,0,508424,397600,662667,"IRN",530134
1,380.0,"Western Asia",1108850,0,1108850,938569,1564282,"IRQ",1251426
1,380.0,"Eastern Asia",759331,0,759331,596886,994810,"JPN",795848
1,380.0,"Southern Africa",121983,0,121983,97392,162320,"ZAF",129856
1,380.0,"South-Eastern Asia",1104796,0,1104796,797915,1329858,"IDN",1063887
1,380.0,"Caribbean",171328,0,171328,128425,214042,"CUB",171234
1,381.0,"Pakistan",1868635,1711008,157627,1470894,2451490,"PAK",1961192
1,381.0,"India",6210674,6065813,144861,5101704,8502841,"IND",6802273
1,381.0,"Western Europe",3575725,3396863,178862,3192165,5320276,"NLD",4256221
1,381.0,"China",8677386,8545743,131643,7067869,11779782,"CPR",9423826
1,381.0,"United States of America",2382214,2382214,0,1869079,3115132,"USA",2492106
1,381.0,"Northern Africa",1661877,0,1661877,1391310,2318851,"EGY",1855081
1,381.0,"Russian Federation",2810611,2772940,37671,2312401,3854002,"RUS",3083202
1,381.0,"Western Africa",438890,0,438890,365776,609627,"NGA",487702
1,381.0,"South America",2004680,1802694,201986,1628025,2713376,"BRA",2170701
1,381.0,"Northern Europe",2077856,1954091,123765,1671334,2785557,"GBR",2228446
1,381.0,"Northern America",542523,542523,0,425507,709178,"CAN",567343
1,381.0,"Oceania",679305,466962,212343,490465,817442,"NZL",653954
1,381.0,"Eastern Africa",302355,0,302355,239460,399101,"ETH",319281
1,381.0,"Middle Africa",93267,0,93267,77279,128798,"AGO",103039
1,381.0,"Eastern Europe",2841287,2606459,234828,2506299,4177165,"POL",3341732
1,381.0,"Central Asia",1743247,1586774,156473,1379986,2299977,"UZB",1839982
1,381.0,"Southern Europe",838315,0,838315,693606,1156011,"ITA",924809
1,381.0,"Central America",336095,0,336095,263614,439357,"MEX",351486
1,381.0,"Southern Asia",508767,0,508767,397600,662667,"IRN",530134
1,381.0,"Western Asia",1132619,0,1132619,938569,1564282,"IRQ",1251426
1,381.0,"Eastern Asia",757976,0,757976,596886,994810,"JPN",795848
1,381.0,"Southern Africa",123199,0,123199,97392,162320,"ZAF",129856
1,381.0,"South-Eastern Asia",1098903,0,1098903,797915,1329858,"IDN",1063887
1,381.0,"Caribbean",163777,0,163777,128425,214042,"CUB",171234
1,382.0,"Pakistan",1864710,1699354,165356,1470894,2451490,"PAK",1961192
1,382.0,"India",6243979,6083932,160047,5101704,8502841,"IND",6802273
1,382.0,"Western Europe",3738671,3496174,242497,3192165,5320276,"NLD",4256221
1,382.0,"China",8720384,8566476,153908,7067869,11779782,"CPR",9423826
1,382.0,"United States of America",2352415,2352415,0,1869079,3115132,"USA",2492106
1,382.0,"Northern Africa",1711826,0,1711826,1391310,2318851,"EGY",1855081
1,382.0,"Russian Federation",2804275,2752540,51735,2312401,3854002,"RUS",3083202
1,382.0,"Western Africa",453580,0,453580,365776,609627,"NGA",487702
1,382.0,"South America",2030508,1802310,228198,1628025,2713376,"BRA",2170701
1,382.0,"Northern Europe",2082772,1940286,142486,1671334,2785557,"GBR",2228446
1,382.0,"Northern America",535622,535622,0,425507,709178,"CAN",567343
1,382.0,"Oceania",662001,473407,188594,490465,817442,"NZL",653954
1,382.0,"Eastern Africa",308046,0,308046,239460,399101,"ETH",319281
1,382.0,"Middle Africa",96113,0,96113,77279,128798,"AGO",103039
1,382.0,"Eastern Europe",2946387,2650006,296381,2506299,4177165,"POL",3341732
1,382.0,"Central Asia",1892368,1726211,166157,1379986,2299977,"UZB",1839982
1,382.0,"Southern Europe",864664,0,864664,693606,1156011,"ITA",924809
1,382.0,"Central America",331921,0,331921,263614,439357,"MEX",351486
1,382.0,"Southern Asia",531420,0,531420,397600,662667,"IRN",530134
1,382.0,"Western Asia",1162417,0,1162417,938569,1564282,"IRQ",1251426
1,382.0,"Eastern Asia",758782,0,758782,596886,994810,"JPN",795848
1,382.0,"Southern Africa",124980,0,124980,97392,162320,"ZAF",129856
1,382.0,"South-Eastern Asia",1074627,0,1074627,797915,1329858,"IDN",1063887
1,382.0,"Caribbean",161714,0,161714,128425,214042,"CUB",171234
1,383.0,"Pakistan",1871023,1701852,169171,1470894,2451490,"PAK",1961192
1,383.0,"India",6274385,6102930,171455,5101704,8502841,"IND",6802273
1,383.0,"Western Europe",3890066,3598377,291689,3192165,5320276,"NLD",4256221
1,383.0,"China",8768099,8601593,166506,7067869,11779782,"CPR",9423826
1,383.0,"United States of America",2252018,2252018,0,1869079,3115132,"USA",2492106
1,383.0,"Northern Africa",1731169,0,1731169,1391310,2318851,"EGY",1855081
1,383.0,"Russian Federation",2839426,2776189,63237,2312401,3854002,"RUS",3083202
1,383.0,"Western Africa",455391,0,455391,365776,609627,"NGA",487702
1,383.0,"South America",2054377,1814983,239394,1628025,2713376,"BRA",2170701
1,383.0,"Northern Europe",2076606,1921941,154665,1671334,2785557,"GBR",2228446
1,383.0,"Northern America",498372,498372,0,425507,709178,"CAN",567343
1,383.0,"Oceania",641565,472755,168810,490465,817442,"NZL",653954
1,383.0,"Eastern Africa",304051,0,304051,239460,399101,"ETH",319281
1,383.0,"Middle Africa",96196,0,96196,77279,128798,"AGO",103039
1,383.0,"Eastern Europe",3029264,2684900,344364,2506299,4177165,"POL",3341732
1,383.0,"Central Asia",1816773,1673405,143368,1379986,2299977,"UZB",1839982
1,383.0,"Southern Europe",867308,0,867308,693606,1156011,"ITA",924809
1,383.0,"Central America",317653,0,317653,263614,439357,"MEX",351486
1,383.0,"Southern Asia",509847,0,509847,397600,662667,"IRN",530134
1,383.0,"Western Asia",1168028,0,1168028,938569,1564282,"IRQ",1251426
1,383.0,"Eastern Asia",746568,0,746568,596886,994810,"JPN",795848
1,383.0,"Southern Africa",123304,0,123304,97392,162320,"ZAF",129856
1,383.0,"South-Eastern Asia",1042266,0,1042266,797915,1329858,"IDN",1063887
1,383.0,"Caribbean",154740,0,154740,128425,214042,"CUB",171234
1,384.0,"Pakistan",1853096,1694926,158170,1470897,2451496,"PAK",1961197
1,384.0,"India",6285406,6102026,183380,5101710,8502851,"IND",6802281
1,384.0,"Western Europe",3991694,3658377,333317,3192171,5320285,"NLD",4256228
1,384.0,"China",8833730,8654021,179709,7067877,11779796,"CPR",9423837
1,384.0,"United States of America",2326897,2326897,0,1869093,3115155,"USA",2492124
1,384.0,"Northern Africa",1759578,0,1759578,1391312,2318853,"EGY",1855083
1,384.0,"Russian Federation",2882860,2811405,71455,2312411,3854018,"RUS",3083215
1,384.0,"Western Africa",459548,0,459548,365781,609635,"NGA",487708
1,384.0,"South America",2064709,1812650,252059,1628034,2713391,"BRA",2170713
1,384.0,"Northern Europe",2074136,1906907,167229,1671339,2785566,"GBR",2228453
1,384.0,"Northern America",490726,489692,1034,425516,709193,"CAN",567355
1,384.0,"Oceania",625519,466020,159499,490475,817458,"NZL",653967
1,384.0,"Eastern Africa",302800,0,302800,239467,399112,"ETH",319290
1,384.0,"Middle Africa",97253,0,97253,77278,128797,"AGO",103038
1,384.0,"Eastern Europe",3148603,2757643,390960,2506302,4177171,"POL",3341737
1,384.0,"Central Asia",1770977,1638853,132124,1379993,2299988,"UZB",1839991
1,384.0,"Southern Europe",881772,0,881772,693603,1156005,"ITA",924804
1,384.0,"Central America",327677,0,327677,263613,439356,"MEX",351485
1,384.0,"Southern Asia",500445,0,500445,397604,662673,"IRN",530139
1,384.0,"Western Asia",1196802,0,1196802,938565,1564275,"IRQ",1251420
1,384.0,"Eastern Asia",752544,0,752544,596898,994831,"JPN",795865
1,384.0,"Southern Africa",122903,0,122903,97385,162308,"ZAF",129847
1,384.0,"South-Eastern Asia",1021686,0,1021686,797920,1329867,"IDN",1063894
1,384.0,"Caribbean",159575,0,159575,128438,214063,"CUB",171251
1,385.0,"Pakistan",1843514,1690801,152713,1266347,2110578,"PAK",1688463
1,385.0,"India",6275803,6085748,190055,4492429,7487382,"IND",5989906
1,385.0,"Western Europe",4090361,3732654,357707,3018040,5030067,"NLD",4024054
1,385.0,"China",8860256,8674620,185636,6082554,10137590,"CPR",8110072
1,385.0,"United States of America",2217828,2217828,0,1920179,3200298,"USA",2560239
1,385.0,"Northern Africa",1765626,0,1765626,1164538,1940897,"EGY",1552718
1,385.0,"Russian Federation",2889048,2814246,74802,2958676,4931127,"RUS",3944902
1,385.0,"Western Africa",465726,0,465726,318839,531398,"NGA",425119
1,385.0,"South America",2032580,1780900,251680,1419963,2366605,"BRA",1893284
1,385.0,"Northern Europe",2083408,1909869,173539,1440068,2400113,"GBR",1920091
1,385.0,"Northern America",500036,494867,5169,373438,622397,"CAN",497918
1,385.0,"Oceania",602444,468117,134327,468346,780577,"NZL",624462
1,385.0,"Eastern Africa",302449,0,302449,208486,347477,"ETH",277982
1,385.0,"Middle Africa",98379,0,98379,78846,131410,"AGO",105128
1,385.0,"Eastern Europe",3200517,2786954,413563,2407062,4011770,"POL",3209416
1,385.0,"Central Asia",1730625,1622027,108598,1118088,1863481,"UZB",1490785
1,385.0,"Southern Europe",879305,0,879305,455569,759282,"ITA",607426
1,385.0,"Central America",312818,0,312818,146469,244116,"MEX",195293
1,385.0,"Southern Asia",495022,0,495022,354986,591643,"IRN",473315
1,385.0,"Western Asia",1191262,0,1191262,735488,1225813,"IRQ",980651
1,385.0,"Eastern Asia",743484,0,743484,514143,856906,"JPN",685525
1,385.0,"Southern Africa",122064,0,122064,79849,133082,"ZAF",106466
1,385.0,"South-Eastern Asia",984882,0,984882,602395,1003992,"IDN",803194
1,385.0,"Caribbean",152374,0,152374,112846,188077,"CUB",150462
1,386.0,"Pakistan",1835436,1688026,147410,1266347,2110578,"PAK",1688463
1,386.0,"India",6290940,6097078,193862,4492429,7487382,"IND",5989906
1,386.0,"Western Europe",4154514,3785655,368859,3018040,5030067,"NLD",4024054
1,386.0,"China",8868510,8680937,187573,6082554,10137590,"CPR",8110072
1,386.0,"United States of America",2149857,2149857,0,1920179,3200298,"USA",2560239
1,386.0,"Northern Africa",1768650,0,1768650,1164538,1940897,"EGY",1552718
1,386.0,"Russian Federation",2902835,2828741,74094,2958676,4931127,"RUS",3944902
1,386.0,"Western Africa",468503,0,468503,318839,531398,"NGA",425119
1,386.0,"South America",2039177,1784708,254469,1419963,2366605,"BRA",1893284
1,386.0,"Northern Europe",2076483,1901080,175403,1440068,2400113,"GBR",1920091
1,386.0,"Northern America",512236,505309,6927,373438,622397,"CAN",497918
1,386.0,"Oceania",680731,561519,119212,468346,780577,"NZL",624462
1,386.0,"Eastern Africa",301078,0,301078,208486,347477,"ETH",277982
1,386.0,"Middle Africa",98983,0,98983,78846,131410,"AGO",105128
1,386.0,"Eastern Europe",3249430,2824247,425183,2407062,4011770,"POL",3209416
1,386.0,"Central Asia",1687911,1594856,93055,1118088,1863481,"UZB",1490785
1,386.0,"Southern Europe",874205,0,874205,455569,759282,"ITA",607426
1,386.0,"Central America",304205,0,304205,146469,244116,"MEX",195293
1,386.0,"Southern Asia",488605,0,488605,354986,591643,"IRN",473315
1,386.0,"Western Asia",1187607,0,1187607,735488,1225813,"IRQ",980651
1,386.0,"Eastern Asia",736784,0,736784,514143,856906,"JPN",685525
1,386.0,"Southern Africa",122092,0,122092,79849,133082,"ZAF",106466
1,386.0,"South-Eastern Asia",1080104,0,1080104,602395,1003992,"IDN",803194
1,386.0,"Caribbean",148264,0,148264,112846,188077,"CUB",150462
1,387.0,"Pakistan",1805404,1694428,110976,1266347,2110578,"PAK",1688463
1,387.0,"India",6313413,6119285,194128,4492429,7487382,"IND",5989906
1,387.0,"Western Europe",4282600,3914687,367913,3018040,5030067,"NLD",4024054
1,387.0,"China",8915384,8729149,186235,6082554,10137590,"CPR",8110072
1,387.0,"United States of America",2366174,2365920,254,1920179,3200298,"USA",2560239
1,387.0,"Northern Africa",1706267,0,1706267,1164538,1940897,"EGY",1552718
1,387.0,"Russian Federation",3006482,2953223,53259,2958676,4931127,"RUS",3944902
1,387.0,"Western Africa",460965,0,460965,318839,531398,"NGA",425119
1,387.0,"South America",2038060,1784303,253757,1419963,2366605,"BRA",1893284
1,387.0,"Northern Europe",2080259,1903908,176351,1440068,2400113,"GBR",1920091
1,387.0,"Northern America",509210,504701,4509,373438,622397,"CAN",497918
1,387.0,"Oceania",651551,558248,93303,468346,780577,"NZL",624462
1,387.0,"Eastern Africa",294362,0,294362,208486,347477,"ETH",277982
1,387.0,"Middle Africa",103434,0,103434,78846,131410,"AGO",105128
1,387.0,"Eastern Europe",3317370,2879131,438239,2407062,4011770,"POL",3209416
1,387.0,"Central Asia",1613134,1557137,55997,1118088,1863481,"UZB",1490785
1,387.0,"Southern Europe",796728,0,796728,455569,759282,"ITA",607426
1,387.0,"Central America",267841,0,267841,146469,244116,"MEX",195293
1,387.0,"Southern Asia",482005,0,482005,354986,591643,"IRN",473315
1,387.0,"Western Asia",1113503,0,1113503,735488,1225813,"IRQ",980651
1,387.0,"Eastern Asia",725618,0,725618,514143,856906,"JPN",685525
1,387.0,"Southern Africa",117572,0,117572,79849,133082,"ZAF",106466
1,387.0,"South-Eastern Asia",956588,0,956588,602395,1003992,"IDN",803194
1,387.0,"Caribbean",152935,0,152935,112846,188077,"CUB",150462
1,388.0,"Pakistan",1760311,1690637,69674,1266347,2110578,"PAK",1688463
1,388.0,"India",6295372,6117059,178313,4492429,7487382,"IND",5989906
1,388.0,"Western Europe",4278047,3946856,331191,3018040,5030067,"NLD",4024054
1,388.0,"China",8884288,8714914,169374,6082554,10137590,"CPR",8110072
1,388.0,"United States of America",2444133,2443991,142,1920179,3200298,"USA",2560239
1,388.0,"Northern Africa",1675661,0,1675661,1164538,1940897,"EGY",1552718
1,388.0,"Russian Federation",3331839,3260204,71635,2958676,4931127,"RUS",3944902
1,388.0,"Western Africa",457454,0,457454,318839,531398,"NGA",425119
1,388.0,"South America",2027049,1785434,241615,1419963,2366605,"BRA",1893284
1,388.0,"Northern Europe",2061559,1895158,166401,1440068,2400113,"GBR",1920091
1,388.0,"Northern America",516638,512077,4561,373438,622397,"CAN",497918
1,388.0,"Oceania",606852,539674,67178,468346,780577,"NZL",624462
1,388.0,"Eastern Africa",291435,0,291435,208486,347477,"ETH",277982
1,388.0,"Middle Africa",106020,0,106020,78846,131410,"AGO",105128
1,388.0,"Eastern Europe",3316486,2892317,424169,2407062,4011770,"POL",3209416
1,388.0,"Central Asia",1581096,1547208,33888,1118088,1863481,"UZB",1490785
1,388.0,"Southern Europe",739016,0,739016,455569,759282,"ITA",607426
1,388.0,"Central America",238319,0,238319,146469,244116,"MEX",195293
1,388.0,"Southern Asia",485137,0,485137,354986,591643,"IRN",473315
1,388.0,"Western Asia",1076788,0,1076788,735488,1225813,"IRQ",980651
1,388.0,"Eastern Asia",724551,0,724551,514143,856906,"JPN",685525
1,388.0,"Southern Africa",115524,0,115524,79849,133082,"ZAF",106466
1,388.0,"South-Eastern Asia",859604,0,859604,602395,1003992,"IDN",803194
1,388.0,"Caribbean",151521,0,151521,112846,188077,"CUB",150462
1,389.0,"Pakistan",1641958,1594181,47777,1266347,2110578,"PAK",1688463
1,389.0,"India",6011610,5861904,149706,4492429,7487382,"IND",5989906
1,389.0,"Western Europe",4116240,3834977,281263,3018040,5030067,"NLD",4024054
1,389.0,"China",8029211,7924885,104326,6082554,10137590,"CPR",8110072
1,389.0,"United States of America",2176941,2176941,0,1920179,3200298,"USA",2560239
1,389.0,"Northern Africa",1544600,0,1544600,1164538,1940897,"EGY",1552718
1,389.0,"Russian Federation",3571963,3492371,79592,2958676,4931127,"RUS",3944902
1,389.0,"Western Africa",414888,0,414888,318839,531398,"NGA",425119
1,389.0,"South America",1934884,1732246,202638,1419963,2366605,"BRA",1893284
1,389.0,"Northern Europe",1888277,1751021,137256,1440068,2400113,"GBR",1920091
1,389.0,"Northern America",442841,440559,2282,373438,622397,"CAN",497918
1,389.0,"Oceania",534578,497180,37398,468346,780577,"NZL",624462
1,389.0,"Eastern Africa",262017,0,262017,208486,347477,"ETH",277982
1,389.0,"Middle Africa",98215,0,98215,78846,131410,"AGO",105128
1,389.0,"Eastern Europe",3274056,2895894,378162,2407062,4011770,"POL",3209416
1,389.0,"Central Asia",1423522,1406044,17478,1118088,1863481,"UZB",1490785
1,389.0,"Southern Europe",637341,0,637341,455569,759282,"ITA",607426
1,389.0,"Central America",193082,0,193082,146469,244116,"MEX",195293
1,389.0,"Southern Asia",434638,0,434638,354986,591643,"IRN",473315
1,389.0,"Western Asia",983899,0,983899,735488,1225813,"IRQ",980651
1,389.0,"Eastern Asia",643868,0,643868,514143,856906,"JPN",685525
1,389.0,"Southern Africa",104160,0,104160,79849,133082,"ZAF",106466
1,389.0,"South-Eastern Asia",731282,0,731282,602395,1003992,"IDN",803194
1,389.0,"Caribbean",132027,0,132027,112846,188077,"CUB",150462
1,390.0,"Pakistan",1507864,1479341,28523,1266347,2110578,"PAK",1688463
1,390.0,"India",5459356,5370947,88409,4492429,7487382,"IND",5989906
1,390.0,"Western Europe",3713504,3543523,169981,3018040,5030067,"NLD",4024054
1,390.0,"China",7326558,7264648,61910,6082554,10137590,"CPR",8110072
1,390.0,"United States of America",2101779,2101779,0,1920179,3200298,"USA",2560239
1,390.0,"Northern Africa",1409384,0,1409384,1164538,1940897,"EGY",1552718
1,390.0,"Russian Federation",3401189,3352533,48656,2958676,4931127,"RUS",3944902
1,390.0,"Western Africa",380741,0,380741,318839,531398,"NGA",425119
1,390.0,"South America",1746174,1623168,123006,1419963,2366605,"BRA",1893284
1,390.0,"Northern Europe",1727189,1645634,81555,1440068,2400113,"GBR",1920091
1,390.0,"Northern America",420228,418822,1406,373438,622397,"CAN",497918
1,390.0,"Oceania",514759,491389,23370,468346,780577,"NZL",624462
1,390.0,"Eastern Africa",243549,0,243549,208486,347477,"ETH",277982
1,390.0,"Middle Africa",91588,0,91588,78846,131410,"AGO",105128
1,390.0,"Eastern Europe",2985020,2744650,240370,2407062,4011770,"POL",3209416
1,390.0,"Central Asia",1315820,1305334,10486,1118088,1863481,"UZB",1490785
1,390.0,"Southern Europe",570138,0,570138,455569,759282,"ITA",607426
1,390.0,"Central America",176264,0,176264,146469,244116,"MEX",195293
1,390.0,"Southern Asia",407644,0,407644,354986,591643,"IRN",473315
1,390.0,"Western Asia",898199,0,898199,735488,1225813,"IRQ",980651
1,390.0,"Eastern Asia",599236,0,599236,514143,856906,"JPN",685525
1,390.0,"Southern Africa",95512,0,95512,79849,133082,"ZAF",106466
1,390.0,"South-Eastern Asia",687929,0,687929,602395,1003992,"IDN",803194
1,390.0,"Caribbean",125914,0,125914,112846,188077,"CUB",150462
1,391.0,"Pakistan",1519808,1500010,19798,1266347,2110578,"PAK",1688463
1,391.0,"India",5529644,5468707,60937,4492429,7487382,"IND",5989906
1,391.0,"Western Europe",3745479,3624133,121346,3018040,5030067,"NLD",4024054
1,391.0,"China",7443339,7400530,42809,6082554,10137590,"CPR",8110072
1,391.0,"United States of America",2208571,2208571,0,1920179,3200298,"USA",2560239
1,391.0,"Northern Africa",1428724,0,1428724,1164538,1940897,"EGY",1552718
1,391.0,"Russian Federation",3511856,3477673,34183,2958676,4931127,"RUS",3944902
1,391.0,"Western Africa",387945,0,387945,318839,531398,"NGA",425119
1,391.0,"South America",1761568,1677112,84456,1419963,2366605,"BRA",1893284
1,391.0,"Northern Europe",1757275,1700803,56472,1440068,2400113,"GBR",1920091
1,391.0,"Northern America",437174,436181,993,373438,622397,"CAN",497918
1,391.0,"Oceania",540084,523393,16691,468346,780577,"NZL",624462
1,391.0,"Eastern Africa",248850,0,248850,208486,347477,"ETH",277982
1,391.0,"Middle Africa",94214,0,94214,78846,131410,"AGO",105128
1,391.0,"Eastern Europe",3002754,2837454,165300,2407062,4011770,"POL",3209416
1,391.0,"Central Asia",1347439,1340215,7224,1118088,1863481,"UZB",1490785
1,391.0,"Southern Europe",571782,0,571782,455569,759282,"ITA",607426
1,391.0,"Central America",179117,0,179117,146469,244116,"MEX",195293
1,391.0,"Southern Asia",420895,0,420895,354986,591643,"IRN",473315
1,391.0,"Western Asia",908085,0,908085,735488,1225813,"IRQ",980651
1,391.0,"Eastern Asia",615743,0,615743,514143,856906,"JPN",685525
1,391.0,"Southern Africa",97244,0,97244,79849,133082,"ZAF",106466
1,391.0,"South-Eastern Asia",711973,0,711973,602395,1003992,"IDN",803194
1,391.0,"Caribbean",131365,0,131365,112846,188077,"CUB",150462
1,392.0,"Pakistan",1518236,1501384,16852,1266347,2110578,"PAK",1688463
1,392.0,"India",6692188,6640697,51491,4492429,7487382,"IND",5989906
1,392.0,"Western Europe",4585580,4481073,104507,3018040,5030067,"NLD",4024054
1,392.0,"China",8432988,8396693,36295,6082554,10137590,"CPR",8110072
1,392.0,"United States of America",2817765,2817765,0,1920179,3200298,"USA",2560239
1,392.0,"Northern Africa",1714047,0,1714047,1164538,1940897,"EGY",1552718
1,392.0,"Russian Federation",4431777,4402879,28898,2958676,4931127,"RUS",3944902
1,392.0,"Western Africa",479796,0,479796,318839,531398,"NGA",425119
1,392.0,"South America",1846200,1774835,71365,1419963,2366605,"BRA",1893284
1,392.0,"Northern Europe",1933230,1884720,48510,1440068,2400113,"GBR",1920091
1,392.0,"Northern America",554361,553496,865,373438,622397,"CAN",497918
1,392.0,"Oceania",608971,594286,14685,468346,780577,"NZL",624462
1,392.0,"Eastern Africa",280927,0,280927,208486,347477,"ETH",277982
1,392.0,"Middle Africa",115381,0,115381,78846,131410,"AGO",105128
1,392.0,"Eastern Europe",3721405,3586732,134673,2407062,4011770,"POL",3209416
1,392.0,"Central Asia",1509743,1503340,6403,1118088,1863481,"UZB",1490785
1,392.0,"Southern Europe",700930,0,700930,455569,759282,"ITA",607426
1,392.0,"Central America",223074,0,223074,146469,244116,"MEX",195293
1,392.0,"Southern Asia",488893,0,488893,354986,591643,"IRN",473315
1,392.0,"Western Asia",1105146,0,1105146,735488,1225813,"IRQ",980651
1,392.0,"Eastern Asia",740642,0,740642,514143,856906,"JPN",685525
1,392.0,"Southern Africa",109853,0,109853,79849,133082,"ZAF",106466
1,392.0,"South-Eastern Asia",812652,0,812652,602395,1003992,"IDN",803194
1,392.0,"Caribbean",166033,0,166033,112846,188077,"CUB",150462
1,393.0,"Pakistan",1611252,1544359,66893,1266347,2110578,"PAK",1688463
1,393.0,"India",6662260,6628209,34051,4492429,7487382,"IND",5989906
1,393.0,"Western Europe",4511137,4441553,69584,3018040,5030067,"NLD",4024054
1,393.0,"China",8459607,8420375,39232,6082554,10137590,"CPR",8110072
1,393.0,"United States of America",3120857,3120857,0,1920179,3200298,"USA",2560239
1,393.0,"Northern Africa",1770860,0,1770860,1164538,1940897,"EGY",1552718
1,393.0,"Russian Federation",4643372,4624235,19137,2958676,4931127,"RUS",3944902
1,393.0,"Western Africa",482230,0,482230,318839,531398,"NGA",425119
1,393.0,"South America",1884961,1784343,100618,1419963,2366605,"BRA",1893284
1,393.0,"Northern Europe",2126160,2054347,71813,1440068,2400113,"GBR",1920091
1,393.0,"Northern America",561741,561151,590,373438,622397,"CAN",497918
1,393.0,"Oceania",637230,614486,22744,468346,780577,"NZL",624462
1,393.0,"Eastern Africa",296986,0,296986,208486,347477,"ETH",277982
1,393.0,"Middle Africa",118052,0,118052,78846,131410,"AGO",105128
1,393.0,"Eastern Europe",3925244,3837548,87696,2407062,4011770,"POL",3209416
1,393.0,"Central Asia",1563959,1541583,22376,1118088,1863481,"UZB",1490785
1,393.0,"Southern Europe",708552,0,708552,455569,759282,"ITA",607426
1,393.0,"Central America",243030,0,243030,146469,244116,"MEX",195293
1,393.0,"Southern Asia",509671,0,509671,354986,591643,"IRN",473315
1,393.0,"Western Asia",1169899,0,1169899,735488,1225813,"IRQ",980651
1,393.0,"Eastern Asia",770517,0,770517,514143,856906,"JPN",685525
1,393.0,"Southern Africa",113781,0,113781,79849,133082,"ZAF",106466
1,393.0,"South-Eastern Asia",851874,0,851874,602395,1003992,"IDN",803194
1,393.0,"Caribbean",182759,0,182759,112846,188077,"CUB",150462
1,394.0,"Pakistan",1713828,1575416,138412,1266347,2110578,"PAK",1688463
1,394.0,"India",6658455,6619117,39338,4492429,7487382,"IND",5989906
1,394.0,"Western Europe",4495633,4422062,73571,3018040,5030067,"NLD",4024054
1,394.0,"China",8522028,8455225,66803,6082554,10137590,"CPR",8110072
1,394.0,"United States of America",3319310,3319310,0,1920179,3200298,"USA",2560239
1,394.0,"Northern Africa",1789819,0,1789819,1164538,1940897,"EGY",1552718
1,394.0,"Russian Federation",4568185,4556586,11599,2958676,4931127,"RUS",3944902
1,394.0,"Western Africa",484683,0,484683,318839,531398,"NGA",425119
1,394.0,"South America",1941208,1787199,154009,1419963,2366605,"BRA",1893284
1,394.0,"Northern Europe",2150858,2057168,93690,1440068,2400113,"GBR",1920091
1,394.0,"Northern America",574340,569540,4800,373438,622397,"CAN",497918
1,394.0,"Oceania",675926,629489,46437,468346,780577,"NZL",624462
1,394.0,"Eastern Africa",307774,0,307774,208486,347477,"ETH",277982
1,394.0,"Middle Africa",119584,0,119584,78846,131410,"AGO",105128
1,394.0,"Eastern Europe",3706947,3654402,52545,2407062,4011770,"POL",3209416
1,394.0,"Central Asia",1529647,1477968,51679,1118088,1863481,"UZB",1490785
1,394.0,"Southern Europe",715269,0,715269,455569,759282,"ITA",607426
1,394.0,"Central America",255922,0,255922,146469,244116,"MEX",195293
1,394.0,"Southern Asia",509635,0,509635,354986,591643,"IRN",473315
1,394.0,"Western Asia",1162510,0,1162510,735488,1225813,"IRQ",980651
1,394.0,"Eastern Asia",798866,0,798866,514143,856906,"JPN",685525
1,394.0,"Southern Africa",117172,0,117172,79849,133082,"ZAF",106466
1,394.0,"South-Eastern Asia",895732,0,895732,602395,1003992,"IDN",803194
1,394.0,"Caribbean",194040,0,194040,112846,188077,"CUB",150462
1,395.0,"Pakistan",1814503,1595860,218643,1266347,2110578,"PAK",1688463
1,395.0,"India",6635620,6581086,54534,4492429,7487382,"IND",5989906
1,395.0,"Western Europe",4529145,4443447,85698,3018040,5030067,"NLD",4024054
1,395.0,"China",8602498,8494046,108452,6082554,10137590,"CPR",8110072
1,395.0,"United States of America",3023276,3023276,0,1920179,3200298,"USA",2560239
1,395.0,"Northern Africa",1788796,0,1788796,1164538,1940897,"EGY",1552718
1,395.0,"Russian Federation",4498751,4483252,15499,2958676,4931127,"RUS",3944902
1,395.0,"Western Africa",486907,0,486907,318839,531398,"NGA",425119
1,395.0,"South America",2007853,1790357,217496,1419963,2366605,"BRA",1893284
1,395.0,"Northern Europe",2202876,2085204,117672,1440068,2400113,"GBR",1920091
1,395.0,"Northern America",570879,557301,13578,373438,622397,"CAN",497918
1,395.0,"Oceania",712971,638764,74207,468346,780577,"NZL",624462
1,395.0,"Eastern Africa",317360,0,317360,208486,347477,"ETH",277982
1,395.0,"Middle Africa",120596,0,120596,78846,131410,"AGO",105128
1,395.0,"Eastern Europe",3629532,3583755,45777,2407062,4011770,"POL",3209416
1,395.0,"Central Asia",1637340,1533500,103840,1118088,1863481,"UZB",1490785
1,395.0,"Southern Europe",705320,0,705320,455569,759282,"ITA",607426
1,395.0,"Central America",232649,0,232649,146469,244116,"MEX",195293
1,395.0,"Southern Asia",534361,0,534361,354986,591643,"IRN",473315
1,395.0,"Western Asia",1139293,0,1139293,735488,1225813,"IRQ",980651
1,395.0,"Eastern Asia",788059,0,788059,514143,856906,"JPN",685525
1,395.0,"Southern Africa",120332,0,120332,79849,133082,"ZAF",106466
1,395.0,"South-Eastern Asia",929587,0,929587,602395,1003992,"IDN",803194
1,395.0,"Caribbean",177835,0,177835,112846,188077,"CUB",150462
1,396.0,"Pakistan",1919914,1621721,298193,1266357,2110595,"PAK",1688476
1,396.0,"India",6658514,6587304,71210,4492440,7487401,"IND",5989921
1,396.0,"Western Europe",4563525,4466046,97479,3018042,5030070,"NLD",4024056
1,396.0,"China",8688331,8529315,159016,6082562,10137603,"CPR",8110083
1,396.0,"United States of America",2772515,2772515,0,1920187,3200312,"USA",2560250
1,396.0,"Northern Africa",1774798,0,1774798,1164537,1940895,"EGY",1552716
1,396.0,"Russian Federation",4418720,4399346,19374,2958687,4931145,"RUS",3944916
1,396.0,"Western Africa",486053,0,486053,318837,531395,"NGA",425116
1,396.0,"South America",2077655,1791307,286348,1419969,2366615,"BRA",1893292
1,396.0,"Northern Europe",2225649,2089621,136028,1440083,2400138,"GBR",1920111
1,396.0,"Northern America",568749,548028,20721,373448,622413,"CAN",497931
1,396.0,"Oceania",741076,649190,91886,468348,780581,"NZL",624465
1,396.0,"Eastern Africa",323662,0,323662,208479,347465,"ETH",277972
1,396.0,"Middle Africa",120422,0,120422,78854,131423,"AGO",105139
1,396.0,"Eastern Europe",3583961,3539779,44182,2407063,4011772,"POL",3209418
1,396.0,"Central Asia",1724642,1574889,149753,1118094,1863491,"UZB",1490793
1,396.0,"Southern Europe",691750,0,691750,455566,759277,"ITA",607422
1,396.0,"Central America",213275,0,213275,146469,244116,"MEX",195293
1,396.0,"Southern Asia",550007,0,550007,354984,591641,"IRN",473313
1,396.0,"Western Asia",1112019,0,1112019,735494,1225823,"IRQ",980659
1,396.0,"Eastern Asia",771540,0,771540,514155,856926,"JPN",685541
1,396.0,"Southern Africa",122467,0,122467,79847,133078,"ZAF",106463
1,396.0,"South-Eastern Asia",949361,0,949361,602403,1004006,"IDN",803205
1,396.0,"Caribbean",164019,0,164019,112855,188092,"CUB",150474
1,397.0,"Pakistan",2003166,1633484,369682,1493199,2488666,"PAK",1990933
1,397.0,"India",6645173,6559141,86032,5160111,8600186,"IND",6880149
1,397.0,"Western Europe",4590004,4485445,104559,3396276,5660460,"NLD",4528368
1,397.0,"China",8770913,8553700,217213,7134837,11891395,"CPR",9513116
1,397.0,"United States of America",2604744,2604744,0,2080120,3466867,"USA",2773494
1,397.0,"Northern Africa",1755156,0,1755156,1312944,2188241,"EGY",1750593
1,397.0,"Russian Federation",4340296,4319475,20821,2891021,4818368,"RUS",3854695
1,397.0,"Western Africa",482133,0,482133,391163,651938,"NGA",521551
1,397.0,"South America",2274852,1919194,355658,1635509,2725848,"BRA",2180679
1,397.0,"Northern Europe",2260451,2114188,146263,1629090,2715151,"GBR",2172121
1,397.0,"Northern America",568633,545029,23604,472278,787131,"CAN",629705
1,397.0,"Oceania",755088,656820,98268,393768,656281,"NZL",525025
1,397.0,"Eastern Africa",325305,0,325305,366144,610241,"ETH",488193
1,397.0,"Middle Africa",119304,0,119304,97008,161681,"AGO",129345
1,397.0,"Eastern Europe",3529818,3487084,42734,2344324,3907207,"POL",3125766
1,397.0,"Central Asia",1784126,1602201,181925,1389006,2315010,"UZB",1852008
1,397.0,"Southern Europe",677404,0,677404,812902,1354837,"ITA",1083870
1,397.0,"Central America",200441,0,200441,191623,319372,"MEX",255498
1,397.0,"Southern Asia",556044,0,556044,703466,1172443,"IRN",937955
1,397.0,"Western Asia",1078391,0,1078391,1031520,1719201,"IRQ",1375361
1,397.0,"Eastern Asia",755244,0,755244,603075,1005125,"JPN",804100
1,397.0,"Southern Africa",125611,0,125611,100641,167735,"ZAF",134188
1,397.0,"South-Eastern Asia",951763,0,951763,838676,1397793,"IDN",1118235
1,397.0,"Caribbean",154699,0,154699,131804,219673,"CUB",175739
1,398.0,"Pakistan",2074442,1658655,415787,1493199,2488666,"PAK",1990933
1,398.0,"India",6664678,6564209,100469,5160111,8600186,"IND",6880149
1,398.0,"Western Europe",4671622,4566797,104825,3396276,5660460,"NLD",4528368
1,398.0,"China",8885930,8602933,282997,7134837,11891395,"CPR",9513116
1,398.0,"United States of America",2572761,2572646,115,2080120,3466867,"USA",2773494
1,398.0,"Northern Africa",1729235,0,1729235,1312944,2188241,"EGY",1750593
1,398.0,"Russian Federation",4254600,4244468,10132,2891021,4818368,"RUS",3854695
1,398.0,"Western Africa",467777,0,467777,391163,651938,"NGA",521551
1,398.0,"South America",2312631,1922521,390110,1635509,2725848,"BRA",2180679
1,398.0,"Northern Europe",2230401,2093306,137095,1629090,2715151,"GBR",2172121
1,398.0,"Northern America",521230,510266,10964,472278,787131,"CAN",629705
1,398.0,"Oceania",908619,832655,75964,393768,656281,"NZL",525025
1,398.0,"Eastern Africa",327042,0,327042,366144,610241,"ETH",488193
1,398.0,"Middle Africa",116202,0,116202,97008,161681,"AGO",129345
1,398.0,"Eastern Europe",3528641,3487935,40706,2344324,3907207,"POL",3125766
1,398.0,"Central Asia",1829572,1645251,184321,1389006,2315010,"UZB",1852008
1,398.0,"Southern Europe",661266,0,661266,812902,1354837,"ITA",1083870
1,398.0,"Central America",198940,0,198940,191623,319372,"MEX",255498
1,398.0,"Southern Asia",546554,0,546554,703466,1172443,"IRN",937955
1,398.0,"Western Asia",1054839,0,1054839,1031520,1719201,"IRQ",1375361
1,398.0,"Eastern Asia",736110,0,736110,603075,1005125,"JPN",804100
1,398.0,"Southern Africa",125305,0,125305,100641,167735,"ZAF",134188
1,398.0,"South-Eastern Asia",1064555,0,1064555,838676,1397793,"IDN",1118235
1,398.0,"Caribbean",153316,0,153316,131804,219673,"CUB",175739
1,399.0,"Pakistan",2123201,1670297,452904,1493199,2488666,"PAK",1990933
1,399.0,"India",6690022,6564964,125058,5160111,8600186,"IND",6880149
1,399.0,"Western Europe",4384662,4327665,56997,3396276,5660460,"NLD",4528368
1,399.0,"China",8997658,8627557,370101,7134837,11891395,"CPR",9513116
1,399.0,"United States of America",2586297,2579555,6742,2080120,3466867,"USA",2773494
1,399.0,"Northern Africa",1717639,0,1717639,1312944,2188241,"EGY",1750593
1,399.0,"Russian Federation",4097991,4086975,11016,2891021,4818368,"RUS",3854695
1,399.0,"Western Africa",506523,0,506523,391163,651938,"NGA",521551
1,399.0,"South America",2347988,1929088,418900,1635509,2725848,"BRA",2180679
1,399.0,"Northern Europe",2155133,2078959,76174,1629090,2715151,"GBR",2172121
1,399.0,"Northern America",632991,613004,19987,472278,787131,"CAN",629705
1,399.0,"Oceania",650872,615143,35729,393768,656281,"NZL",525025
1,399.0,"Eastern Africa",429562,0,429562,366144,610241,"ETH",488193
1,399.0,"Middle Africa",125017,0,125017,97008,161681,"AGO",129345
1,399.0,"Eastern Europe",3336959,3311107,25852,2344324,3907207,"POL",3125766
1,399.0,"Central Asia",1709200,1557987,151213,1389006,2315010,"UZB",1852008
1,399.0,"Southern Europe",864767,0,864767,812902,1354837,"ITA",1083870
1,399.0,"Central America",223268,0,223268,191623,319372,"MEX",255498
1,399.0,"Southern Asia",730442,0,730442,703466,1172443,"IRN",937955
1,399.0,"Western Asia",1215053,0,1215053,1031520,1719201,"IRQ",1375361
1,399.0,"Eastern Asia",786742,0,786742,603075,1005125,"JPN",804100
1,399.0,"Southern Africa",136038,0,136038,100641,167735,"ZAF",134188
1,399.0,"South-Eastern Asia",1079455,0,1079455,838676,1397793,"IDN",1118235
1,399.0,"Caribbean",162953,0,162953,131804,219673,"CUB",175739
1,400.0,"Pakistan",2136272,1686004,450268,1493199,2488666,"PAK",1990933
1,400.0,"India",6698354,6576481,121873,5160111,8600186,"IND",6880149
1,400.0,"Western Europe",4353969,4297665,56304,3396276,5660460,"NLD",4528368
1,400.0,"China",9134297,8681704,452593,7134837,11891395,"CPR",9513116
1,400.0,"United States of America",2780446,2763083,17363,2080120,3466867,"USA",2773494
1,400.0,"Northern Africa",1705960,0,1705960,1312944,2188241,"EGY",1750593
1,400.0,"Russian Federation",3944415,3930102,14313,2891021,4818368,"RUS",3854695
1,400.0,"Western Africa",492512,0,492512,391163,651938,"NGA",521551
1,400.0,"South America",2332843,1930205,402638,1635509,2725848,"BRA",2180679
1,400.0,"Northern Europe",2115842,2050118,65724,1629090,2715151,"GBR",2172121
1,400.0,"Northern America",568735,552265,16470,472278,787131,"CAN",629705
1,400.0,"Oceania",525348,509409,15939,393768,656281,"NZL",525025
1,400.0,"Eastern Africa",441259,0,441259,366144,610241,"ETH",488193
1,400.0,"Middle Africa",123125,0,123125,97008,161681,"AGO",129345
1,400.0,"Eastern Europe",3147213,3125061,22152,2344324,3907207,"POL",3125766
1,400.0,"Central Asia",1776295,1593316,182979,1389006,2315010,"UZB",1852008
1,400.0,"Southern Europe",962592,0,962592,812902,1354837,"ITA",1083870
1,400.0,"Central America",247463,0,247463,191623,319372,"MEX",255498
1,400.0,"Southern Asia",820790,0,820790,703466,1172443,"IRN",937955
1,400.0,"Western Asia",1288091,0,1288091,1031520,1719201,"IRQ",1375361
1,400.0,"Eastern Asia",791577,0,791577,603075,1005125,"JPN",804100
1,400.0,"Southern Africa",130982,0,130982,100641,167735,"ZAF",134188
1,400.0,"South-Eastern Asia",1035510,0,1035510,838676,1397793,"IDN",1118235
1,400.0,"Caribbean",173896,0,173896,131804,219673,"CUB",175739
1,401.0,"Pakistan",2026318,1679645,346673,1493199,2488666,"PAK",1990933
1,401.0,"India",6645174,6507719,137455,5160111,8600186,"IND",6880149
1,401.0,"Western Europe",4521293,4454842,66451,3396276,5660460,"NLD",4528368
1,401.0,"China",9209897,8681219,528678,7134837,11891395,"CPR",9513116
1,401.0,"United States of America",2734398,2719333,15065,2080120,3466867,"USA",2773494
1,401.0,"Northern Africa",1721353,0,1721353,1312944,2188241,"EGY",1750593
1,401.0,"Russian Federation",3739824,3726727,13097,2891021,4818368,"RUS",3854695
1,401.0,"Western Africa",508271,0,508271,391163,651938,"NGA",521551
1,401.0,"South America",2229602,1929496,300106,1635509,2725848,"BRA",2180679
1,401.0,"Northern Europe",2133058,2069515,63543,1629090,2715151,"GBR",2172121
1,401.0,"Northern America",617182,597160,20022,472278,787131,"CAN",629705
1,401.0,"Oceania",453811,446140,7671,393768,656281,"NZL",525025
1,401.0,"Eastern Africa",453152,0,453152,366144,610241,"ETH",488193
1,401.0,"Middle Africa",125322,0,125322,97008,161681,"AGO",129345
1,401.0,"Eastern Europe",3099591,3081793,17798,2344324,3907207,"POL",3125766
1,401.0,"Central Asia",1834659,1634824,199835,1389006,2315010,"UZB",1852008
1,401.0,"Southern Europe",1023747,0,1023747,812902,1354837,"ITA",1083870
1,401.0,"Central America",243317,0,243317,191623,319372,"MEX",255498
1,401.0,"Southern Asia",881199,0,881199,703466,1172443,"IRN",937955
1,401.0,"Western Asia",1309254,0,1309254,1031520,1719201,"IRQ",1375361
1,401.0,"Eastern Asia",797550,0,797550,603075,1005125,"JPN",804100
1,401.0,"Southern Africa",128567,0,128567,100641,167735,"ZAF",134188
1,401.0,"South-Eastern Asia",974535,0,974535,838676,1397793,"IDN",1118235
1,401.0,"Caribbean",169054,0,169054,131804,219673,"CUB",175739
1,402.0,"Pakistan",1992936,1671321,321615,1493199,2488666,"PAK",1990933
1,402.0,"India",6668678,6512940,155738,5160111,8600186,"IND",6880149
1,402.0,"Western Europe",4437017,4393755,43262,3396276,5660460,"NLD",4528368
1,402.0,"China",9335145,8736300,598845,7134837,11891395,"CPR",9513116
1,402.0,"United States of America",2763990,2755493,8497,2080120,3466867,"USA",2773494
1,402.0,"Northern Africa",1700332,0,1700332,1312944,2188241,"EGY",1750593
1,402.0,"Russian Federation",3839245,3831890,7355,2891021,4818368,"RUS",3854695
1,402.0,"Western Africa",492266,0,492266,391163,651938,"NGA",521551
1,402.0,"South America",2148643,1925866,222777,1635509,2725848,"BRA",2180679
1,402.0,"Northern Europe",2101989,2050714,51275,1629090,2715151,"GBR",2172121
1,402.0,"Northern America",567321,557333,9988,472278,787131,"CAN",629705
1,402.0,"Oceania",481881,477742,4139,393768,656281,"NZL",525025
1,402.0,"Eastern Africa",451864,0,451864,366144,610241,"ETH",488193
1,402.0,"Middle Africa",122427,0,122427,97008,161681,"AGO",129345
1,402.0,"Eastern Europe",2993783,2984137,9646,2344324,3907207,"POL",3125766
1,402.0,"Central Asia",1879212,1675836,203376,1389006,2315010,"UZB",1852008
1,402.0,"Southern Europe",1028055,0,1028055,812902,1354837,"ITA",1083870
1,402.0,"Central America",248779,0,248779,191623,319372,"MEX",255498
1,402.0,"Southern Asia",895045,0,895045,703466,1172443,"IRN",937955
1,402.0,"Western Asia",1315479,0,1315479,1031520,1719201,"IRQ",1375361
1,402.0,"Eastern Asia",785645,0,785645,603075,1005125,"JPN",804100
1,402.0,"Southern Africa",126496,0,126496,100641,167735,"ZAF",134188
1,402.0,"South-Eastern Asia",1033845,0,1033845,838676,1397793,"IDN",1118235
1,402.0,"Caribbean",171636,0,171636,131804,219673,"CUB",175739
1,403.0,"Pakistan",1924960,1668934,256026,1493199,2488666,"PAK",1990933
1,403.0,"India",6678961,6513607,165354,5160111,8600186,"IND",6880149
1,403.0,"Western Europe",4446599,4413826,32773,3396276,5660460,"NLD",4528368
1,403.0,"China",9413783,8750066,663717,7134837,11891395,"CPR",9513116
1,403.0,"United States of America",2696519,2692121,4398,2080120,3466867,"USA",2773494
1,403.0,"Northern Africa",1713069,0,1713069,1312944,2188241,"EGY",1750593
1,403.0,"Russian Federation",3686430,3682603,3827,2891021,4818368,"RUS",3854695
1,403.0,"Western Africa",539900,0,539900,391163,651938,"NGA",521551
1,403.0,"South America",2121818,1921255,200563,1635509,2725848,"BRA",2180679
1,403.0,"Northern Europe",2110180,2066399,43781,1629090,2715151,"GBR",2172121
1,403.0,"Northern America",727958,713931,14027,472278,787131,"CAN",629705
1,403.0,"Oceania",487628,485471,2157,393768,656281,"NZL",525025
1,403.0,"Eastern Africa",495485,0,495485,366144,610241,"ETH",488193
1,403.0,"Middle Africa",131468,0,131468,97008,161681,"AGO",129345
1,403.0,"Eastern Europe",3044197,3033996,10201,2344324,3907207,"POL",3125766
1,403.0,"Central Asia",1736166,1605213,130953,1389006,2315010,"UZB",1852008
1,403.0,"Southern Europe",1064182,0,1064182,812902,1354837,"ITA",1083870
1,403.0,"Central America",247812,0,247812,191623,319372,"MEX",255498
1,403.0,"Southern Asia",914615,0,914615,703466,1172443,"IRN",937955
1,403.0,"Western Asia",1324595,0,1324595,1031520,1719201,"IRQ",1375361
1,403.0,"Eastern Asia",824306,0,824306,603075,1005125,"JPN",804100
1,403.0,"Southern Africa",135612,0,135612,100641,167735,"ZAF",134188
1,403.0,"South-Eastern Asia",1045918,0,1045918,838676,1397793,"IDN",1118235
1,403.0,"Caribbean",172127,0,172127,131804,219673,"CUB",175739
1,404.0,"Pakistan",1919322,1669802,249520,1493199,2488666,"PAK",1990933
1,404.0,"India",6706279,6529230,177049,5160111,8600186,"IND",6880149
1,404.0,"Western Europe",4343996,4319718,24278,3396276,5660460,"NLD",4528368
1,404.0,"China",9475265,8779238,696027,7134837,11891395,"CPR",9513116
1,404.0,"United States of America",2263150,2255618,7532,2080120,3466867,"USA",2773494
1,404.0,"Northern Africa",1667581,0,1667581,1312944,2188241,"EGY",1750593
1,404.0,"Russian Federation",3632581,3625196,7385,2891021,4818368,"RUS",3854695
1,404.0,"Western Africa",508894,0,508894,391163,651938,"NGA",521551
1,404.0,"South America",2093285,1927684,165601,1635509,2725848,"BRA",2180679
1,404.0,"Northern Europe",2161140,2121921,39219,1629090,2715151,"GBR",2172121
1,404.0,"Northern America",641972,635962,6010,472278,787131,"CAN",629705
1,404.0,"Oceania",527419,521889,5530,393768,656281,"NZL",525025
1,404.0,"Eastern Africa",480611,0,480611,366144,610241,"ETH",488193
1,404.0,"Middle Africa",126323,0,126323,97008,161681,"AGO",129345
1,404.0,"Eastern Europe",3155914,3143092,12822,2344324,3907207,"POL",3125766
1,404.0,"Central Asia",1819134,1671436,147698,1389006,2315010,"UZB",1852008
1,404.0,"Southern Europe",998087,0,998087,812902,1354837,"ITA",1083870
1,404.0,"Central America",214967,0,214967,191623,319372,"MEX",255498
1,404.0,"Southern Asia",904201,0,904201,703466,1172443,"IRN",937955
1,404.0,"Western Asia",1299439,0,1299439,1031520,1719201,"IRQ",1375361
1,404.0,"Eastern Asia",750438,0,750438,603075,1005125,"JPN",804100
1,404.0,"Southern Africa",132393,0,132393,100641,167735,"ZAF",134188
1,404.0,"South-Eastern Asia",1095600,0,1095600,838676,1397793,"IDN",1118235
1,404.0,"Caribbean",149890,0,149890,131804,219673,"CUB",175739
1,405.0,"Pakistan",1902268,1671206,231062,1493199,2488666,"PAK",1990933
1,405.0,"India",6696818,6519704,177114,5160111,8600186,"IND",6880149
1,405.0,"Western Europe",4321313,4293027,28286,3396276,5660460,"NLD",4528368
1,405.0,"China",9443160,8758165,684995,7134837,11891395,"CPR",9513116
1,405.0,"United States of America",2621012,2577590,43422,2080120,3466867,"USA",2773494
1,405.0,"Northern Africa",1688382,0,1688382,1312944,2188241,"EGY",1750593
1,405.0,"Russian Federation",3688336,3673802,14534,2891021,4818368,"RUS",3854695
1,405.0,"Western Africa",506055,0,506055,391163,651938,"NGA",521551
1,405.0,"South America",2048149,1928145,120004,1635509,2725848,"BRA",2180679
1,405.0,"Northern Europe",2159355,2127581,31774,1629090,2715151,"GBR",2172121
1,405.0,"Northern America",605439,602006,3433,472278,787131,"CAN",629705
1,405.0,"Oceania",500590,494162,6428,393768,656281,"NZL",525025
1,405.0,"Eastern Africa",473602,0,473602,366144,610241,"ETH",488193
1,405.0,"Middle Africa",125482,0,125482,97008,161681,"AGO",129345
1,405.0,"Eastern Europe",3032060,3019803,12257,2344324,3907207,"POL",3125766
1,405.0,"Central Asia",1776685,1664339,112346,1389006,2315010,"UZB",1852008
1,405.0,"Southern Europe",1038853,0,1038853,812902,1354837,"ITA",1083870
1,405.0,"Central America",244527,0,244527,191623,319372,"MEX",255498
1,405.0,"Southern Asia",904196,0,904196,703466,1172443,"IRN",937955
1,405.0,"Western Asia",1325390,0,1325390,1031520,1719201,"IRQ",1375361
1,405.0,"Eastern Asia",778507,0,778507,603075,1005125,"JPN",804100
1,405.0,"Southern Africa",130046,0,130046,100641,167735,"ZAF",134188
1,405.0,"South-Eastern Asia",1070160,0,1070160,838676,1397793,"IDN",1118235
1,405.0,"Caribbean",168577,0,168577,131804,219673,"CUB",175739
1,406.0,"Pakistan",1892482,1672161,220321,1493199,2488666,"PAK",1990933
1,406.0,"India",6685547,6512289,173258,5160111,8600186,"IND",6880149
1,406.0,"Western Europe",4321229,4290884,30345,3396276,5660460,"NLD",4528368
1,406.0,"China",9502419,8796506,705913,7134837,11891395,"CPR",9513116
1,406.0,"United States of America",2880928,2831106,49822,2080120,3466867,"USA",2773494
1,406.0,"Northern Africa",1677050,0,1677050,1312944,2188241,"EGY",1750593
1,406.0,"Russian Federation",3715570,3698911,16659,2891021,4818368,"RUS",3854695
1,406.0,"Western Africa",489028,0,489028,391163,651938,"NGA",521551
1,406.0,"South America",2035880,1937669,98211,1635509,2725848,"BRA",2180679
1,406.0,"Northern Europe",2054458,2030178,24280,1629090,2715151,"GBR",2172121
1,406.0,"Northern America",564554,562532,2022,472278,787131,"CAN",629705
1,406.0,"Oceania",481447,474297,7150,393768,656281,"NZL",525025
1,406.0,"Eastern Africa",454559,0,454559,366144,610241,"ETH",488193
1,406.0,"Middle Africa",121668,0,121668,97008,161681,"AGO",129345
1,406.0,"Eastern Europe",2939474,2927076,12398,2344324,3907207,"POL",3125766
1,406.0,"Central Asia",1857098,1748013,109085,1389006,2315010,"UZB",1852008
1,406.0,"Southern Europe",1049250,0,1049250,812902,1354837,"ITA",1083870
1,406.0,"Central America",260753,0,260753,191623,319372,"MEX",255498
1,406.0,"Southern Asia",901073,0,901073,703466,1172443,"IRN",937955
1,406.0,"Western Asia",1323885,0,1323885,1031520,1719201,"IRQ",1375361
1,406.0,"Eastern Asia",778989,0,778989,603075,1005125,"JPN",804100
1,406.0,"Southern Africa",125222,0,125222,100641,167735,"ZAF",134188
1,406.0,"South-Eastern Asia",1039761,0,1039761,838676,1397793,"IDN",1118235
1,406.0,"Caribbean",178153,0,178153,131804,219673,"CUB",175739
1,407.0,"Pakistan",1894019,1671236,222783,1493199,2488666,"PAK",1990933
1,407.0,"India",6678442,6519264,159178,5160111,8600186,"IND",6880149
1,407.0,"Western Europe",4392010,4360797,31213,3396276,5660460,"NLD",4528368
1,407.0,"China",9497853,8776840,721013,7134837,11891395,"CPR",9513116
1,407.0,"United States of America",2841996,2808347,33649,2080120,3466867,"USA",2773494
1,407.0,"Northern Africa",1680918,0,1680918,1312944,2188241,"EGY",1750593
1,407.0,"Russian Federation",3776581,3761887,14694,2891021,4818368,"RUS",3854695
1,407.0,"Western Africa",483913,0,483913,391163,651938,"NGA",521551
1,407.0,"South America",2050055,1940939,109116,1635509,2725848,"BRA",2180679
1,407.0,"Northern Europe",2027141,2007873,19268,1629090,2715151,"GBR",2172121
1,407.0,"Northern America",550363,549185,1178,472278,787131,"CAN",629705
1,407.0,"Oceania",531497,524421,7076,393768,656281,"NZL",525025
1,407.0,"Eastern Africa",455440,0,455440,366144,610241,"ETH",488193
1,407.0,"Middle Africa",121111,0,121111,97008,161681,"AGO",129345
1,407.0,"Eastern Europe",2920108,2908186,11922,2344324,3907207,"POL",3125766
1,407.0,"Central Asia",1720757,1661989,58768,1389006,2315010,"UZB",1852008
1,407.0,"Southern Europe",1044876,0,1044876,812902,1354837,"ITA",1083870
1,407.0,"Central America",255826,0,255826,191623,319372,"MEX",255498
1,407.0,"Southern Asia",881308,0,881308,703466,1172443,"IRN",937955
1,407.0,"Western Asia",1315618,0,1315618,1031520,1719201,"IRQ",1375361
1,407.0,"Eastern Asia",772680,0,772680,603075,1005125,"JPN",804100
1,407.0,"Southern Africa",127328,0,127328,100641,167735,"ZAF",134188
1,407.0,"South-Eastern Asia",1116864,0,1116864,838676,1397793,"IDN",1118235
1,407.0,"Caribbean",174569,0,174569,131804,219673,"CUB",175739
1,408.0,"Pakistan",1898115,1676475,221640,1493208,2488681,"PAK",1990945
1,408.0,"India",6642004,6510333,131671,5160123,8600205,"IND",6880164
1,408.0,"Western Europe",4357857,4336897,20960,3396291,5660485,"NLD",4528388
1,408.0,"China",9496173,8764014,732159,7134846,11891411,"CPR",9513129
1,408.0,"United States of America",2710034,2690447,19587,2080130,3466883,"USA",2773507
1,408.0,"Northern Africa",1682062,0,1682062,1312941,2188235,"EGY",1750588
1,408.0,"Russian Federation",3684091,3674534,9557,2891030,4818383,"RUS",3854707
1,408.0,"Western Africa",522221,0,522221,391176,651960,"NGA",521568
1,408.0,"South America",2068388,1943513,124875,1635519,2725866,"BRA",2180693
1,408.0,"Northern Europe",2063105,2046010,17095,1629093,2715155,"GBR",2172124
1,408.0,"Northern America",659978,656590,3388,472287,787145,"CAN",629716
1,408.0,"Oceania",487376,482980,4396,393782,656303,"NZL",525043
1,408.0,"Eastern Africa",485316,0,485316,366150,610250,"ETH",488200
1,408.0,"Middle Africa",128929,0,128929,97013,161688,"AGO",129351
1,408.0,"Eastern Europe",2956944,2945572,11372,2344335,3907225,"POL",3125780
1,408.0,"Central Asia",1774841,1715388,59453,1389018,2315030,"UZB",1852024
1,408.0,"Southern Europe",1052217,0,1052217,812904,1354840,"ITA",1083872
1,408.0,"Central America",253266,0,253266,191622,319370,"MEX",255496
1,408.0,"Southern Asia",908094,0,908094,703470,1172450,"IRN",937960
1,408.0,"Western Asia",1317016,0,1317016,1031525,1719208,"IRQ",1375367
1,408.0,"Eastern Asia",799655,0,799655,603080,1005133,"JPN",804107
1,408.0,"Southern Africa",133848,0,133848,100636,167727,"ZAF",134182
1,408.0,"South-Eastern Asia",1050922,0,1050922,838685,1397808,"IDN",1118247
1,408.0,"Caribbean",174963,0,174963,131811,219686,"CUB",175749
1,409.0,"Pakistan",1909829,1677380,232449,1508074,2513457,"PAK",2010766
1,409.0,"India",6648398,6528383,120015,5289889,8816482,"IND",7053186
1,409.0,"Western Europe",4294841,4274646,20195,3116227,5193712,"NLD",4154970
1,409.0,"China",9532077,8797774,734303,7376602,12294337,"CPR",9835470
1,409.0,"United States of America",2691607,2674748,16859,2017226,3362043,"USA",2689635
1,409.0,"Northern Africa",1677843,0,1677843,1496731,2494552,"EGY",1995642
1,409.0,"Russian Federation",3691520,3680858,10662,1948558,3247597,"RUS",2598078
1,409.0,"Western Africa",497950,0,497950,403191,671985,"NGA",537588
1,409.0,"South America",1933624,1797576,136048,1660710,2767850,"BRA",2214280
1,409.0,"Northern Europe",2081007,2061762,19245,1676103,2793506,"GBR",2234805
1,409.0,"Northern America",591234,589465,1769,416744,694573,"CAN",555659
1,409.0,"Oceania",529188,523097,6091,522726,871211,"NZL",696969
1,409.0,"Eastern Africa",471053,0,471053,377295,628826,"ETH",503061
1,409.0,"Middle Africa",123832,0,123832,98879,164798,"AGO",131839
1,409.0,"Eastern Europe",3014298,3000208,14090,2481602,4136003,"POL",3308803
1,409.0,"Central Asia",1814433,1764432,50001,1342943,2238238,"UZB",1790591
1,409.0,"Southern Europe",1039694,0,1039694,746294,1243823,"ITA",995059
1,409.0,"Central America",247575,0,247575,283083,471806,"MEX",377445
1,409.0,"Southern Asia",904350,0,904350,422361,703936,"IRN",563149
1,409.0,"Western Asia",1326683,0,1326683,913635,1522725,"IRQ",1218180
1,409.0,"Eastern Asia",774285,0,774285,673605,1122675,"JPN",898140
1,409.0,"Southern Africa",130919,0,130919,110583,184306,"ZAF",147445
1,409.0,"South-Eastern Asia",1115082,0,1115082,858231,1430385,"IDN",1144308
1,409.0,"Caribbean",170047,0,170047,136662,227770,"CUB",182216
1,410.0,"Pakistan",1917978,1682110,235868,1508074,2513457,"PAK",2010766
1,410.0,"India",6620528,6505465,115063,5289889,8816482,"IND",7053186
1,410.0,"Western Europe",4430352,4408206,22146,3116227,5193712,"NLD",4154970
1,410.0,"China",9474777,8788002,686775,7376602,12294337,"CPR",9835470
1,410.0,"United States of America",2703347,2689076,14271,2017226,3362043,"USA",2689635
1,410.0,"Northern Africa",1699460,0,1699460,1496731,2494552,"EGY",1995642
1,410.0,"Russian Federation",3776491,3765483,11008,1948558,3247597,"RUS",2598078
1,410.0,"Western Africa",495952,0,495952,403191,671985,"NGA",537588
1,410.0,"South America",1978859,1804434,174425,1660710,2767850,"BRA",2214280
1,410.0,"Northern Europe",2090282,2071196,19086,1676103,2793506,"GBR",2234805
1,410.0,"Northern America",570654,569637,1017,416744,694573,"CAN",555659
1,410.0,"Oceania",559427,556300,3127,522726,871211,"NZL",696969
1,410.0,"Eastern Africa",468834,0,468834,377295,628826,"ETH",503061
1,410.0,"Middle Africa",124132,0,124132,98879,164798,"AGO",131839
1,410.0,"Eastern Europe",2992831,2978973,13858,2481602,4136003,"POL",3308803
1,410.0,"Central Asia",1766318,1731907,34411,1342943,2238238,"UZB",1790591
1,410.0,"Southern Europe",1049745,0,1049745,746294,1243823,"ITA",995059
1,410.0,"Central America",245932,0,245932,283083,471806,"MEX",377445
1,410.0,"Southern Asia",900143,0,900143,422361,703936,"IRN",563149
1,410.0,"Western Asia",1329264,0,1329264,913635,1522725,"IRQ",1218180
1,410.0,"Eastern Asia",772522,0,772522,673605,1122675,"JPN",898140
1,410.0,"Southern Africa",132138,0,132138,110583,184306,"ZAF",147445
1,410.0,"South-Eastern Asia",1166264,0,1166264,858231,1430385,"IDN",1144308
1,410.0,"Caribbean",168429,0,168429,136662,227770,"CUB",182216
1,411.0,"Pakistan",1945092,1689174,255918,1508074,2513457,"PAK",2010766
1,411.0,"India",6671984,6552709,119275,5289889,8816482,"IND",7053186
1,411.0,"Western Europe",4296462,4280090,16372,3116227,5193712,"NLD",4154970
1,411.0,"China",9458365,8801514,656851,7376602,12294337,"CPR",9835470
1,411.0,"United States of America",2628599,2618732,9867,2017226,3362043,"USA",2689635
1,411.0,"Northern Africa",1825720,0,1825720,1496731,2494552,"EGY",1995642
1,411.0,"Russian Federation",3551460,3543734,7726,1948558,3247597,"RUS",2598078
1,411.0,"Western Africa",536452,0,536452,403191,671985,"NGA",537588
1,411.0,"South America",2023751,1797775,225976,1660710,2767850,"BRA",2214280
1,411.0,"Northern Europe",2140901,2123302,17599,1676103,2793506,"GBR",2234805
1,411.0,"Northern America",634083,631350,2733,416744,694573,"CAN",555659
1,411.0,"Oceania",551484,549214,2270,522726,871211,"NZL",696969
1,411.0,"Eastern Africa",499148,0,499148,377295,628826,"ETH",503061
1,411.0,"Middle Africa",131038,0,131038,98879,164798,"AGO",131839
1,411.0,"Eastern Europe",3066787,3051629,15158,2481602,4136003,"POL",3308803
1,411.0,"Central Asia",1818083,1781677,36406,1342943,2238238,"UZB",1790591
1,411.0,"Southern Europe",1020073,0,1020073,746294,1243823,"ITA",995059
1,411.0,"Central America",302966,0,302966,283083,471806,"MEX",377445
1,411.0,"Southern Asia",784636,0,784636,422361,703936,"IRN",563149
1,411.0,"Western Asia",1297835,0,1297835,913635,1522725,"IRQ",1218180
1,411.0,"Eastern Asia",862495,0,862495,673605,1122675,"JPN",898140
1,411.0,"Southern Africa",138998,0,138998,110583,184306,"ZAF",147445
1,411.0,"South-Eastern Asia",1067727,0,1067727,858231,1430385,"IDN",1144308
1,411.0,"Caribbean",176716,0,176716,136662,227770,"CUB",182216
1,412.0,"Pakistan",1970084,1692445,277639,1508074,2513457,"PAK",2010766
1,412.0,"India",6697824,6571932,125892,5289889,8816482,"IND",7053186
1,412.0,"Western Europe",4256581,4237792,18789,3116227,5193712,"NLD",4154970
1,412.0,"China",9439970,8777834,662136,7376602,12294337,"CPR",9835470
1,412.0,"United States of America",2759685,2746596,13089,2017226,3362043,"USA",2689635
1,412.0,"Northern Africa",1914571,0,1914571,1496731,2494552,"EGY",1995642
1,412.0,"Russian Federation",3277450,3274081,3369,1948558,3247597,"RUS",2598078
1,412.0,"Western Africa",517676,0,517676,403191,671985,"NGA",537588
1,412.0,"South America",2080759,1798226,282533,1660710,2767850,"BRA",2214280
1,412.0,"Northern Europe",2130591,2109000,21591,1676103,2793506,"GBR",2234805
1,412.0,"Northern America",550027,548522,1505,416744,694573,"CAN",555659
1,412.0,"Oceania",608332,602757,5575,522726,871211,"NZL",696969
1,412.0,"Eastern Africa",483269,0,483269,377295,628826,"ETH",503061
1,412.0,"Middle Africa",127573,0,127573,98879,164798,"AGO",131839
1,412.0,"Eastern Europe",3165477,3141296,24181,2481602,4136003,"POL",3308803
1,412.0,"Central Asia",1807830,1771578,36252,1342943,2238238,"UZB",1790591
1,412.0,"Southern Europe",1020234,0,1020234,746294,1243823,"ITA",995059
1,412.0,"Central America",339941,0,339941,283083,471806,"MEX",377445
1,412.0,"Southern Asia",690695,0,690695,422361,703936,"IRN",563149
1,412.0,"Western Asia",1288123,0,1288123,913635,1522725,"IRQ",1218180
1,412.0,"Eastern Asia",882736,0,882736,673605,1122675,"JPN",898140
1,412.0,"Southern Africa",137338,0,137338,110583,184306,"ZAF",147445
1,412.0,"South-Eastern Asia",1100217,0,1100217,858231,1430385,"IDN",1144308
1,412.0,"Caribbean",179933,0,179933,136662,227770,"CUB",182216
1,413.0,"Pakistan",1981193,1686329,294864,1508074,2513457,"PAK",2010766
1,413.0,"India",7001190,6853847,147343,5289889,8816482,"IND",7053186
1,413.0,"Western Europe",4196138,4171032,25106,3116227,5193712,"NLD",4154970
1,413.0,"China",9465437,8787669,677768,7376602,12294337,"CPR",9835470
1,413.0,"United States of America",2717486,2706281,11205,2017226,3362043,"USA",2689635
1,413.0,"Northern Africa",1958097,0,1958097,1496731,2494552,"EGY",1995642
1,413.0,"Russian Federation",2937236,2935510,1726,1948558,3247597,"RUS",2598078
1,413.0,"Western Africa",528003,0,528003,403191,671985,"NGA",537588
1,413.0,"South America",2138444,1799114,339330,1660710,2767850,"BRA",2214280
1,413.0,"Northern Europe",2204184,2168519,35665,1676103,2793506,"GBR",2234805
1,413.0,"Northern America",548242,543364,4878,416744,694573,"CAN",555659
1,413.0,"Oceania",666049,656812,9237,522726,871211,"NZL",696969
1,413.0,"Eastern Africa",497617,0,497617,377295,628826,"ETH",503061
1,413.0,"Middle Africa",130342,0,130342,98879,164798,"AGO",131839
1,413.0,"Eastern Europe",3269405,3231911,37494,2481602,4136003,"POL",3308803
1,413.0,"Central Asia",1793607,1756591,37016,1342943,2238238,"UZB",1790591
1,413.0,"Southern Europe",1013911,0,1013911,746294,1243823,"ITA",995059
1,413.0,"Central America",356931,0,356931,283083,471806,"MEX",377445
1,413.0,"Southern Asia",639010,0,639010,422361,703936,"IRN",563149
1,413.0,"Western Asia",1268203,0,1268203,913635,1522725,"IRQ",1218180
1,413.0,"Eastern Asia",890765,0,890765,673605,1122675,"JPN",898140
1,413.0,"Southern Africa",143851,0,143851,110583,184306,"ZAF",147445
1,413.0,"South-Eastern Asia",1146594,0,1146594,858231,1430385,"IDN",1144308
1,413.0,"Caribbean",180992,0,180992,136662,227770,"CUB",182216
1,414.0,"Pakistan",2229101,1914476,314625,1508074,2513457,"PAK",2010766
1,414.0,"India",6988457,6829270,159187,5289889,8816482,"IND",7053186
1,414.0,"Western Europe",4179388,4147836,31552,3116227,5193712,"NLD",4154970
1,414.0,"China",9475208,8760682,714526,7376602,12294337,"CPR",9835470
1,414.0,"United States of America",2693744,2682224,11520,2017226,3362043,"USA",2689635
1,414.0,"Northern Africa",1985854,0,1985854,1496731,2494552,"EGY",1995642
1,414.0,"Russian Federation",2687510,2686590,920,1948558,3247597,"RUS",2598078
1,414.0,"Western Africa",534876,0,534876,403191,671985,"NGA",537588
1,414.0,"South America",2195852,1799851,396001,1660710,2767850,"BRA",2214280
1,414.0,"Northern Europe",2257291,2211679,45612,1676103,2793506,"GBR",2234805
1,414.0,"Northern America",551635,542943,8692,416744,694573,"CAN",555659
1,414.0,"Oceania",679515,668124,11391,522726,871211,"NZL",696969
1,414.0,"Eastern Africa",501863,0,501863,377295,628826,"ETH",503061
1,414.0,"Middle Africa",131656,0,131656,98879,164798,"AGO",131839
1,414.0,"Eastern Europe",3404783,3358111,46672,2481602,4136003,"POL",3308803
1,414.0,"Central Asia",1800126,1760364,39762,1342943,2238238,"UZB",1790591
1,414.0,"Southern Europe",1011674,0,1011674,746294,1243823,"ITA",995059
1,414.0,"Central America",365463,0,365463,283083,471806,"MEX",377445
1,414.0,"Southern Asia",608100,0,608100,422361,703936,"IRN",563149
1,414.0,"Western Asia",1256981,0,1256981,913635,1522725,"IRQ",1218180
1,414.0,"Eastern Asia",884863,0,884863,673605,1122675,"JPN",898140
1,414.0,"Southern Africa",145834,0,145834,110583,184306,"ZAF",147445
1,414.0,"South-Eastern Asia",1140468,0,1140468,858231,1430385,"IDN",1144308
1,414.0,"Caribbean",181348,0,181348,136662,227770,"CUB",182216
1,415.0,"Pakistan",2073183,1847733,225450,1508074,2513457,"PAK",2010766
1,415.0,"India",7011759,6838930,172829,5289889,8816482,"IND",7053186
1,415.0,"Western Europe",4205708,4168990,36718,3116227,5193712,"NLD",4154970
1,415.0,"China",9518745,8765522,753223,7376602,12294337,"CPR",9835470
1,415.0,"United States of America",2795336,2784321,11015,2017226,3362043,"USA",2689635
1,415.0,"Northern Africa",1990904,0,1990904,1496731,2494552,"EGY",1995642
1,415.0,"Russian Federation",2529029,2528526,503,1948558,3247597,"RUS",2598078
1,415.0,"Western Africa",526729,0,526729,403191,671985,"NGA",537588
1,415.0,"South America",2251210,1805691,445519,1660710,2767850,"BRA",2214280
1,415.0,"Northern Europe",2277134,2228677,48457,1676103,2793506,"GBR",2234805
1,415.0,"Northern America",531981,521538,10443,416744,694573,"CAN",555659
1,415.0,"Oceania",695485,683745,11740,522726,871211,"NZL",696969
1,415.0,"Eastern Africa",492116,0,492116,377295,628826,"ETH",503061
1,415.0,"Middle Africa",129995,0,129995,98879,164798,"AGO",131839
1,415.0,"Eastern Europe",3362971,3323318,39653,2481602,4136003,"POL",3308803
1,415.0,"Central Asia",1818653,1775404,43249,1342943,2238238,"UZB",1790591
1,415.0,"Southern Europe",1009005,0,1009005,746294,1243823,"ITA",995059
1,415.0,"Central America",378212,0,378212,283083,471806,"MEX",377445
1,415.0,"Southern Asia",579046,0,579046,422361,703936,"IRN",563149
1,415.0,"Western Asia",1224662,0,1224662,913635,1522725,"IRQ",1218180
1,415.0,"Eastern Asia",871500,0,871500,673605,1122675,"JPN",898140
1,415.0,"Southern Africa",144596,0,144596,110583,184306,"ZAF",147445
1,415.0,"South-Eastern Asia",1141859,0,1141859,858231,1430385,"IDN",1144308
1,415.0,"Caribbean",184435,0,184435,136662,227770,"CUB",182216
1,416.0,"Pakistan",1968814,1831314,137500,1508074,2513457,"PAK",2010766
1,416.0,"India",6993815,6845997,147818,5289889,8816482,"IND",7053186
1,416.0,"Western Europe",4122137,4093425,28712,3116227,5193712,"NLD",4154970
1,416.0,"China",9838342,9113303,725039,7376602,12294337,"CPR",9835470
1,416.0,"United States of America",2939050,2934719,4331,2017226,3362043,"USA",2689635
1,416.0,"Northern Africa",1828719,0,1828719,1496731,2494552,"EGY",1995642
1,416.0,"Russian Federation",1668443,1668216,227,1948558,3247597,"RUS",2598078
1,416.0,"Western Africa",540185,0,540185,403191,671985,"NGA",537588
1,416.0,"South America",2276441,1807449,468992,1660710,2767850,"BRA",2214280
1,416.0,"Northern Europe",2271616,2234548,37068,1676103,2793506,"GBR",2234805
1,416.0,"Northern America",611554,600119,11435,416744,694573,"CAN",555659
1,416.0,"Oceania",693985,689575,4410,522726,871211,"NZL",696969
1,416.0,"Eastern Africa",483619,0,483619,377295,628826,"ETH",503061
1,416.0,"Middle Africa",129341,0,129341,98879,164798,"AGO",131839
1,416.0,"Eastern Europe",2908041,2879209,28832,2481602,4136003,"POL",3308803
1,416.0,"Central Asia",1816410,1785788,30622,1342943,2238238,"UZB",1790591
1,416.0,"Southern Europe",967598,0,967598,746294,1243823,"ITA",995059
1,416.0,"Central America",385533,0,385533,283083,471806,"MEX",377445
1,416.0,"Southern Asia",490845,0,490845,422361,703936,"IRN",563149
1,416.0,"Western Asia",1012948,0,1012948,913635,1522725,"IRQ",1218180
1,416.0,"Eastern Asia",785004,0,785004,673605,1122675,"JPN",898140
1,416.0,"Southern Africa",143690,0,143690,110583,184306,"ZAF",147445
1,416.0,"South-Eastern Asia",1059553,0,1059553,858231,1430385,"IDN",1144308
1,416.0,"Caribbean",188613,0,188613,136662,227770,"CUB",182216
1,417.0,"Pakistan",1906214,1797933,108281,1508074,2513457,"PAK",2010766
1,417.0,"India",6959400,6820650,138750,5289889,8816482,"IND",7053186
1,417.0,"Western Europe",4082782,4049906,32876,3116227,5193712,"NLD",4154970
1,417.0,"China",9750962,9100225,650737,7376602,12294337,"CPR",9835470
1,417.0,"United States of America",2688231,2685403,2828,2017226,3362043,"USA",2689635
1,417.0,"Northern Africa",1890847,0,1890847,1496731,2494552,"EGY",1995642
1,417.0,"Russian Federation",2041048,1939868,101180,1948558,3247597,"RUS",2598078
1,417.0,"Western Africa",532220,0,532220,403191,671985,"NGA",537588
1,417.0,"South America",2251314,1799786,451528,1660710,2767850,"BRA",2214280
1,417.0,"Northern Europe",2346766,2309657,37109,1676103,2793506,"GBR",2234805
1,417.0,"Northern America",561611,552425,9186,416744,694573,"CAN",555659
1,417.0,"Oceania",672722,666193,6529,522726,871211,"NZL",696969
1,417.0,"Eastern Africa",487009,0,487009,377295,628826,"ETH",503061
1,417.0,"Middle Africa",129181,0,129181,98879,164798,"AGO",131839
1,417.0,"Eastern Europe",2986531,2930409,56122,2481602,4136003,"POL",3308803
1,417.0,"Central Asia",1763064,1735780,27284,1342943,2238238,"UZB",1790591
1,417.0,"Southern Europe",971082,0,971082,746294,1243823,"ITA",995059
1,417.0,"Central America",372663,0,372663,283083,471806,"MEX",377445
1,417.0,"Southern Asia",522233,0,522233,422361,703936,"IRN",563149
1,417.0,"Western Asia",1093940,0,1093940,913635,1522725,"IRQ",1218180
1,417.0,"Eastern Asia",830463,0,830463,673605,1122675,"JPN",898140
1,417.0,"Southern Africa",143488,0,143488,110583,184306,"ZAF",147445
1,417.0,"South-Eastern Asia",1085678,0,1085678,858231,1430385,"IDN",1144308
1,417.0,"Caribbean",181054,0,181054,136662,227770,"CUB",182216
1,418.0,"Pakistan",1885606,1791032,94574,1508074,2513457,"PAK",2010766
1,418.0,"India",6933966,6802307,131659,5289889,8816482,"IND",7053186
1,418.0,"Western Europe",4038562,4002665,35897,3116227,5193712,"NLD",4154970
1,418.0,"China",9688726,9087891,600835,7376602,12294337,"CPR",9835470
1,418.0,"United States of America",2514783,2512806,1977,2017226,3362043,"USA",2689635
1,418.0,"Northern Africa",1915897,0,1915897,1496731,2494552,"EGY",1995642
1,418.0,"Russian Federation",2342338,2157414,184924,1948558,3247597,"RUS",2598078
1,418.0,"Western Africa",522882,0,522882,403191,671985,"NGA",537588
1,418.0,"South America",2238995,1801264,437731,1660710,2767850,"BRA",2214280
1,418.0,"Northern Europe",2269334,2237826,31508,1676103,2793506,"GBR",2234805
1,418.0,"Northern America",536966,529323,7643,416744,694573,"CAN",555659
1,418.0,"Oceania",659540,652103,7437,522726,871211,"NZL",696969
1,418.0,"Eastern Africa",486532,0,486532,377295,628826,"ETH",503061
1,418.0,"Middle Africa",128122,0,128122,98879,164798,"AGO",131839
1,418.0,"Eastern Europe",3059639,2977034,82605,2481602,4136003,"POL",3308803
1,418.0,"Central Asia",1808819,1783379,25440,1342943,2238238,"UZB",1790591
1,418.0,"Southern Europe",962149,0,962149,746294,1243823,"ITA",995059
1,418.0,"Central America",357081,0,357081,283083,471806,"MEX",377445
1,418.0,"Southern Asia",546631,0,546631,422361,703936,"IRN",563149
1,418.0,"Western Asia",1148828,0,1148828,913635,1522725,"IRQ",1218180
1,418.0,"Eastern Asia",854177,0,854177,673605,1122675,"JPN",898140
1,418.0,"Southern Africa",142448,0,142448,110583,184306,"ZAF",147445
1,418.0,"South-Eastern Asia",1096142,0,1096142,858231,1430385,"IDN",1144308
1,418.0,"Caribbean",173161,0,173161,136662,227770,"CUB",182216
1,419.0,"Pakistan",1884024,1796755,87269,1508074,2513457,"PAK",2010766
1,419.0,"India",6914486,6796509,117977,5289889,8816482,"IND",7053186
1,419.0,"Western Europe",4009861,3972419,37442,3116227,5193712,"NLD",4154970
1,419.0,"China",9643139,9079540,563599,7376602,12294337,"CPR",9835470
1,419.0,"United States of America",2489376,2487936,1440,2017226,3362043,"USA",2689635
1,419.0,"Northern Africa",1929989,0,1929989,1496731,2494552,"EGY",1995642
1,419.0,"Russian Federation",2597541,2357781,239760,1948558,3247597,"RUS",2598078
1,419.0,"Western Africa",516234,0,516234,403191,671985,"NGA",537588
1,419.0,"South America",2220174,1805887,414287,1660710,2767850,"BRA",2214280
1,419.0,"Northern Europe",2149501,2130761,18740,1676103,2793506,"GBR",2234805
1,419.0,"Northern America",522440,517427,5013,416744,694573,"CAN",555659
1,419.0,"Oceania",653614,648559,5055,522726,871211,"NZL",696969
1,419.0,"Eastern Africa",484490,0,484490,377295,628826,"ETH",503061
1,419.0,"Middle Africa",127055,0,127055,98879,164798,"AGO",131839
1,419.0,"Eastern Europe",3133740,3028766,104974,2481602,4136003,"POL",3308803
1,419.0,"Central Asia",1708250,1691333,16917,1342943,2238238,"UZB",1790591
1,419.0,"Southern Europe",959048,0,959048,746294,1243823,"ITA",995059
1,419.0,"Central America",354869,0,354869,283083,471806,"MEX",377445
1,419.0,"Southern Asia",553089,0,553089,422361,703936,"IRN",563149
1,419.0,"Western Asia",1185288,0,1185288,913635,1522725,"IRQ",1218180
1,419.0,"Eastern Asia",873601,0,873601,673605,1122675,"JPN",898140
1,419.0,"Southern Africa",141312,0,141312,110583,184306,"ZAF",147445
1,419.0,"South-Eastern Asia",1098342,0,1098342,858231,1430385,"IDN",1144308
1,419.0,"Caribbean",170996,0,170996,136662,227770,"CUB",182216
1,420.0,"Pakistan",1886229,1804992,81237,1508081,2513468,"PAK",2010775
1,420.0,"India",6899018,6803854,95164,5289899,8816498,"IND",7053199
1,420.0,"Western Europe",4008836,3972642,36194,3116236,5193727,"NLD",4154982
1,420.0,"China",9608742,9076436,532306,7376605,12294342,"CPR",9835474
1,420.0,"United States of America",2467966,2467014,952,2017234,3362057,"USA",2689646
1,420.0,"Northern Africa",1936063,0,1936063,1496728,2494547,"EGY",1995638
1,420.0,"Russian Federation",2785555,2533125,252430,1948567,3247612,"RUS",2598090
1,420.0,"Western Africa",508974,0,508974,403192,671987,"NGA",537590
1,420.0,"South America",2197015,1802874,394141,1660710,2767850,"BRA",2214280
1,420.0,"Northern Europe",2047914,2036231,11683,1676109,2793515,"GBR",2234812
1,420.0,"Northern America",512623,509272,3351,416757,694596,"CAN",555677
1,420.0,"Oceania",658310,655155,3155,522738,871231,"NZL",696985
1,420.0,"Eastern Africa",480326,0,480326,377290,628817,"ETH",503054
1,420.0,"Middle Africa",125557,0,125557,98881,164802,"AGO",131842
1,420.0,"Eastern Europe",3210821,3090970,119851,2481607,4136012,"POL",3308810
1,420.0,"Central Asia",1653428,1641677,11751,1342947,2238245,"UZB",1790596
1,420.0,"Southern Europe",953405,0,953405,746298,1243830,"ITA",995064
1,420.0,"Central America",351037,0,351037,283086,471810,"MEX",377448
1,420.0,"Southern Asia",554833,0,554833,422361,703936,"IRN",563149
1,420.0,"Western Asia",1205674,0,1205674,913641,1522735,"IRQ",1218188
1,420.0,"Eastern Asia",880620,0,880620,673613,1122688,"JPN",898151
1,420.0,"Southern Africa",140022,0,140022,110583,184306,"ZAF",147445
1,420.0,"South-Eastern Asia",1101371,0,1101371,858234,1430391,"IDN",1144313
1,420.0,"Caribbean",169784,0,169784,136670,227783,"CUB",182227
1,421.0,"Pakistan",1902043,1826546,75497,1558435,2597392,"PAK",2077914
1,421.0,"India",6852798,6794719,58079,5404003,9006672,"IND",7205338
1,421.0,"Western Europe",3889475,3865815,23660,3276431,5460718,"NLD",4368575
1,421.0,"China",9585044,9066230,518814,8238777,13731295,"CPR",10985036
1,421.0,"United States of America",2484023,2483382,641,2110288,3517147,"USA",2813718
1,421.0,"Northern Africa",1921794,0,1921794,1584441,2640735,"EGY",2112588
1,421.0,"Russian Federation",2799128,2597703,201425,2164755,3607926,"RUS",2886341
1,421.0,"Western Africa",502980,0,502980,402539,670898,"NGA",536719
1,421.0,"South America",2134170,1773683,360487,1693779,2822966,"BRA",2258373
1,421.0,"Northern Europe",2039110,2031617,7493,1683611,2806018,"GBR",2244815
1,421.0,"Northern America",512432,510254,2178,514290,857151,"CAN",685721
1,421.0,"Oceania",666949,664985,1964,450459,750766,"NZL",600613
1,421.0,"Eastern Africa",479310,0,479310,440108,733513,"ETH",586811
1,421.0,"Middle Africa",124192,0,124192,114302,190503,"AGO",152403
1,421.0,"Eastern Europe",3358201,3230951,127250,2593692,4322821,"POL",3458257
1,421.0,"Central Asia",1663880,1656448,7432,1458921,2431536,"UZB",1945229
1,421.0,"Southern Europe",941510,0,941510,724197,1206995,"ITA",965596
1,421.0,"Central America",352234,0,352234,293259,488765,"MEX",391012
1,421.0,"Southern Asia",557428,0,557428,420205,700342,"IRN",560274
1,421.0,"Western Asia",1226235,0,1226235,1232155,2053592,"IRQ",1642874
1,421.0,"Eastern Asia",878293,0,878293,752492,1254153,"JPN",1003323
1,421.0,"Southern Africa",139798,0,139798,137471,229118,"ZAF",183295
1,421.0,"South-Eastern Asia",1106097,0,1106097,975390,1625650,"IDN",1300520
1,421.0,"Caribbean",170090,0,170090,133993,223322,"CUB",178658
1,422.0,"Pakistan",1920085,1857826,62259,1558435,2597392,"PAK",2077914
1,422.0,"India",6822436,6781504,40932,5404003,9006672,"IND",7205338
1,422.0,"Western Europe",3907784,3889858,17926,3276431,5460718,"NLD",4368575
1,422.0,"China",9524560,9095367,429193,8238777,13731295,"CPR",10985036
1,422.0,"United States of America",2650489,2650099,390,2110288,3517147,"USA",2813718
1,422.0,"Northern Africa",1931751,0,1931751,1584441,2640735,"EGY",2112588
1,422.0,"Russian Federation",2621978,2500070,121908,2164755,3607926,"RUS",2886341
1,422.0,"Western Africa",517275,0,517275,402539,670898,"NGA",536719
1,422.0,"South America",2135839,1771808,364031,1693779,2822966,"BRA",2258373
1,422.0,"Northern Europe",2027426,2022811,4615,1683611,2806018,"GBR",2244815
1,422.0,"Northern America",536748,535391,1357,514290,857151,"CAN",685721
1,422.0,"Oceania",681842,680615,1227,450459,750766,"NZL",600613
1,422.0,"Eastern Africa",489637,0,489637,440108,733513,"ETH",586811
1,422.0,"Middle Africa",126856,0,126856,114302,190503,"AGO",152403
1,422.0,"Eastern Europe",3322130,3218806,103324,2593692,4322821,"POL",3458257
1,422.0,"Central Asia",1685008,1678097,6911,1458921,2431536,"UZB",1945229
1,422.0,"Southern Europe",959358,0,959358,724197,1206995,"ITA",965596
1,422.0,"Central America",372692,0,372692,293259,488765,"MEX",391012
1,422.0,"Southern Asia",551785,0,551785,420205,700342,"IRN",560274
1,422.0,"Western Asia",1210089,0,1210089,1232155,2053592,"IRQ",1642874
1,422.0,"Eastern Asia",888650,0,888650,752492,1254153,"JPN",1003323
1,422.0,"Southern Africa",143421,0,143421,137471,229118,"ZAF",183295
1,422.0,"South-Eastern Asia",1122319,0,1122319,975390,1625650,"IDN",1300520
1,422.0,"Caribbean",180310,0,180310,133993,223322,"CUB",178658
1,423.0,"Pakistan",1943303,1881846,61457,1558435,2597392,"PAK",2077914
1,423.0,"India",6819077,6792097,26980,5404003,9006672,"IND",7205338
1,423.0,"Western Europe",3949741,3932679,17062,3276431,5460718,"NLD",4368575
1,423.0,"China",9510425,9105410,405015,8238777,13731295,"CPR",10985036
1,423.0,"United States of America",2537564,2537316,248,2110288,3517147,"USA",2813718
1,423.0,"Northern Africa",1921211,0,1921211,1584441,2640735,"EGY",2112588
1,423.0,"Russian Federation",2649680,2558610,91070,2164755,3607926,"RUS",2886341
1,423.0,"Western Africa",495414,0,495414,402539,670898,"NGA",536719
1,423.0,"South America",2109936,1770907,339029,1693779,2822966,"BRA",2258373
1,423.0,"Northern Europe",2160232,2153010,7222,1683611,2806018,"GBR",2244815
1,423.0,"Northern America",546409,544946,1463,514290,857151,"CAN",685721
1,423.0,"Oceania",625195,624514,681,450459,750766,"NZL",600613
1,423.0,"Eastern Africa",498453,0,498453,440108,733513,"ETH",586811
1,423.0,"Middle Africa",129768,0,129768,114302,190503,"AGO",152403
1,423.0,"Eastern Europe",3233787,3154742,79045,2593692,4322821,"POL",3458257
1,423.0,"Central Asia",1707439,1701926,5513,1458921,2431536,"UZB",1945229
1,423.0,"Southern Europe",920493,0,920493,724197,1206995,"ITA",965596
1,423.0,"Central America",355455,0,355455,293259,488765,"MEX",391012
1,423.0,"Southern Asia",532845,0,532845,420205,700342,"IRN",560274
1,423.0,"Western Asia",1317237,0,1317237,1232155,2053592,"IRQ",1642874
1,423.0,"Eastern Asia",882734,0,882734,752492,1254153,"JPN",1003323
1,423.0,"Southern Africa",151275,0,151275,137471,229118,"ZAF",183295
1,423.0,"South-Eastern Asia",1146074,0,1146074,975390,1625650,"IDN",1300520
1,423.0,"Caribbean",167802,0,167802,133993,223322,"CUB",178658
1,424.0,"Pakistan",1936201,1894064,42137,1558435,2597392,"PAK",2077914
1,424.0,"India",6775602,6758643,16959,5404003,9006672,"IND",7205338
1,424.0,"Western Europe",3945509,3929820,15689,3276431,5460718,"NLD",4368575
1,424.0,"China",9508386,9130578,377808,8238777,13731295,"CPR",10985036
1,424.0,"United States of America",2574504,2574347,157,2110288,3517147,"USA",2813718
1,424.0,"Northern Africa",1922967,0,1922967,1584441,2640735,"EGY",2112588
1,424.0,"Russian Federation",2608410,2549742,58668,2164755,3607926,"RUS",2886341
1,424.0,"Western Africa",510689,0,510689,402539,670898,"NGA",536719
1,424.0,"South America",2113734,1774199,339535,1693779,2822966,"BRA",2258373
1,424.0,"Northern Europe",2068732,2064216,4516,1683611,2806018,"GBR",2244815
1,424.0,"Northern America",624254,622025,2229,514290,857151,"CAN",685721
1,424.0,"Oceania",588133,587802,331,450459,750766,"NZL",600613
1,424.0,"Eastern Africa",527600,0,527600,440108,733513,"ETH",586811
1,424.0,"Middle Africa",136914,0,136914,114302,190503,"AGO",152403
1,424.0,"Eastern Europe",3172421,3103891,68530,2593692,4322821,"POL",3458257
1,424.0,"Central Asia",1733589,1728070,5519,1458921,2431536,"UZB",1945229
1,424.0,"Southern Europe",912039,0,912039,724197,1206995,"ITA",965596
1,424.0,"Central America",360194,0,360194,293259,488765,"MEX",391012
1,424.0,"Southern Asia",526304,0,526304,420205,700342,"IRN",560274
1,424.0,"Western Asia",1379838,0,1379838,1232155,2053592,"IRQ",1642874
1,424.0,"Eastern Asia",915001,0,915001,752492,1254153,"JPN",1003323
1,424.0,"Southern Africa",160127,0,160127,137471,229118,"ZAF",183295
1,424.0,"South-Eastern Asia",1153720,0,1153720,975390,1625650,"IDN",1300520
1,424.0,"Caribbean",168212,0,168212,133993,223322,"CUB",178658
1,425.0,"Pakistan",1918609,1886874,31735,1558435,2597392,"PAK",2077914
1,425.0,"India",6739829,6728923,10906,5404003,9006672,"IND",7205338
1,425.0,"Western Europe",3976591,3959838,16753,3276431,5460718,"NLD",4368575
1,425.0,"China",9514161,9129957,384204,8238777,13731295,"CPR",10985036
1,425.0,"United States of America",2593253,2592834,419,2110288,3517147,"USA",2813718
1,425.0,"Northern Africa",1933017,0,1933017,1584441,2640735,"EGY",2112588
1,425.0,"Russian Federation",2687795,2646342,41453,2164755,3607926,"RUS",2886341
1,425.0,"Western Africa",499701,0,499701,402539,670898,"NGA",536719
1,425.0,"South America",2075524,1770949,304575,1693779,2822966,"BRA",2258373
1,425.0,"Northern Europe",2049479,2045741,3738,1683611,2806018,"GBR",2244815
1,425.0,"Northern America",611856,610410,1446,514290,857151,"CAN",685721
1,425.0,"Oceania",567681,567468,213,450459,750766,"NZL",600613
1,425.0,"Eastern Africa",526942,0,526942,440108,733513,"ETH",586811
1,425.0,"Middle Africa",137133,0,137133,114302,190503,"AGO",152403
1,425.0,"Eastern Europe",3177205,3109841,67364,2593692,4322821,"POL",3458257
1,425.0,"Central Asia",1755793,1751028,4765,1458921,2431536,"UZB",1945229
1,425.0,"Southern Europe",903558,0,903558,724197,1206995,"ITA",965596
1,425.0,"Central America",361901,0,361901,293259,488765,"MEX",391012
1,425.0,"Southern Asia",524969,0,524969,420205,700342,"IRN",560274
1,425.0,"Western Asia",1432709,0,1432709,1232155,2053592,"IRQ",1642874
1,425.0,"Eastern Asia",917890,0,917890,752492,1254153,"JPN",1003323
1,425.0,"Southern Africa",161428,0,161428,137471,229118,"ZAF",183295
1,425.0,"South-Eastern Asia",1158803,0,1158803,975390,1625650,"IDN",1300520
1,425.0,"Caribbean",167348,0,167348,133993,223322,"CUB",178658
1,426.0,"Pakistan",2269030,2243045,25985,1558435,2597392,"PAK",2077914
1,426.0,"India",6631843,6624732,7111,5404003,9006672,"IND",7205338
1,426.0,"Western Europe",4012925,3995665,17260,3276431,5460718,"NLD",4368575
1,426.0,"China",9535675,9134035,401640,8238777,13731295,"CPR",10985036
1,426.0,"United States of America",2614983,2614787,196,2110288,3517147,"USA",2813718
1,426.0,"Northern Africa",1949477,0,1949477,1584441,2640735,"EGY",2112588
1,426.0,"Russian Federation",2635293,2608012,27281,2164755,3607926,"RUS",2886341
1,426.0,"Western Africa",492854,0,492854,402539,670898,"NGA",536719
1,426.0,"South America",2069721,1768131,301590,1693779,2822966,"BRA",2258373
1,426.0,"Northern Europe",2055450,2051848,3602,1683611,2806018,"GBR",2244815
1,426.0,"Northern America",601017,600066,951,514290,857151,"CAN",685721
1,426.0,"Oceania",569265,569265,0,450459,750766,"NZL",600613
1,426.0,"Eastern Africa",526357,0,526357,440108,733513,"ETH",586811
1,426.0,"Middle Africa",137152,0,137152,114302,190503,"AGO",152403
1,426.0,"Eastern Europe",3230452,3163143,67309,2593692,4322821,"POL",3458257
1,426.0,"Central Asia",1766988,1761865,5123,1458921,2431536,"UZB",1945229
1,426.0,"Southern Europe",900896,0,900896,724197,1206995,"ITA",965596
1,426.0,"Central America",363195,0,363195,293259,488765,"MEX",391012
1,426.0,"Southern Asia",519233,0,519233,420205,700342,"IRN",560274
1,426.0,"Western Asia",1468332,0,1468332,1232155,2053592,"IRQ",1642874
1,426.0,"Eastern Asia",911439,0,911439,752492,1254153,"JPN",1003323
1,426.0,"Southern Africa",163642,0,163642,137471,229118,"ZAF",183295
1,426.0,"South-Eastern Asia",1183360,0,1183360,975390,1625650,"IDN",1300520
1,426.0,"Caribbean",167302,0,167302,133993,223322,"CUB",178658
1,427.0,"Pakistan",2122112,2105584,16528,1558435,2597392,"PAK",2077914
1,427.0,"India",6623929,6617006,6923,5404003,9006672,"IND",7205338
1,427.0,"Western Europe",4008473,3990296,18177,3276431,5460718,"NLD",4368575
1,427.0,"China",9519822,9091640,428182,8238777,13731295,"CPR",10985036
1,427.0,"United States of America",2582660,2582521,139,2110288,3517147,"USA",2813718
1,427.0,"Northern Africa",1945118,0,1945118,1584441,2640735,"EGY",2112588
1,427.0,"Russian Federation",2670632,2650032,20600,2164755,3607926,"RUS",2886341
1,427.0,"Western Africa",509276,0,509276,402539,670898,"NGA",536719
1,427.0,"South America",2078086,1771392,306694,1693779,2822966,"BRA",2258373
1,427.0,"Northern Europe",2031812,2027086,4726,1683611,2806018,"GBR",2244815
1,427.0,"Northern America",654012,651709,2303,514290,857151,"CAN",685721
1,427.0,"Oceania",563770,562944,826,450459,750766,"NZL",600613
1,427.0,"Eastern Africa",547673,0,547673,440108,733513,"ETH",586811
1,427.0,"Middle Africa",142482,0,142482,114302,190503,"AGO",152403
1,427.0,"Eastern Europe",3189807,3131361,58446,2593692,4322821,"POL",3458257
1,427.0,"Central Asia",1781916,1776492,5424,1458921,2431536,"UZB",1945229
1,427.0,"Southern Europe",900621,0,900621,724197,1206995,"ITA",965596
1,427.0,"Central America",360753,0,360753,293259,488765,"MEX",391012
1,427.0,"Southern Asia",524771,0,524771,420205,700342,"IRN",560274
1,427.0,"Western Asia",1482657,0,1482657,1232155,2053592,"IRQ",1642874
1,427.0,"Eastern Asia",935137,0,935137,752492,1254153,"JPN",1003323
1,427.0,"Southern Africa",169386,0,169386,137471,229118,"ZAF",183295
1,427.0,"South-Eastern Asia",1191903,0,1191903,975390,1625650,"IDN",1300520
1,427.0,"Caribbean",165634,0,165634,133993,223322,"CUB",178658
1,428.0,"Pakistan",2021141,2009722,11419,1558435,2597392,"PAK",2077914
1,428.0,"India",6607894,6600345,7549,5404003,9006672,"IND",7205338
1,428.0,"Western Europe",3975870,3955660,20210,3276431,5460718,"NLD",4368575
1,428.0,"China",10772492,10300274,472218,8238777,13731295,"CPR",10985036
1,428.0,"United States of America",2973049,2972650,399,2110288,3517147,"USA",2813718
1,428.0,"Northern Africa",1986476,0,1986476,1584441,2640735,"EGY",2112588
1,428.0,"Russian Federation",3073729,3055564,18165,2164755,3607926,"RUS",2886341
1,428.0,"Western Africa",511563,0,511563,402539,670898,"NGA",536719
1,428.0,"South America",2097646,1776189,321457,1693779,2822966,"BRA",2258373
1,428.0,"Northern Europe",2148824,2141561,7263,1683611,2806018,"GBR",2244815
1,428.0,"Northern America",618498,616952,1546,514290,857151,"CAN",685721
1,428.0,"Oceania",559323,558025,1298,450459,750766,"NZL",600613
1,428.0,"Eastern Africa",547325,0,547325,440108,733513,"ETH",586811
1,428.0,"Middle Africa",143022,0,143022,114302,190503,"AGO",152403
1,428.0,"Eastern Europe",3121003,3061183,59820,2593692,4322821,"POL",3458257
1,428.0,"Central Asia",1778703,1771559,7144,1458921,2431536,"UZB",1945229
1,428.0,"Southern Europe",937003,0,937003,724197,1206995,"ITA",965596
1,428.0,"Central America",408977,0,408977,293259,488765,"MEX",391012
1,428.0,"Southern Asia",544076,0,544076,420205,700342,"IRN",560274
1,428.0,"Western Asia",1530041,0,1530041,1232155,2053592,"IRQ",1642874
1,428.0,"Eastern Asia",1000069,0,1000069,752492,1254153,"JPN",1003323
1,428.0,"Southern Africa",168767,0,168767,137471,229118,"ZAF",183295
1,428.0,"South-Eastern Asia",1203303,0,1203303,975390,1625650,"IDN",1300520
1,428.0,"Caribbean",186875,0,186875,133993,223322,"CUB",178658
1,429.0,"Pakistan",1975868,1968462,7406,1558435,2597392,"PAK",2077914
1,429.0,"India",6627741,6613154,14587,5404003,9006672,"IND",7205338
1,429.0,"Western Europe",4045271,4014007,31264,3276431,5460718,"NLD",4368575
1,429.0,"China",10698665,10294667,403998,8238777,13731295,"CPR",10985036
1,429.0,"United States of America",2855076,2854812,264,2110288,3517147,"USA",2813718
1,429.0,"Northern Africa",2002643,0,2002643,1584441,2640735,"EGY",2112588
1,429.0,"Russian Federation",2944162,2932546,11616,2164755,3607926,"RUS",2886341
1,429.0,"Western Africa",514074,0,514074,402539,670898,"NGA",536719
1,429.0,"South America",2093636,1775098,318538,1693779,2822966,"BRA",2258373
1,429.0,"Northern Europe",1989166,1976275,12891,1683611,2806018,"GBR",2244815
1,429.0,"Northern America",637247,629643,7604,514290,857151,"CAN",685721
1,429.0,"Oceania",589858,583507,6351,450459,750766,"NZL",600613
1,429.0,"Eastern Africa",557626,0,557626,440108,733513,"ETH",586811
1,429.0,"Middle Africa",144686,0,144686,114302,190503,"AGO",152403
1,429.0,"Eastern Europe",3221711,3148908,72803,2593692,4322821,"POL",3458257
1,429.0,"Central Asia",1786003,1769153,16850,1458921,2431536,"UZB",1945229
1,429.0,"Southern Europe",934904,0,934904,724197,1206995,"ITA",965596
1,429.0,"Central America",394698,0,394698,293259,488765,"MEX",391012
1,429.0,"Southern Asia",541991,0,541991,420205,700342,"IRN",560274
1,429.0,"Western Asia",1551581,0,1551581,1232155,2053592,"IRQ",1642874
1,429.0,"Eastern Asia",992963,0,992963,752492,1254153,"JPN",1003323
1,429.0,"Southern Africa",175549,0,175549,137471,229118,"ZAF",183295
1,429.0,"South-Eastern Asia",1265819,0,1265819,975390,1625650,"IDN",1300520
1,429.0,"Caribbean",180403,0,180403,133993,223322,"CUB",178658
1,430.0,"Pakistan",1955151,1949385,5766,1558435,2597392,"PAK",2077914
1,430.0,"India",6717192,6695634,21558,5404003,9006672,"IND",7205338
1,430.0,"Western Europe",4090881,4051640,39241,3276431,5460718,"NLD",4368575
1,430.0,"China",10642651,10286249,356402,8238777,13731295,"CPR",10985036
1,430.0,"United States of America",2738182,2738003,179,2110288,3517147,"USA",2813718
1,430.0,"Northern Africa",2005975,0,2005975,1584441,2640735,"EGY",2112588
1,430.0,"Russian Federation",2815544,2807899,7645,2164755,3607926,"RUS",2886341
1,430.0,"Western Africa",518254,0,518254,402539,670898,"NGA",536719
1,430.0,"South America",2092595,1767132,325463,1693779,2822966,"BRA",2258373
1,430.0,"Northern Europe",2078200,2053800,24400,1683611,2806018,"GBR",2244815
1,430.0,"Northern America",652953,640668,12285,514290,857151,"CAN",685721
1,430.0,"Oceania",593218,586983,6235,450459,750766,"NZL",600613
1,430.0,"Eastern Africa",563273,0,563273,440108,733513,"ETH",586811
1,430.0,"Middle Africa",146298,0,146298,114302,190503,"AGO",152403
1,430.0,"Eastern Europe",3251222,3174994,76228,2593692,4322821,"POL",3458257
1,430.0,"Central Asia",1674295,1648163,26132,1458921,2431536,"UZB",1945229
1,430.0,"Southern Europe",931634,0,931634,724197,1206995,"ITA",965596
1,430.0,"Central America",380313,0,380313,293259,488765,"MEX",391012
1,430.0,"Southern Asia",528952,0,528952,420205,700342,"IRN",560274
1,430.0,"Western Asia",1548119,0,1548119,1232155,2053592,"IRQ",1642874
1,430.0,"Eastern Asia",975514,0,975514,752492,1254153,"JPN",1003323
1,430.0,"Southern Africa",177983,0,177983,137471,229118,"ZAF",183295
1,430.0,"South-Eastern Asia",1275025,0,1275025,975390,1625650,"IDN",1300520
1,430.0,"Caribbean",173923,0,173923,133993,223322,"CUB",178658
1,431.0,"Pakistan",1927896,1924016,3880,1558435,2597392,"PAK",2077914
1,431.0,"India",6732398,6705856,26542,5404003,9006672,"IND",7205338
1,431.0,"Western Europe",4120000,4074821,45179,3276431,5460718,"NLD",4368575
1,431.0,"China",10602872,10267798,335074,8238777,13731295,"CPR",10985036
1,431.0,"United States of America",2662092,2661970,122,2110288,3517147,"USA",2813718
1,431.0,"Northern Africa",2006296,0,2006296,1584441,2640735,"EGY",2112588
1,431.0,"Russian Federation",2730184,2725099,5085,2164755,3607926,"RUS",2886341
1,431.0,"Western Africa",518005,0,518005,402539,670898,"NGA",536719
1,431.0,"South America",2108297,1772780,335517,1693779,2822966,"BRA",2258373
1,431.0,"Northern Europe",2140544,2109132,31412,1683611,2806018,"GBR",2244815
1,431.0,"Northern America",659353,645751,13602,514290,857151,"CAN",685721
1,431.0,"Oceania",588657,582998,5659,450459,750766,"NZL",600613
1,431.0,"Eastern Africa",564646,0,564646,440108,733513,"ETH",586811
1,431.0,"Middle Africa",146484,0,146484,114302,190503,"AGO",152403
1,431.0,"Eastern Europe",3248799,3169979,78820,2593692,4322821,"POL",3458257
1,431.0,"Central Asia",1761857,1713966,47891,1458921,2431536,"UZB",1945229
1,431.0,"Southern Europe",925940,0,925940,724197,1206995,"ITA",965596
1,431.0,"Central America",370693,0,370693,293259,488765,"MEX",391012
1,431.0,"Southern Asia",531094,0,531094,420205,700342,"IRN",560274
1,431.0,"Western Asia",1551049,0,1551049,1232155,2053592,"IRQ",1642874
1,431.0,"Eastern Asia",958868,0,958868,752492,1254153,"JPN",1003323
1,431.0,"Southern Africa",177641,0,177641,137471,229118,"ZAF",183295
1,431.0,"South-Eastern Asia",1264332,0,1264332,975390,1625650,"IDN",1300520
1,431.0,"Caribbean",169569,0,169569,133993,223322,"CUB",178658
1,432.0,"Pakistan",1883097,1880424,2673,1558445,2597408,"PAK",2077927
1,432.0,"India",6781220,6751574,29646,5404012,9006687,"IND",7205350
1,432.0,"Western Europe",4164674,4115156,49518,3276440,5460733,"NLD",4368587
1,432.0,"China",10638101,10319894,318207,8238792,13731320,"CPR",10985056
1,432.0,"United States of America",2608795,2608795,0,2110294,3517157,"USA",2813726
1,432.0,"Northern Africa",2012659,0,2012659,1584445,2640742,"EGY",2112594
1,432.0,"Russian Federation",2685566,2682132,3434,2164755,3607926,"RUS",2886341
1,432.0,"Western Africa",516210,0,516210,402548,670913,"NGA",536731
1,432.0,"South America",2117500,1774522,342978,1693785,2822976,"BRA",2258381
1,432.0,"Northern Europe",2143343,2109036,34307,1683613,2806022,"GBR",2244818
1,432.0,"Northern America",663364,649398,13966,514299,857165,"CAN",685732
1,432.0,"Oceania",578631,574998,3633,450463,750772,"NZL",600618
1,432.0,"Eastern Africa",562306,0,562306,440104,733507,"ETH",586806
1,432.0,"Middle Africa",146202,0,146202,114305,190508,"AGO",152407
1,432.0,"Eastern Europe",3286310,3202236,84074,2593702,4322837,"POL",3458270
1,432.0,"Central Asia",1824107,1762012,62095,1458933,2431555,"UZB",1945244
1,432.0,"Southern Europe",921382,0,921382,724192,1206987,"ITA",965590
1,432.0,"Central America",363991,0,363991,293256,488761,"MEX",391009
1,432.0,"Southern Asia",531516,0,531516,420198,700330,"IRN",560264
1,432.0,"Western Asia",1557768,0,1557768,1232159,2053598,"IRQ",1642879
1,432.0,"Eastern Asia",945649,0,945649,752496,1254160,"JPN",1003328
1,432.0,"Southern Africa",175227,0,175227,137477,229128,"ZAF",183303
1,432.0,"South-Eastern Asia",1244088,0,1244088,975399,1625666,"IDN",1300533
1,432.0,"Caribbean",166521,0,166521,133998,223330,"CUB",178664
1,433.0,"Pakistan",1882410,1880389,2021,1525818,2543030,"PAK",2034424
1,433.0,"India",6812545,6781647,30898,5354187,8923645,"IND",7138916
1,433.0,"Western Europe",4195120,4145865,49255,3048482,5080803,"NLD",4064643
1,433.0,"China",10593463,10290255,303208,7958504,13264173,"CPR",10611339
1,433.0,"United States of America",2568423,2568321,102,2386694,3977823,"USA",3182259
1,433.0,"Northern Africa",2014276,0,2014276,1353068,2255113,"EGY",1804091
1,433.0,"Russian Federation",2634709,2632308,2401,1885887,3143145,"RUS",2514516
1,433.0,"Western Africa",515376,0,515376,417432,695721,"NGA",556577
1,433.0,"South America",2565497,2217043,348454,1644202,2740337,"BRA",2192270
1,433.0,"Northern Europe",2130524,2096586,33938,1636404,2727340,"GBR",2181872
1,433.0,"Northern America",669906,656355,13551,518744,864573,"CAN",691659
1,433.0,"Oceania",575042,572656,2386,491262,818771,"NZL",655017
1,433.0,"Eastern Africa",561706,0,561706,353277,588796,"ETH",471037
1,433.0,"Middle Africa",146251,0,146251,113873,189788,"AGO",151831
1,433.0,"Eastern Europe",3333039,3246590,86449,2298693,3831156,"POL",3064925
1,433.0,"Central Asia",1868505,1798385,70120,1301175,2168625,"UZB",1734900
1,433.0,"Southern Europe",916154,0,916154,675577,1125962,"ITA",900770
1,433.0,"Central America",359022,0,359022,337347,562246,"MEX",449797
1,433.0,"Southern Asia",530645,0,530645,612243,1020405,"IRN",816324
1,433.0,"Western Asia",1562731,0,1562731,1231759,2052932,"IRQ",1642346
1,433.0,"Eastern Asia",933309,0,933309,795941,1326568,"JPN",1061255
1,433.0,"Southern Africa",174391,0,174391,120855,201425,"ZAF",161140
1,433.0,"South-Eastern Asia",1235890,0,1235890,1059632,1766053,"IDN",1412843
1,433.0,"Caribbean",164307,0,164307,122329,203882,"CUB",163106
1,434.0,"Pakistan",1853897,1852353,1544,1525818,2543030,"PAK",2034424
1,434.0,"India",6877876,6848892,28984,5354187,8923645,"IND",7138916
1,434.0,"Western Europe",4217181,4168618,48563,3048482,5080803,"NLD",4064643
1,434.0,"China",10572738,10297683,275055,7958504,13264173,"CPR",10611339
1,434.0,"United States of America",2645291,2645291,0,2386694,3977823,"USA",3182259
1,434.0,"Northern Africa",2028452,0,2028452,1353068,2255113,"EGY",1804091
1,434.0,"Russian Federation",2626844,2625137,1707,1885887,3143145,"RUS",2514516
1,434.0,"Western Africa",515024,0,515024,417432,695721,"NGA",556577
1,434.0,"South America",2418010,2149602,268408,1644202,2740337,"BRA",2192270
1,434.0,"Northern Europe",2190791,2156691,34100,1636404,2727340,"GBR",2181872
1,434.0,"Northern America",655422,645953,9469,518744,864573,"CAN",691659
1,434.0,"Oceania",727153,725361,1792,491262,818771,"NZL",655017
1,434.0,"Eastern Africa",581885,0,581885,353277,588796,"ETH",471037
1,434.0,"Middle Africa",147765,0,147765,113873,189788,"AGO",151831
1,434.0,"Eastern Europe",3324824,3240776,84048,2298693,3831156,"POL",3064925
1,434.0,"Central Asia",1914060,1842181,71879,1301175,2168625,"UZB",1734900
1,434.0,"Southern Europe",925334,0,925334,675577,1125962,"ITA",900770
1,434.0,"Central America",367924,0,367924,337347,562246,"MEX",449797
1,434.0,"Southern Asia",530991,0,530991,612243,1020405,"IRN",816324
1,434.0,"Western Asia",1568161,0,1568161,1231759,2052932,"IRQ",1642346
1,434.0,"Eastern Asia",957158,0,957158,795941,1326568,"JPN",1061255
1,434.0,"Southern Africa",200470,0,200470,120855,201425,"ZAF",161140
1,434.0,"South-Eastern Asia",1518173,0,1518173,1059632,1766053,"IDN",1412843
1,434.0,"Caribbean",168564,0,168564,122329,203882,"CUB",163106
1,435.0,"Pakistan",1943410,1938685,4725,1525818,2543030,"PAK",2034424
1,435.0,"India",6859806,6834827,24979,5354187,8923645,"IND",7138916
1,435.0,"Western Europe",4254656,4207660,46996,3048482,5080803,"NLD",4064643
1,435.0,"China",10579894,10315025,264869,7958504,13264173,"CPR",10611339
1,435.0,"United States of America",2713171,2711609,1562,2386694,3977823,"USA",3182259
1,435.0,"Northern Africa",1973135,0,1973135,1353068,2255113,"EGY",1804091
1,435.0,"Russian Federation",2627613,2623534,4079,1885887,3143145,"RUS",2514516
1,435.0,"Western Africa",521364,0,521364,417432,695721,"NGA",556577
1,435.0,"South America",2319443,2127539,191904,1644202,2740337,"BRA",2192270
1,435.0,"Northern Europe",2174265,2141415,32850,1636404,2727340,"GBR",2181872
1,435.0,"Northern America",659884,648933,10951,518744,864573,"CAN",691659
1,435.0,"Oceania",668846,667771,1075,491262,818771,"NZL",655017
1,435.0,"Eastern Africa",543505,0,543505,353277,588796,"ETH",471037
1,435.0,"Middle Africa",148015,0,148015,113873,189788,"AGO",151831
1,435.0,"Eastern Europe",3316896,3232545,84351,2298693,3831156,"POL",3064925
1,435.0,"Central Asia",1912329,1842403,69926,1301175,2168625,"UZB",1734900
1,435.0,"Southern Europe",910889,0,910889,675577,1125962,"ITA",900770
1,435.0,"Central America",382376,0,382376,337347,562246,"MEX",449797
1,435.0,"Southern Asia",622255,0,622255,612243,1020405,"IRN",816324
1,435.0,"Western Asia",1605217,0,1605217,1231759,2052932,"IRQ",1642346
1,435.0,"Eastern Asia",978344,0,978344,795941,1326568,"JPN",1061255
1,435.0,"Southern Africa",182097,0,182097,120855,201425,"ZAF",161140
1,435.0,"South-Eastern Asia",1425001,0,1425001,1059632,1766053,"IDN",1412843
1,435.0,"Caribbean",162403,0,162403,122329,203882,"CUB",163106
1,436.0,"Pakistan",1957181,1950227,6954,1525818,2543030,"PAK",2034424
1,436.0,"India",6891303,6863889,27414,5354187,8923645,"IND",7138916
1,436.0,"Western Europe",4226352,4191105,35247,3048482,5080803,"NLD",4064643
1,436.0,"China",10516559,10287171,229388,7958504,13264173,"CPR",10611339
1,436.0,"United States of America",2925883,2923241,2642,2386694,3977823,"USA",3182259
1,436.0,"Northern Africa",1940153,0,1940153,1353068,2255113,"EGY",1804091
1,436.0,"Russian Federation",2577769,2572358,5411,1885887,3143145,"RUS",2514516
1,436.0,"Western Africa",541297,0,541297,417432,695721,"NGA",556577
1,436.0,"South America",2246540,2110666,135874,1644202,2740337,"BRA",2192270
1,436.0,"Northern Europe",2176677,2149844,26833,1636404,2727340,"GBR",2181872
1,436.0,"Northern America",677943,668511,9432,518744,864573,"CAN",691659
1,436.0,"Oceania",643503,642902,601,491262,818771,"NZL",655017
1,436.0,"Eastern Africa",522148,0,522148,353277,588796,"ETH",471037
1,436.0,"Middle Africa",151305,0,151305,113873,189788,"AGO",151831
1,436.0,"Eastern Europe",3265457,3197349,68108,2298693,3831156,"POL",3064925
1,436.0,"Central Asia",1873132,1815469,57663,1301175,2168625,"UZB",1734900
1,436.0,"Southern Europe",920443,0,920443,675577,1125962,"ITA",900770
1,436.0,"Central America",413147,0,413147,337347,562246,"MEX",449797
1,436.0,"Southern Asia",680917,0,680917,612243,1020405,"IRN",816324
1,436.0,"Western Asia",1621884,0,1621884,1231759,2052932,"IRQ",1642346
1,436.0,"Eastern Asia",1009238,0,1009238,795941,1326568,"JPN",1061255
1,436.0,"Southern Africa",172941,0,172941,120855,201425,"ZAF",161140
1,436.0,"South-Eastern Asia",1383279,0,1383279,1059632,1766053,"IDN",1412843
1,436.0,"Caribbean",166838,0,166838,122329,203882,"CUB",163106
1,437.0,"Pakistan",1992158,1983621,8537,1525818,2543030,"PAK",2034424
1,437.0,"India",7195161,7165299,29862,5354187,8923645,"IND",7138916
1,437.0,"Western Europe",4205287,4178720,26567,3048482,5080803,"NLD",4064643
1,437.0,"China",10539881,10328374,211507,7958504,13264173,"CPR",10611339
1,437.0,"United States of America",3041656,3038792,2864,2386694,3977823,"USA",3182259
1,437.0,"Northern Africa",1914759,0,1914759,1353068,2255113,"EGY",1804091
1,437.0,"Russian Federation",2575247,2568873,6374,1885887,3143145,"RUS",2514516
1,437.0,"Western Africa",550243,0,550243,417432,695721,"NGA",556577
1,437.0,"South America",2218264,2122268,95996,1644202,2740337,"BRA",2192270
1,437.0,"Northern Europe",2220451,2193629,26822,1636404,2727340,"GBR",2181872
1,437.0,"Northern America",686206,678579,7627,518744,864573,"CAN",691659
1,437.0,"Oceania",617217,616795,422,491262,818771,"NZL",655017
1,437.0,"Eastern Africa",504181,0,504181,353277,588796,"ETH",471037
1,437.0,"Middle Africa",152338,0,152338,113873,189788,"AGO",151831
1,437.0,"Eastern Europe",3228233,3163819,64414,2298693,3831156,"POL",3064925
1,437.0,"Central Asia",1832927,1789071,43856,1301175,2168625,"UZB",1734900
1,437.0,"Southern Europe",922084,0,922084,675577,1125962,"ITA",900770
1,437.0,"Central America",429308,0,429308,337347,562246,"MEX",449797
1,437.0,"Southern Asia",724236,0,724236,612243,1020405,"IRN",816324
1,437.0,"Western Asia",1636208,0,1636208,1231759,2052932,"IRQ",1642346
1,437.0,"Eastern Asia",1027223,0,1027223,795941,1326568,"JPN",1061255
1,437.0,"Southern Africa",164927,0,164927,120855,201425,"ZAF",161140
1,437.0,"South-Eastern Asia",1337497,0,1337497,1059632,1766053,"IDN",1412843
1,437.0,"Caribbean",167376,0,167376,122329,203882,"CUB",163106
1,438.0,"Pakistan",1873961,1864660,9301,1525818,2543030,"PAK",2034424
1,438.0,"India",7178383,7153388,24995,5354187,8923645,"IND",7138916
1,438.0,"Western Europe",4189702,4169067,20635,3048482,5080803,"NLD",4064643
1,438.0,"China",10488260,10278131,210129,7958504,13264173,"CPR",10611339
1,438.0,"United States of America",3085524,3083771,1753,2386694,3977823,"USA",3182259
1,438.0,"Northern Africa",1889582,0,1889582,1353068,2255113,"EGY",1804091
1,438.0,"Russian Federation",2588960,2582606,6354,1885887,3143145,"RUS",2514516
1,438.0,"Western Africa",557382,0,557382,417432,695721,"NGA",556577
1,438.0,"South America",2197256,2131241,66015,1644202,2740337,"BRA",2192270
1,438.0,"Northern Europe",2222845,2197521,25324,1636404,2727340,"GBR",2181872
1,438.0,"Northern America",704205,699136,5069,518744,864573,"CAN",691659
1,438.0,"Oceania",599044,598751,293,491262,818771,"NZL",655017
1,438.0,"Eastern Africa",491754,0,491754,353277,588796,"ETH",471037
1,438.0,"Middle Africa",152734,0,152734,113873,189788,"AGO",151831
1,438.0,"Eastern Europe",3180656,3118908,61748,2298693,3831156,"POL",3064925
1,438.0,"Central Asia",1803754,1766548,37206,1301175,2168625,"UZB",1734900
1,438.0,"Southern Europe",921254,0,921254,675577,1125962,"ITA",900770
1,438.0,"Central America",434358,0,434358,337347,562246,"MEX",449797
1,438.0,"Southern Asia",750627,0,750627,612243,1020405,"IRN",816324
1,438.0,"Western Asia",1640722,0,1640722,1231759,2052932,"IRQ",1642346
1,438.0,"Eastern Asia",1041931,0,1041931,795941,1326568,"JPN",1061255
1,438.0,"Southern Africa",158816,0,158816,120855,201425,"ZAF",161140
1,438.0,"South-Eastern Asia",1303460,0,1303460,1059632,1766053,"IDN",1412843
1,438.0,"Caribbean",165167,0,165167,122329,203882,"CUB",163106
1,439.0,"Pakistan",1944820,1926065,18755,1525818,2543030,"PAK",2034424
1,439.0,"India",7213780,7189912,23868,5354187,8923645,"IND",7138916
1,439.0,"Western Europe",4152218,4137202,15016,3048482,5080803,"NLD",4064643
1,439.0,"China",10521386,10309561,211825,7958504,13264173,"CPR",10611339
1,439.0,"United States of America",3134523,3133265,1258,2386694,3977823,"USA",3182259
1,439.0,"Northern Africa",1872307,0,1872307,1353068,2255113,"EGY",1804091
1,439.0,"Russian Federation",2566284,2562181,4103,1885887,3143145,"RUS",2514516
1,439.0,"Western Africa",564362,0,564362,417432,695721,"NGA",556577
1,439.0,"South America",2195818,2150075,45743,1644202,2740337,"BRA",2192270
1,439.0,"Northern Europe",2238502,2215435,23067,1636404,2727340,"GBR",2181872
1,439.0,"Northern America",716566,713244,3322,518744,864573,"CAN",691659
1,439.0,"Oceania",595861,595650,211,491262,818771,"NZL",655017
1,439.0,"Eastern Africa",487759,0,487759,353277,588796,"ETH",471037
1,439.0,"Middle Africa",153427,0,153427,113873,189788,"AGO",151831
1,439.0,"Eastern Europe",3186861,3128218,58643,2298693,3831156,"POL",3064925
1,439.0,"Central Asia",1806267,1772752,33515,1301175,2168625,"UZB",1734900
1,439.0,"Southern Europe",920121,0,920121,675577,1125962,"ITA",900770
1,439.0,"Central America",441241,0,441241,337347,562246,"MEX",449797
1,439.0,"Southern Asia",778615,0,778615,612243,1020405,"IRN",816324
1,439.0,"Western Asia",1656227,0,1656227,1231759,2052932,"IRQ",1642346
1,439.0,"Eastern Asia",1050609,0,1050609,795941,1326568,"JPN",1061255
1,439.0,"Southern Africa",156582,0,156582,120855,201425,"ZAF",161140
1,439.0,"South-Eastern Asia",1298944,0,1298944,1059632,1766053,"IDN",1412843
1,439.0,"Caribbean",165103,0,165103,122329,203882,"CUB",163106
1,440.0,"Pakistan",1996478,1970750,25728,1525818,2543030,"PAK",2034424
1,440.0,"India",7192011,7169443,22568,5354187,8923645,"IND",7138916
1,440.0,"Western Europe",3840226,3826748,13478,3048482,5080803,"NLD",4064643
1,440.0,"China",10261214,10050686,210528,7958504,13264173,"CPR",10611339
1,440.0,"United States of America",3093473,3092438,1035,2386694,3977823,"USA",3182259
1,440.0,"Northern Africa",1778382,0,1778382,1353068,2255113,"EGY",1804091
1,440.0,"Russian Federation",2423660,2420561,3099,1885887,3143145,"RUS",2514516
1,440.0,"Western Africa",546666,0,546666,417432,695721,"NGA",556577
1,440.0,"South America",2193714,2160493,33221,1644202,2740337,"BRA",2192270
1,440.0,"Northern Europe",2165641,2148662,16979,1636404,2727340,"GBR",2181872
1,440.0,"Northern America",684047,681817,2230,518744,864573,"CAN",691659
1,440.0,"Oceania",618067,617922,145,491262,818771,"NZL",655017
1,440.0,"Eastern Africa",473555,0,473555,353277,588796,"ETH",471037
1,440.0,"Middle Africa",149788,0,149788,113873,189788,"AGO",151831
1,440.0,"Eastern Europe",3326203,3271797,54406,2298693,3831156,"POL",3064925
1,440.0,"Central Asia",1784389,1757544,26845,1301175,2168625,"UZB",1734900
1,440.0,"Southern Europe",878332,0,878332,675577,1125962,"ITA",900770
1,440.0,"Central America",436232,0,436232,337347,562246,"MEX",449797
1,440.0,"Southern Asia",774308,0,774308,612243,1020405,"IRN",816324
1,440.0,"Western Asia",1668826,0,1668826,1231759,2052932,"IRQ",1642346
1,440.0,"Eastern Asia",1021216,0,1021216,795941,1326568,"JPN",1061255
1,440.0,"Southern Africa",157802,0,157802,120855,201425,"ZAF",161140
1,440.0,"South-Eastern Asia",1336183,0,1336183,1059632,1766053,"IDN",1412843
1,440.0,"Caribbean",161681,0,161681,122329,203882,"CUB",163106
1,441.0,"Pakistan",2020391,1993120,27271,1525818,2543030,"PAK",2034424
1,441.0,"India",7223436,7202955,20481,5354187,8923645,"IND",7138916
1,441.0,"Western Europe",3902640,3885227,17413,3048482,5080803,"NLD",4064643
1,441.0,"China",10284730,10067192,217538,7958504,13264173,"CPR",10611339
1,441.0,"United States of America",3102104,3101400,704,2386694,3977823,"USA",3182259
1,441.0,"Northern Africa",1782174,0,1782174,1353068,2255113,"EGY",1804091
1,441.0,"Russian Federation",2481766,2478210,3556,1885887,3143145,"RUS",2514516
1,441.0,"Western Africa",545367,0,545367,417432,695721,"NGA",556577
1,441.0,"South America",2179955,2157083,22872,1644202,2740337,"BRA",2192270
1,441.0,"Northern Europe",2100802,2086620,14182,1636404,2727340,"GBR",2181872
1,441.0,"Northern America",678235,676713,1522,518744,864573,"CAN",691659
1,441.0,"Oceania",618490,618390,100,491262,818771,"NZL",655017
1,441.0,"Eastern Africa",469140,0,469140,353277,588796,"ETH",471037
1,441.0,"Middle Africa",149364,0,149364,113873,189788,"AGO",151831
1,441.0,"Eastern Europe",3206299,3169664,36635,2298693,3831156,"POL",3064925
1,441.0,"Central Asia",1747459,1727687,19772,1301175,2168625,"UZB",1734900
1,441.0,"Southern Europe",880855,0,880855,675577,1125962,"ITA",900770
1,441.0,"Central America",437540,0,437540,337347,562246,"MEX",449797
1,441.0,"Southern Asia",787242,0,787242,612243,1020405,"IRN",816324
1,441.0,"Western Asia",1653276,0,1653276,1231759,2052932,"IRQ",1642346
1,441.0,"Eastern Asia",1034100,0,1034100,795941,1326568,"JPN",1061255
1,441.0,"Southern Africa",156506,0,156506,120855,201425,"ZAF",161140
1,441.0,"South-Eastern Asia",1339830,0,1339830,1059632,1766053,"IDN",1412843
1,441.0,"Caribbean",160973,0,160973,122329,203882,"CUB",163106
1,442.0,"Pakistan",2037732,2009405,28327,1525818,2543030,"PAK",2034424
1,442.0,"India",7152139,7137447,14692,5354187,8923645,"IND",7138916
1,442.0,"Western Europe",3974134,3953760,20374,3048482,5080803,"NLD",4064643
1,442.0,"China",10301607,10075501,226106,7958504,13264173,"CPR",10611339
1,442.0,"United States of America",3088845,3088257,588,2386694,3977823,"USA",3182259
1,442.0,"Northern Africa",1789206,0,1789206,1353068,2255113,"EGY",1804091
1,442.0,"Russian Federation",2539535,2536142,3393,1885887,3143145,"RUS",2514516
1,442.0,"Western Africa",541632,0,541632,417432,695721,"NGA",556577
1,442.0,"South America",2170348,2154558,15790,1644202,2740337,"BRA",2192270
1,442.0,"Northern Europe",2123599,2108074,15525,1636404,2727340,"GBR",2181872
1,442.0,"Northern America",670018,668971,1047,518744,864573,"CAN",691659
1,442.0,"Oceania",622112,622112,0,491262,818771,"NZL",655017
1,442.0,"Eastern Africa",465558,0,465558,353277,588796,"ETH",471037
1,442.0,"Middle Africa",148340,0,148340,113873,189788,"AGO",151831
1,442.0,"Eastern Europe",3105463,3080466,24997,2298693,3831156,"POL",3064925
1,442.0,"Central Asia",1878092,1862960,15132,1301175,2168625,"UZB",1734900
1,442.0,"Southern Europe",882514,0,882514,675577,1125962,"ITA",900770
1,442.0,"Central America",435883,0,435883,337347,562246,"MEX",449797
1,442.0,"Southern Asia",813266,0,813266,612243,1020405,"IRN",816324
1,442.0,"Western Asia",1641605,0,1641605,1231759,2052932,"IRQ",1642346
1,442.0,"Eastern Asia",1041143,0,1041143,795941,1326568,"JPN",1061255
1,442.0,"Southern Africa",155944,0,155944,120855,201425,"ZAF",161140
1,442.0,"South-Eastern Asia",1349665,0,1349665,1059632,1766053,"IDN",1412843
1,442.0,"Caribbean",159628,0,159628,122329,203882,"CUB",163106
1,443.0,"Pakistan",2063415,2035390,28025,1525818,2543030,"PAK",2034424
1,443.0,"India",7148160,7137089,11071,5354187,8923645,"IND",7138916
1,443.0,"Western Europe",4053082,4029600,23482,3048482,5080803,"NLD",4064643
1,443.0,"China",10311094,10077337,233757,7958504,13264173,"CPR",10611339
1,443.0,"United States of America",3155515,3155257,258,2386694,3977823,"USA",3182259
1,443.0,"Northern Africa",1805201,0,1805201,1353068,2255113,"EGY",1804091
1,443.0,"Russian Federation",2500030,2497300,2730,1885887,3143145,"RUS",2514516
1,443.0,"Western Africa",544641,0,544641,417432,695721,"NGA",556577
1,443.0,"South America",2163789,2152659,11130,1644202,2740337,"BRA",2192270
1,443.0,"Northern Europe",2140170,2123200,16970,1636404,2727340,"GBR",2181872
1,443.0,"Northern America",668273,667537,736,518744,864573,"CAN",691659
1,443.0,"Oceania",624435,624435,0,491262,818771,"NZL",655017
1,443.0,"Eastern Africa",462458,0,462458,353277,588796,"ETH",471037
1,443.0,"Middle Africa",148802,0,148802,113873,189788,"AGO",151831
1,443.0,"Eastern Europe",3036268,3018579,17689,2298693,3831156,"POL",3064925
1,443.0,"Central Asia",1800685,1790410,10275,1301175,2168625,"UZB",1734900
1,443.0,"Southern Europe",894239,0,894239,675577,1125962,"ITA",900770
1,443.0,"Central America",444747,0,444747,337347,562246,"MEX",449797
1,443.0,"Southern Asia",803285,0,803285,612243,1020405,"IRN",816324
1,443.0,"Western Asia",1619826,0,1619826,1231759,2052932,"IRQ",1642346
1,443.0,"Eastern Asia",1039360,0,1039360,795941,1326568,"JPN",1061255
1,443.0,"Southern Africa",155846,0,155846,120855,201425,"ZAF",161140
1,443.0,"South-Eastern Asia",1353362,0,1353362,1059632,1766053,"IDN",1412843
1,443.0,"Caribbean",162355,0,162355,122329,203882,"CUB",163106
1,444.0,"Pakistan",2068303,2044275,24028,1525824,2543040,"PAK",2034432
1,444.0,"India",7145299,7137139,8160,5354195,8923658,"IND",7138927
1,444.0,"Western Europe",4056490,4031800,24690,3048483,5080806,"NLD",4064645
1,444.0,"China",10318879,10075368,243511,7958510,13264183,"CPR",10611347
1,444.0,"United States of America",3163755,3163575,180,2386698,3977830,"USA",3182264
1,444.0,"Northern Africa",1805656,0,1805656,1353072,2255121,"EGY",1804097
1,444.0,"Russian Federation",2472010,2469726,2284,1885895,3143158,"RUS",2514527
1,444.0,"Western Africa",557238,0,557238,417438,695730,"NGA",556584
1,444.0,"South America",2159068,2151192,7876,1644215,2740358,"BRA",2192287
1,444.0,"Northern Europe",2180486,2162296,18190,1636416,2727361,"GBR",2181889
1,444.0,"Northern America",700536,699718,818,518751,864586,"CAN",691669
1,444.0,"Oceania",637602,637602,0,491279,818798,"NZL",655039
1,444.0,"Eastern Africa",471573,0,471573,353277,588796,"ETH",471037
1,444.0,"Middle Africa",151818,0,151818,113889,189816,"AGO",151853
1,444.0,"Eastern Europe",2987364,2974738,12626,2298697,3831162,"POL",3064930
1,444.0,"Central Asia",1737194,1730062,7132,1301183,2168638,"UZB",1734911
1,444.0,"Southern Europe",903474,0,903474,675580,1125967,"ITA",900774
1,444.0,"Central America",447014,0,447014,337353,562256,"MEX",449805
1,444.0,"Southern Asia",799314,0,799314,612234,1020391,"IRN",816313
1,444.0,"Western Asia",1609135,0,1609135,1231761,2052936,"IRQ",1642349
1,444.0,"Eastern Asia",1048939,0,1048939,795954,1326591,"JPN",1061273
1,444.0,"Southern Africa",158357,0,158357,120858,201431,"ZAF",161145
1,444.0,"South-Eastern Asia",1377677,0,1377677,1059633,1766055,"IDN",1412844
1,444.0,"Caribbean",162860,0,162860,122337,203895,"CUB",163116
1,445.0,"Pakistan",2031504,2013641,17863,1525824,2543040,"PAK",2034432
1,445.0,"India",7143389,7137327,6062,5354195,8923658,"IND",7138927
1,445.0,"Western Europe",4112111,4086291,25820,3048483,5080806,"NLD",4064645
1,445.0,"China",10324513,10069782,254731,7958510,13264183,"CPR",10611347
1,445.0,"United States of America",3150172,3150045,127,2386698,3977830,"USA",3182264
1,445.0,"Northern Africa",1806724,0,1806724,1353072,2255121,"EGY",1804097
1,445.0,"Russian Federation",2548941,2546747,2194,1885895,3143158,"RUS",2514527
1,445.0,"Western Africa",549414,0,549414,417438,695730,"NGA",556584
1,445.0,"South America",2384863,2379413,5450,1644215,2740358,"BRA",2192287
1,445.0,"Northern Europe",2166263,2149374,16889,1636416,2727361,"GBR",2181889
1,445.0,"Northern America",676816,676252,564,518751,864586,"CAN",691669
1,445.0,"Oceania",643005,642895,110,491279,818798,"NZL",655039
1,445.0,"Eastern Africa",465507,0,465507,353277,588796,"ETH",471037
1,445.0,"Middle Africa",149945,0,149945,113889,189816,"AGO",151853
1,445.0,"Eastern Europe",2971148,2961338,9810,2298697,3831162,"POL",3064930
1,445.0,"Central Asia",1693022,1688043,4979,1301183,2168638,"UZB",1734911
1,445.0,"Southern Europe",897123,0,897123,675580,1125967,"ITA",900774
1,445.0,"Central America",444834,0,444834,337353,562256,"MEX",449805
1,445.0,"Southern Asia",802525,0,802525,612234,1020391,"IRN",816313
1,445.0,"Western Asia",1609867,0,1609867,1231761,2052936,"IRQ",1642349
1,445.0,"Eastern Asia",1054226,0,1054226,795954,1326591,"JPN",1061273
1,445.0,"Southern Africa",161063,0,161063,120858,201431,"ZAF",161145
1,445.0,"South-Eastern Asia",1390864,0,1390864,1059633,1766055,"IDN",1412844
1,445.0,"Caribbean",161904,0,161904,122337,203895,"CUB",163116
1,446.0,"Pakistan",2044876,2030232,14644,1525824,2543040,"PAK",2034432
1,446.0,"India",7141609,7137790,3819,5354195,8923658,"IND",7138927
1,446.0,"Western Europe",4072007,4048544,23463,3048483,5080806,"NLD",4064645
1,446.0,"China",10314545,10060870,253675,7958510,13264183,"CPR",10611347
1,446.0,"United States of America",3198599,3198599,0,2386698,3977830,"USA",3182264
1,446.0,"Northern Africa",1798715,0,1798715,1353072,2255121,"EGY",1804097
1,446.0,"Russian Federation",2522604,2521125,1479,1885895,3143158,"RUS",2514527
1,446.0,"Western Africa",557902,0,557902,417438,695730,"NGA",556584
1,446.0,"South America",2308153,2304524,3629,1644215,2740358,"BRA",2192287
1,446.0,"Northern Europe",2185181,2168498,16683,1636416,2727361,"GBR",2181889
1,446.0,"Northern America",689656,689350,306,518751,864586,"CAN",691669
1,446.0,"Oceania",531254,530742,512,491279,818798,"NZL",655039
1,446.0,"Eastern Africa",442289,0,442289,353277,588796,"ETH",471037
1,446.0,"Middle Africa",146404,0,146404,113889,189816,"AGO",151853
1,446.0,"Eastern Europe",2959099,2951766,7333,2298697,3831162,"POL",3064930
1,446.0,"Central Asia",1683074,1679757,3317,1301183,2168638,"UZB",1734911
1,446.0,"Southern Europe",901927,0,901927,675580,1125967,"ITA",900774
1,446.0,"Central America",450735,0,450735,337353,562256,"MEX",449805
1,446.0,"Southern Asia",798662,0,798662,612234,1020391,"IRN",816313
1,446.0,"Western Asia",1602645,0,1602645,1231761,2052936,"IRQ",1642349
1,446.0,"Eastern Asia",1026334,0,1026334,795954,1326591,"JPN",1061273
1,446.0,"Southern Africa",140990,0,140990,120858,201431,"ZAF",161145
1,446.0,"South-Eastern Asia",1171909,0,1171909,1059633,1766055,"IDN",1412844
1,446.0,"Caribbean",163914,0,163914,122337,203895,"CUB",163116
1,447.0,"Pakistan",2041917,2030394,11523,1525824,2543040,"PAK",2034432
1,447.0,"India",7140887,7138116,2771,5354195,8923658,"IND",7138927
1,447.0,"Western Europe",4096615,4073962,22653,3048483,5080806,"NLD",4064645
1,447.0,"China",10317351,10068848,248503,7958510,13264183,"CPR",10611347
1,447.0,"United States of America",3193538,3193538,0,2386698,3977830,"USA",3182264
1,447.0,"Northern Africa",1804138,0,1804138,1353072,2255121,"EGY",1804097
1,447.0,"Russian Federation",2488012,2486964,1048,1885895,3143158,"RUS",2514527
1,447.0,"Western Africa",552311,0,552311,417438,695730,"NGA",556584
1,447.0,"South America",2192311,2190077,2234,1644215,2740358,"BRA",2192287
1,447.0,"Northern Europe",2198323,2181859,16464,1636416,2727361,"GBR",2181889
1,447.0,"Northern America",677595,677385,210,518751,864586,"CAN",691669
1,447.0,"Oceania",568471,558093,10378,491279,818798,"NZL",655039
1,447.0,"Eastern Africa",449389,0,449389,353277,588796,"ETH",471037
1,447.0,"Middle Africa",147535,0,147535,113889,189816,"AGO",151853
1,447.0,"Eastern Europe",2989091,2981725,7366,2298697,3831162,"POL",3064930
1,447.0,"Central Asia",1664793,1662414,2379,1301183,2168638,"UZB",1734911
1,447.0,"Southern Europe",900920,0,900920,675580,1125967,"ITA",900774
1,447.0,"Central America",450702,0,450702,337353,562256,"MEX",449805
1,447.0,"Southern Asia",794412,0,794412,612234,1020391,"IRN",816313
1,447.0,"Western Asia",1607162,0,1607162,1231761,2052936,"IRQ",1642349
1,447.0,"Eastern Asia",1032415,0,1032415,795954,1326591,"JPN",1061273
1,447.0,"Southern Africa",146875,0,146875,120858,201431,"ZAF",161145
1,447.0,"South-Eastern Asia",1246049,0,1246049,1059633,1766055,"IDN",1412844
1,447.0,"Caribbean",163722,0,163722,122337,203895,"CUB",163116
1,448.0,"Pakistan",2039767,2030502,9265,1525824,2543040,"PAK",2034432
1,448.0,"India",7093845,7091796,2049,5354195,8923658,"IND",7138927
1,448.0,"Western Europe",4114124,4092388,21736,3048483,5080806,"NLD",4064645
1,448.0,"China",10320338,10070814,249524,7958510,13264183,"CPR",10611347
1,448.0,"United States of America",3132159,3132159,0,2386698,3977830,"USA",3182264
1,448.0,"Northern Africa",1803932,0,1803932,1353072,2255121,"EGY",1804097
1,448.0,"Russian Federation",2495695,2494934,761,1885895,3143158,"RUS",2514527
1,448.0,"Western Africa",556416,0,556416,417438,695730,"NGA",556584
1,448.0,"South America",2127634,2126089,1545,1644215,2740358,"BRA",2192287
1,448.0,"Northern Europe",2179227,2165226,14001,1636416,2727361,"GBR",2181889
1,448.0,"Northern America",698816,698300,516,518751,864586,"CAN",691669
1,448.0,"Oceania",608494,590154,18340,491279,818798,"NZL",655039
1,448.0,"Eastern Africa",465062,0,465062,353277,588796,"ETH",471037
1,448.0,"Middle Africa",150697,0,150697,113889,189816,"AGO",151853
1,448.0,"Eastern Europe",2990666,2983348,7318,2298697,3831162,"POL",3064930
1,448.0,"Central Asia",1684477,1682459,2018,1301183,2168638,"UZB",1734911
1,448.0,"Southern Europe",902470,0,902470,675580,1125967,"ITA",900774
1,448.0,"Central America",442786,0,442786,337353,562256,"MEX",449805
1,448.0,"Southern Asia",801057,0,801057,612234,1020391,"IRN",816313
1,448.0,"Western Asia",1616031,0,1616031,1231761,2052936,"IRQ",1642349
1,448.0,"Eastern Asia",1050176,0,1050176,795954,1326591,"JPN",1061273
1,448.0,"Southern Africa",153490,0,153490,120858,201431,"ZAF",161145
1,448.0,"South-Eastern Asia",1325603,0,1325603,1059633,1766055,"IDN",1412844
1,448.0,"Caribbean",160722,0,160722,122337,203895,"CUB",163116
1,449.0,"Pakistan",2011514,2004774,6740,1525824,2543040,"PAK",2034432
1,449.0,"India",7666469,7664966,1503,5354195,8923658,"IND",7138927
1,449.0,"Western Europe",4072791,4055954,16837,3048483,5080806,"NLD",4064645
1,449.0,"China",10320846,10068121,252725,7958510,13264183,"CPR",10611347
1,449.0,"United States of America",3147406,3147406,0,2386698,3977830,"USA",3182264
1,449.0,"Northern Africa",1794547,0,1794547,1353072,2255121,"EGY",1804097
1,449.0,"Russian Federation",2468750,2468145,605,1885895,3143158,"RUS",2514527
1,449.0,"Western Africa",545928,0,545928,417438,695730,"NGA",556584
1,449.0,"South America",2121421,2120346,1075,1644215,2740358,"BRA",2192287
1,449.0,"Northern Europe",2179761,2166330,13431,1636416,2727361,"GBR",2181889
1,449.0,"Northern America",671201,670841,360,518751,864586,"CAN",691669
1,449.0,"Oceania",642940,619895,23045,491279,818798,"NZL",655039
1,449.0,"Eastern Africa",464220,0,464220,353277,588796,"ETH",471037
1,449.0,"Middle Africa",149718,0,149718,113889,189816,"AGO",151853
1,449.0,"Eastern Europe",3011449,3003722,7727,2298697,3831162,"POL",3064930
1,449.0,"Central Asia",1709966,1708025,1941,1301183,2168638,"UZB",1734911
1,449.0,"Southern Europe",892017,0,892017,675580,1125967,"ITA",900774
1,449.0,"Central America",444544,0,444544,337353,562256,"MEX",449805
1,449.0,"Southern Asia",801986,0,801986,612234,1020391,"IRN",816313
1,449.0,"Western Asia",1614528,0,1614528,1231761,2052936,"IRQ",1642349
1,449.0,"Eastern Asia",1045158,0,1045158,795954,1326591,"JPN",1061273
1,449.0,"Southern Africa",158912,0,158912,120858,201431,"ZAF",161145
1,449.0,"South-Eastern Asia",1394346,0,1394346,1059633,1766055,"IDN",1412844
1,449.0,"Caribbean",161334,0,161334,122337,203895,"CUB",163116
1,450.0,"Pakistan",2004872,1995984,8888,1525824,2543040,"PAK",2034432
1,450.0,"India",7458170,7457262,908,5354195,8923658,"IND",7138927
1,450.0,"Western Europe",4043946,4028886,15060,3048483,5080806,"NLD",4064645
1,450.0,"China",10321572,10064250,257322,7958510,13264183,"CPR",10611347
1,450.0,"United States of America",3158013,3158013,0,2386698,3977830,"USA",3182264
1,450.0,"Northern Africa",1793790,0,1793790,1353072,2255121,"EGY",1804097
1,450.0,"Russian Federation",2481834,2480272,1562,1885895,3143158,"RUS",2514527
1,450.0,"Western Africa",559908,0,559908,417438,695730,"NGA",556584
1,450.0,"South America",2143000,2142231,769,1644215,2740358,"BRA",2192287
1,450.0,"Northern Europe",2180498,2168250,12248,1636416,2727361,"GBR",2181889
1,450.0,"Northern America",702916,702400,516,518751,864586,"CAN",691669
1,450.0,"Oceania",676931,651291,25640,491279,818798,"NZL",655039
1,450.0,"Eastern Africa",479110,0,479110,353277,588796,"ETH",471037
1,450.0,"Middle Africa",153712,0,153712,113889,189816,"AGO",151853
1,450.0,"Eastern Europe",3006587,2997805,8782,2298697,3831162,"POL",3064930
1,450.0,"Central Asia",1705992,1702115,3877,1301183,2168638,"UZB",1734911
1,450.0,"Southern Europe",901197,0,901197,675580,1125967,"ITA",900774
1,450.0,"Central America",446815,0,446815,337353,562256,"MEX",449805
1,450.0,"Southern Asia",807212,0,807212,612234,1020391,"IRN",816313
1,450.0,"Western Asia",1622904,0,1622904,1231761,2052936,"IRQ",1642349
1,450.0,"Eastern Asia",1065532,0,1065532,795954,1326591,"JPN",1061273
1,450.0,"Southern Africa",164794,0,164794,120858,201431,"ZAF",161145
1,450.0,"South-Eastern Asia",1455653,0,1455653,1059633,1766055,"IDN",1412844
1,450.0,"Caribbean",162044,0,162044,122337,203895,"CUB",163116
1,451.0,"Pakistan",2013226,2002099,11127,1525824,2543040,"PAK",2034432
1,451.0,"India",7270424,7269667,757,5354195,8923658,"IND",7138927
1,451.0,"Western Europe",4050228,4034146,16082,3048483,5080806,"NLD",4064645
1,451.0,"China",10325125,10046909,278216,7958510,13264183,"CPR",10611347
1,451.0,"United States of America",3165395,3165395,0,2386698,3977830,"USA",3182264
1,451.0,"Northern Africa",1809607,0,1809607,1353072,2255121,"EGY",1804097
1,451.0,"Russian Federation",2540246,2537637,2609,1885895,3143158,"RUS",2514527
1,451.0,"Western Africa",579706,0,579706,417438,695730,"NGA",556584
1,451.0,"South America",2171323,2170749,574,1644215,2740358,"BRA",2192287
1,451.0,"Northern Europe",2166913,2154445,12468,1636416,2727361,"GBR",2181889
1,451.0,"Northern America",750510,750152,358,518751,864586,"CAN",691669
1,451.0,"Oceania",687801,665501,22300,491279,818798,"NZL",655039
1,451.0,"Eastern Africa",495635,0,495635,353277,588796,"ETH",471037
1,451.0,"Middle Africa",158475,0,158475,113889,189816,"AGO",151853
1,451.0,"Eastern Europe",3043378,3032136,11242,2298697,3831162,"POL",3064930
1,451.0,"Central Asia",1714223,1708281,5942,1301183,2168638,"UZB",1734911
1,451.0,"Southern Europe",919276,0,919276,675580,1125967,"ITA",900774
1,451.0,"Central America",448756,0,448756,337353,562256,"MEX",449805
1,451.0,"Southern Asia",821780,0,821780,612234,1020391,"IRN",816313
1,451.0,"Western Asia",1653293,0,1653293,1231761,2052936,"IRQ",1642349
1,451.0,"Eastern Asia",1094878,0,1094878,795954,1326591,"JPN",1061273
1,451.0,"Southern Africa",167328,0,167328,120858,201431,"ZAF",161145
1,451.0,"South-Eastern Asia",1478655,0,1478655,1059633,1766055,"IDN",1412844
1,451.0,"Caribbean",162632,0,162632,122337,203895,"CUB",163116
1,452.0,"Pakistan",2033053,2018730,14323,1525824,2543040,"PAK",2034432
1,452.0,"India",7185700,7185310,390,5354195,8923658,"IND",7138927
1,452.0,"Western Europe",4428326,4411802,16524,3048483,5080806,"NLD",4064645
1,452.0,"China",10332504,10025983,306521,7958510,13264183,"CPR",10611347
1,452.0,"United States of America",3385422,3384527,895,2386698,3977830,"USA",3182264
1,452.0,"Northern Africa",1936233,0,1936233,1353072,2255121,"EGY",1804097
1,452.0,"Russian Federation",2663003,2660386,2617,1885895,3143158,"RUS",2514527
1,452.0,"Western Africa",569334,0,569334,417438,695730,"NGA",556584
1,452.0,"South America",2177686,2177003,683,1644215,2740358,"BRA",2192287
1,452.0,"Northern Europe",2172473,2158668,13805,1636416,2727361,"GBR",2181889
1,452.0,"Northern America",698049,697687,362,518751,864586,"CAN",691669
1,452.0,"Oceania",695507,676797,18710,491279,818798,"NZL",655039
1,452.0,"Eastern Africa",486788,0,486788,353277,588796,"ETH",471037
1,452.0,"Middle Africa",157151,0,157151,113889,189816,"AGO",151853
1,452.0,"Eastern Europe",3393245,3381712,11533,2298697,3831162,"POL",3064930
1,452.0,"Central Asia",1743265,1734205,9060,1301183,2168638,"UZB",1734911
1,452.0,"Southern Europe",949927,0,949927,675580,1125967,"ITA",900774
1,452.0,"Central America",477179,0,477179,337353,562256,"MEX",449805
1,452.0,"Southern Asia",845973,0,845973,612234,1020391,"IRN",816313
1,452.0,"Western Asia",1766786,0,1766786,1231761,2052936,"IRQ",1642349
1,452.0,"Eastern Asia",1113034,0,1113034,795954,1326591,"JPN",1061273
1,452.0,"Southern Africa",168386,0,168386,120858,201431,"ZAF",161145
1,452.0,"South-Eastern Asia",1495645,0,1495645,1059633,1766055,"IDN",1412844
1,452.0,"Caribbean",172978,0,172978,122337,203895,"CUB",163116
1,453.0,"Pakistan",2047832,2026458,21374,1525824,2543040,"PAK",2034432
1,453.0,"India",7216305,7216098,207,5354195,8923658,"IND",7138927
1,453.0,"Western Europe",4367722,4356326,11396,3048483,5080806,"NLD",4064645
1,453.0,"China",10410869,10072335,338534,7958510,13264183,"CPR",10611347
1,453.0,"United States of America",3376883,3376263,620,2386698,3977830,"USA",3182264
1,453.0,"Northern Africa",1916102,0,1916102,1353072,2255121,"EGY",1804097
1,453.0,"Russian Federation",2633586,2631775,1811,1885895,3143158,"RUS",2514527
1,453.0,"Western Africa",578176,0,578176,417438,695730,"NGA",556584
1,453.0,"South America",2208911,2207833,1078,1644215,2740358,"BRA",2192287
1,453.0,"Northern Europe",1976992,1955815,21177,1636416,2727361,"GBR",2181889
1,453.0,"Northern America",716646,716033,613,518751,864586,"CAN",691669
1,453.0,"Oceania",704620,690276,14344,491279,818798,"NZL",655039
1,453.0,"Eastern Africa",493043,0,493043,353277,588796,"ETH",471037
1,453.0,"Middle Africa",158821,0,158821,113889,189816,"AGO",151853
1,453.0,"Eastern Europe",3290375,3282578,7797,2298697,3831162,"POL",3064930
1,453.0,"Central Asia",1786758,1771711,15047,1301183,2168638,"UZB",1734911
1,453.0,"Southern Europe",950765,0,950765,675580,1125967,"ITA",900774
1,453.0,"Central America",476654,0,476654,337353,562256,"MEX",449805
1,453.0,"Southern Asia",850928,0,850928,612234,1020391,"IRN",816313
1,453.0,"Western Asia",1739636,0,1739636,1231761,2052936,"IRQ",1642349
1,453.0,"Eastern Asia",1115739,0,1115739,795954,1326591,"JPN",1061273
1,453.0,"Southern Africa",170353,0,170353,120858,201431,"ZAF",161145
1,453.0,"South-Eastern Asia",1509142,0,1509142,1059633,1766055,"IDN",1412844
1,453.0,"Caribbean",172813,0,172813,122337,203895,"CUB",163116
1,454.0,"Pakistan",2071910,2042443,29467,1525824,2543040,"PAK",2034432
1,454.0,"India",7282169,7281924,245,5354195,8923658,"IND",7138927
1,454.0,"Western Europe",4272511,4264982,7529,3048483,5080806,"NLD",4064645
1,454.0,"China",10393739,10022190,371549,7958510,13264183,"CPR",10611347
1,454.0,"United States of America",3368909,3368497,412,2386698,3977830,"USA",3182264
1,454.0,"Northern Africa",1889812,0,1889812,1353072,2255121,"EGY",1804097
1,454.0,"Russian Federation",2660097,2658859,1238,1885895,3143158,"RUS",2514527
1,454.0,"Western Africa",574708,0,574708,417438,695730,"NGA",556584
1,454.0,"South America",2217140,2215448,1692,1644215,2740358,"BRA",2192287
1,454.0,"Northern Europe",2020098,1974845,45253,1636416,2727361,"GBR",2181889
1,454.0,"Northern America",708546,707932,614,518751,864586,"CAN",691669
1,454.0,"Oceania",697726,688024,9702,491279,818798,"NZL",655039
1,454.0,"Eastern Africa",486946,0,486946,353277,588796,"ETH",471037
1,454.0,"Middle Africa",157428,0,157428,113889,189816,"AGO",151853
1,454.0,"Eastern Europe",3219591,3214415,5176,2298697,3831162,"POL",3064930
1,454.0,"Central Asia",1693520,1674555,18965,1301183,2168638,"UZB",1734911
1,454.0,"Southern Europe",940354,0,940354,675580,1125967,"ITA",900774
1,454.0,"Central America",475336,0,475336,337353,562256,"MEX",449805
1,454.0,"Southern Asia",840685,0,840685,612234,1020391,"IRN",816313
1,454.0,"Western Asia",1719429,0,1719429,1231761,2052936,"IRQ",1642349
1,454.0,"Eastern Asia",1116619,0,1116619,795954,1326591,"JPN",1061273
1,454.0,"Southern Africa",168987,0,168987,120858,201431,"ZAF",161145
1,454.0,"South-Eastern Asia",1498697,0,1498697,1059633,1766055,"IDN",1412844
1,454.0,"Caribbean",172325,0,172325,122337,203895,"CUB",163116
1,455.0,"Pakistan",2075685,2038540,37145,1525824,2543040,"PAK",2034432
1,455.0,"India",7326865,7326764,101,5354195,8923658,"IND",7138927
1,455.0,"Western Europe",4207291,4200951,6340,3048483,5080806,"NLD",4064645
1,455.0,"China",10459182,10050423,408759,7958510,13264183,"CPR",10611347
1,455.0,"United States of America",3306181,3305898,283,2386698,3977830,"USA",3182264
1,455.0,"Northern Africa",1868344,0,1868344,1353072,2255121,"EGY",1804097
1,455.0,"Russian Federation",2645232,2644379,853,1885895,3143158,"RUS",2514527
1,455.0,"Western Africa",582867,0,582867,417438,695730,"NGA",556584
1,455.0,"South America",2236020,2233161,2859,1644215,2740358,"BRA",2192287
1,455.0,"Northern Europe",2052599,1980230,72369,1636416,2727361,"GBR",2181889
1,455.0,"Northern America",731434,730296,1138,518751,864586,"CAN",691669
1,455.0,"Oceania",696837,689303,7534,491279,818798,"NZL",655039
1,455.0,"Eastern Africa",495255,0,495255,353277,588796,"ETH",471037
1,455.0,"Middle Africa",159312,0,159312,113889,189816,"AGO",151853
1,455.0,"Eastern Europe",3171133,3167139,3994,2298697,3831162,"POL",3064930
1,455.0,"Central Asia",1751896,1719904,31992,1301183,2168638,"UZB",1734911
1,455.0,"Southern Europe",936883,0,936883,675580,1125967,"ITA",900774
1,455.0,"Central America",467725,0,467725,337353,562256,"MEX",449805
1,455.0,"Southern Asia",849509,0,849509,612234,1020391,"IRN",816313
1,455.0,"Western Asia",1709323,0,1709323,1231761,2052936,"IRQ",1642349
1,455.0,"Eastern Asia",1118849,0,1118849,795954,1326591,"JPN",1061273
1,455.0,"Southern Africa",169645,0,169645,120858,201431,"ZAF",161145
1,455.0,"South-Eastern Asia",1497361,0,1497361,1059633,1766055,"IDN",1412844
1,455.0,"Caribbean",169635,0,169635,122337,203895,"CUB",163116
1,456.0,"Pakistan",2091176,2046120,45056,1525824,2543040,"PAK",2034432
1,456.0,"India",7356469,7356469,0,5354195,8923658,"IND",7138927
1,456.0,"Western Europe",4187389,4180664,6725,3048483,5080806,"NLD",4064645
1,456.0,"China",10506737,10061494,445243,7958510,13264183,"CPR",10611347
1,456.0,"United States of America",3300921,3300744,177,2386698,3977830,"USA",3182264
1,456.0,"Northern Africa",1857654,0,1857654,1353072,2255121,"EGY",1804097
1,456.0,"Russian Federation",2634059,2633384,675,1885895,3143158,"RUS",2514527
1,456.0,"Western Africa",564704,0,564704,417438,695730,"NGA",556584
1,456.0,"South America",2261846,2257791,4055,1644215,2740358,"BRA",2192287
1,456.0,"Northern Europe",2091945,1988972,102973,1636416,2727361,"GBR",2181889
1,456.0,"Northern America",686193,685444,749,518751,864586,"CAN",691669
1,456.0,"Oceania",691700,686653,5047,491279,818798,"NZL",655039
1,456.0,"Eastern Africa",481930,0,481930,353277,588796,"ETH",471037
1,456.0,"Middle Africa",154916,0,154916,113889,189816,"AGO",151853
1,456.0,"Eastern Europe",3156451,3152793,3658,2298697,3831162,"POL",3064930
1,456.0,"Central Asia",1803848,1762104,41744,1301183,2168638,"UZB",1734911
1,456.0,"Southern Europe",920874,0,920874,675580,1125967,"ITA",900774
1,456.0,"Central America",465925,0,465925,337353,562256,"MEX",449805
1,456.0,"Southern Asia",847886,0,847886,612234,1020391,"IRN",816313
1,456.0,"Western Asia",1693886,0,1693886,1231761,2052936,"IRQ",1642349
1,456.0,"Eastern Asia",1096733,0,1096733,795954,1326591,"JPN",1061273
1,456.0,"Southern Africa",168574,0,168574,120858,201431,"ZAF",161145
1,456.0,"South-Eastern Asia",1488263,0,1488263,1059633,1766055,"IDN",1412844
1,456.0,"Caribbean",168939,0,168939,122337,203895,"CUB",163116
1,457.0,"Pakistan",2101734,2049723,52011,1525824,2543040,"PAK",2034432
1,457.0,"India",7375332,7375332,0,5354195,8923658,"IND",7138927
1,457.0,"Western Europe",4173358,4167111,6247,3048483,5080806,"NLD",4064645
1,457.0,"China",10543283,10060167,483116,7958510,13264183,"CPR",10611347
1,457.0,"United States of America",3242617,3242490,127,2386698,3977830,"USA",3182264
1,457.0,"Northern Africa",1848735,0,1848735,1353072,2255121,"EGY",1804097
1,457.0,"Russian Federation",2580411,2579937,474,1885895,3143158,"RUS",2514527
1,457.0,"Western Africa",560291,0,560291,417438,695730,"NGA",556584
1,457.0,"South America",1378605,1374022,4583,1644215,2740358,"BRA",2192287
1,457.0,"Northern Europe",2135367,2001620,133747,1636416,2727361,"GBR",2181889
1,457.0,"Northern America",735786,733970,1816,518751,864586,"CAN",691669
1,457.0,"Oceania",687494,684565,2929,491279,818798,"NZL",655039
1,457.0,"Eastern Africa",479193,0,479193,353277,588796,"ETH",471037
1,457.0,"Middle Africa",150864,0,150864,113889,189816,"AGO",151853
1,457.0,"Eastern Europe",3109072,3105926,3146,2298697,3831162,"POL",3064930
1,457.0,"Central Asia",1838923,1791657,47266,1301183,2168638,"UZB",1734911
1,457.0,"Southern Europe",930073,0,930073,675580,1125967,"ITA",900774
1,457.0,"Central America",455424,0,455424,337353,562256,"MEX",449805
1,457.0,"Southern Asia",849999,0,849999,612234,1020391,"IRN",816313
1,457.0,"Western Asia",1681296,0,1681296,1231761,2052936,"IRQ",1642349
1,457.0,"Eastern Asia",1099869,0,1099869,795954,1326591,"JPN",1061273
1,457.0,"Southern Africa",148211,0,148211,120858,201431,"ZAF",161145
1,457.0,"South-Eastern Asia",1480605,0,1480605,1059633,1766055,"IDN",1412844
1,457.0,"Caribbean",164666,0,164666,122337,203895,"CUB",163116
1,458.0,"Pakistan",2108229,2050197,58032,1525824,2543040,"PAK",2034432
1,458.0,"India",7343394,7343394,0,5354195,8923658,"IND",7138927
1,458.0,"Western Europe",4163459,4157056,6403,3048483,5080806,"NLD",4064645
1,458.0,"China",10568599,10050181,518418,7958510,13264183,"CPR",10611347
1,458.0,"United States of America",3257938,3257746,192,2386698,3977830,"USA",3182264
1,458.0,"Northern Africa",1840288,0,1840288,1353072,2255121,"EGY",1804097
1,458.0,"Russian Federation",2574176,2573570,606,1885895,3143158,"RUS",2514527
1,458.0,"Western Africa",544436,0,544436,417438,695730,"NGA",556584
1,458.0,"South America",1465827,1394781,71046,1644215,2740358,"BRA",2192287
1,458.0,"Northern Europe",2168082,2004911,163171,1636416,2727361,"GBR",2181889
1,458.0,"Northern America",673753,672560,1193,518751,864586,"CAN",691669
1,458.0,"Oceania",680890,678984,1906,491279,818798,"NZL",655039
1,458.0,"Eastern Africa",464058,0,464058,353277,588796,"ETH",471037
1,458.0,"Middle Africa",147997,0,147997,113889,189816,"AGO",151853
1,458.0,"Eastern Europe",3113691,3109815,3876,2298697,3831162,"POL",3064930
1,458.0,"Central Asia",1850133,1803497,46636,1301183,2168638,"UZB",1734911
1,458.0,"Southern Europe",912111,0,912111,675580,1125967,"ITA",900774
1,458.0,"Central America",457298,0,457298,337353,562256,"MEX",449805
1,458.0,"Southern Asia",840044,0,840044,612234,1020391,"IRN",816313
1,458.0,"Western Asia",1668237,0,1668237,1231761,2052936,"IRQ",1642349
1,458.0,"Eastern Asia",1075102,0,1075102,795954,1326591,"JPN",1061273
1,458.0,"Southern Africa",151907,0,151907,120858,201431,"ZAF",161145
1,458.0,"South-Eastern Asia",1465785,0,1465785,1059633,1766055,"IDN",1412844
1,458.0,"Caribbean",165354,0,165354,122337,203895,"CUB",163116
1,459.0,"Pakistan",2111856,2050833,61023,1525824,2543040,"PAK",2034432
1,459.0,"India",7278100,7278100,0,5354195,8923658,"IND",7138927
1,459.0,"Western Europe",4083380,4077594,5786,3048483,5080806,"NLD",4064645
1,459.0,"China",10591524,10033583,557941,7958510,13264183,"CPR",10611347
1,459.0,"United States of America",3196636,3196495,141,2386698,3977830,"USA",3182264
1,459.0,"Northern Africa",1818585,0,1818585,1353072,2255121,"EGY",1804097
1,459.0,"Russian Federation",2554932,2554499,433,1885895,3143158,"RUS",2514527
1,459.0,"Western Africa",574572,0,574572,417438,695730,"NGA",556584
1,459.0,"South America",1558136,1406935,151201,1644215,2740358,"BRA",2192287
1,459.0,"Northern Europe",2192815,2000247,192568,1636416,2727361,"GBR",2181889
1,459.0,"Northern America",738514,736068,2446,518751,864586,"CAN",691669
1,459.0,"Oceania",676412,675101,1311,491279,818798,"NZL",655039
1,459.0,"Eastern Africa",488324,0,488324,353277,588796,"ETH",471037
1,459.0,"Middle Africa",155985,0,155985,113889,189816,"AGO",151853
1,459.0,"Eastern Europe",3080097,3076136,3961,2298697,3831162,"POL",3064930
1,459.0,"Central Asia",1835044,1796662,38382,1301183,2168638,"UZB",1734911
1,459.0,"Southern Europe",918242,0,918242,675580,1125967,"ITA",900774
1,459.0,"Central America",452067,0,452067,337353,562256,"MEX",449805
1,459.0,"Southern Asia",842053,0,842053,612234,1020391,"IRN",816313
1,459.0,"Western Asia",1662037,0,1662037,1231761,2052936,"IRQ",1642349
1,459.0,"Eastern Asia",1088756,0,1088756,795954,1326591,"JPN",1061273
1,459.0,"Southern Africa",157662,0,157662,120858,201431,"ZAF",161145
1,459.0,"South-Eastern Asia",1457147,0,1457147,1059633,1766055,"IDN",1412844
1,459.0,"Caribbean",163927,0,163927,122337,203895,"CUB",163116
1,460.0,"Pakistan",2101207,2040621,60586,1525824,2543040,"PAK",2034432
1,460.0,"India",7276125,7276125,0,5354195,8923658,"IND",7138927
1,460.0,"Western Europe",4101676,4094967,6709,3048483,5080806,"NLD",4064645
1,460.0,"China",10604646,10011067,593579,7958510,13264183,"CPR",10611347
1,460.0,"United States of America",3209468,3209016,452,2386698,3977830,"USA",3182264
1,460.0,"Northern Africa",1820848,0,1820848,1353072,2255121,"EGY",1804097
1,460.0,"Russian Federation",2541806,2541107,699,1885895,3143158,"RUS",2514527
1,460.0,"Western Africa",559898,0,559898,417438,695730,"NGA",556584
1,460.0,"South America",1661242,1423252,237990,1644215,2740358,"BRA",2192287
1,460.0,"Northern Europe",2224160,2003919,220241,1636416,2727361,"GBR",2181889
1,460.0,"Northern America",691350,689760,1590,518751,864586,"CAN",691669
1,460.0,"Oceania",673249,672398,851,491279,818798,"NZL",655039
1,460.0,"Eastern Africa",474965,0,474965,353277,588796,"ETH",471037
1,460.0,"Middle Africa",152879,0,152879,113889,189816,"AGO",151853
1,460.0,"Eastern Europe",3093659,3089021,4638,2298697,3831162,"POL",3064930
1,460.0,"Central Asia",1792624,1765692,26932,1301183,2168638,"UZB",1734911
1,460.0,"Southern Europe",907684,0,907684,675580,1125967,"ITA",900774
1,460.0,"Central America",453060,0,453060,337353,562256,"MEX",449805
1,460.0,"Southern Asia",830315,0,830315,612234,1020391,"IRN",816313
1,460.0,"Western Asia",1657043,0,1657043,1231761,2052936,"IRQ",1642349
1,460.0,"Eastern Asia",1070630,0,1070630,795954,1326591,"JPN",1061273
1,460.0,"Southern Africa",160484,0,160484,120858,201431,"ZAF",161145
1,460.0,"South-Eastern Asia",1450048,0,1450048,1059633,1766055,"IDN",1412844
1,460.0,"Caribbean",164162,0,164162,122337,203895,"CUB",163116
1,461.0,"Pakistan",2105634,2045750,59884,1525824,2543040,"PAK",2034432
1,461.0,"India",7189846,7189846,0,5354195,8923658,"IND",7138927
1,461.0,"Western Europe",4114054,4107102,6952,3048483,5080806,"NLD",4064645
1,461.0,"China",10691981,10061819,630162,7958510,13264183,"CPR",10611347
1,461.0,"United States of America",3200225,3199927,298,2386698,3977830,"USA",3182264
1,461.0,"Northern Africa",1821332,0,1821332,1353072,2255121,"EGY",1804097
1,461.0,"Russian Federation",2532985,2532522,463,1885895,3143158,"RUS",2514527
1,461.0,"Western Africa",561942,0,561942,417438,695730,"NGA",556584
1,461.0,"South America",1761055,1434121,326934,1644215,2740358,"BRA",2192287
1,461.0,"Northern Europe",2246160,2000823,245337,1636416,2727361,"GBR",2181889
1,461.0,"Northern America",691453,690404,1049,518751,864586,"CAN",691669
1,461.0,"Oceania",667311,666704,607,491279,818798,"NZL",655039
1,461.0,"Eastern Africa",474803,0,474803,353277,588796,"ETH",471037
1,461.0,"Middle Africa",153653,0,153653,113889,189816,"AGO",151853
1,461.0,"Eastern Europe",3084612,3079815,4797,2298697,3831162,"POL",3064930
1,461.0,"Central Asia",1784610,1761851,22759,1301183,2168638,"UZB",1734911
1,461.0,"Southern Europe",907340,0,907340,675580,1125967,"ITA",900774
1,461.0,"Central America",451887,0,451887,337353,562256,"MEX",449805
1,461.0,"Southern Asia",826458,0,826458,612234,1020391,"IRN",816313
1,461.0,"Western Asia",1650993,0,1650993,1231761,2052936,"IRQ",1642349
1,461.0,"Eastern Asia",1067505,0,1067505,795954,1326591,"JPN",1061273
1,461.0,"Southern Africa",162813,0,162813,120858,201431,"ZAF",161145
1,461.0,"South-Eastern Asia",1437129,0,1437129,1059633,1766055,"IDN",1412844
1,461.0,"Caribbean",164144,0,164144,122337,203895,"CUB",163116
1,462.0,"Pakistan",2083222,2029025,54197,1525824,2543040,"PAK",2034432
1,462.0,"India",7173585,7173585,0,5354195,8923658,"IND",7138927
1,462.0,"Western Europe",4050244,4043308,6936,3048483,5080806,"NLD",4064645
1,462.0,"China",10679809,10015901,663908,7958510,13264183,"CPR",10611347
1,462.0,"United States of America",3194120,3193921,199,2386698,3977830,"USA",3182264
1,462.0,"Northern Africa",1806132,0,1806132,1353072,2255121,"EGY",1804097
1,462.0,"Russian Federation",2527020,2526712,308,1885895,3143158,"RUS",2514527
1,462.0,"Western Africa",562783,0,562783,417438,695730,"NGA",556584
1,462.0,"South America",1858650,1443564,415086,1644215,2740358,"BRA",2192287
1,462.0,"Northern Europe",2274053,2007080,266973,1636416,2727361,"GBR",2181889
1,462.0,"Northern America",695374,694681,693,518751,864586,"CAN",691669
1,462.0,"Oceania",663227,662877,350,491279,818798,"NZL",655039
1,462.0,"Eastern Africa",476273,0,476273,353277,588796,"ETH",471037
1,462.0,"Middle Africa",154549,0,154549,113889,189816,"AGO",151853
1,462.0,"Eastern Europe",3096609,3091415,5194,2298697,3831162,"POL",3064930
1,462.0,"Central Asia",1727297,1712013,15284,1301183,2168638,"UZB",1734911
1,462.0,"Southern Europe",901990,0,901990,675580,1125967,"ITA",900774
1,462.0,"Central America",451335,0,451335,337353,562256,"MEX",449805
1,462.0,"Southern Asia",820396,0,820396,612234,1020391,"IRN",816313
1,462.0,"Western Asia",1653084,0,1653084,1231761,2052936,"IRQ",1642349
1,462.0,"Eastern Asia",1066895,0,1066895,795954,1326591,"JPN",1061273
1,462.0,"Southern Africa",164969,0,164969,120858,201431,"ZAF",161145
1,462.0,"South-Eastern Asia",1429150,0,1429150,1059633,1766055,"IDN",1412844
1,462.0,"Caribbean",163855,0,163855,122337,203895,"CUB",163116
1,463.0,"Pakistan",2080048,2029051,50997,1525824,2543040,"PAK",2034432
1,463.0,"India",7120465,7120465,0,5354195,8923658,"IND",7138927
1,463.0,"Western Europe",4078816,4071332,7484,3048483,5080806,"NLD",4064645
1,463.0,"China",10744913,10048890,696023,7958510,13264183,"CPR",10611347
1,463.0,"United States of America",3190086,3189959,127,2386698,3977830,"USA",3182264
1,463.0,"Northern Africa",1805027,0,1805027,1353072,2255121,"EGY",1804097
1,463.0,"Russian Federation",2522973,2522773,200,1885895,3143158,"RUS",2514527
1,463.0,"Western Africa",554111,0,554111,417438,695730,"NGA",556584
1,463.0,"South America",1955061,1454119,500942,1644215,2740358,"BRA",2192287
1,463.0,"Northern Europe",2291530,2008226,283304,1636416,2727361,"GBR",2181889
1,463.0,"Northern America",678733,678277,456,518751,864586,"CAN",691669
1,463.0,"Oceania",656806,656539,267,491279,818798,"NZL",655039
1,463.0,"Eastern Africa",468690,0,468690,353277,588796,"ETH",471037
1,463.0,"Middle Africa",152763,0,152763,113889,189816,"AGO",151853
1,463.0,"Eastern Europe",3050142,3044981,5161,2298697,3831162,"POL",3064930
1,463.0,"Central Asia",1760667,1744961,15706,1301183,2168638,"UZB",1734911
1,463.0,"Southern Europe",899678,0,899678,675580,1125967,"ITA",900774
1,463.0,"Central America",450062,0,450062,337353,562256,"MEX",449805
1,463.0,"Southern Asia",817791,0,817791,612234,1020391,"IRN",816313
1,463.0,"Western Asia",1634701,0,1634701,1231761,2052936,"IRQ",1642349
1,463.0,"Eastern Asia",1059150,0,1059150,795954,1326591,"JPN",1061273
1,463.0,"Southern Africa",164772,0,164772,120858,201431,"ZAF",161145
1,463.0,"South-Eastern Asia",1415879,0,1415879,1059633,1766055,"IDN",1412844
1,463.0,"Caribbean",163312,0,163312,122337,203895,"CUB",163116
1,464.0,"Pakistan",2065477,2017497,47980,1525824,2543040,"PAK",2034432
1,464.0,"India",7084242,7084242,0,5354195,8923658,"IND",7138927
1,464.0,"Western Europe",4026431,4019384,7047,3048483,5080806,"NLD",4064645
1,464.0,"China",10793457,10066885,726572,7958510,13264183,"CPR",10611347
1,464.0,"United States of America",3152188,3152188,0,2386698,3977830,"USA",3182264
1,464.0,"Northern Africa",1791137,0,1791137,1353072,2255121,"EGY",1804097
1,464.0,"Russian Federation",2476388,2476242,146,1885895,3143158,"RUS",2514527
1,464.0,"Western Africa",576905,0,576905,417438,695730,"NGA",556584
1,464.0,"South America",2033985,1450438,583547,1644215,2740358,"BRA",2192287
1,464.0,"Northern Europe",2302465,2006880,295585,1636416,2727361,"GBR",2181889
1,464.0,"Northern America",737171,736359,812,518751,864586,"CAN",691669
1,464.0,"Oceania",652428,652287,141,491279,818798,"NZL",655039
1,464.0,"Eastern Africa",487522,0,487522,353277,588796,"ETH",471037
1,464.0,"Middle Africa",158394,0,158394,113889,189816,"AGO",151853
1,464.0,"Eastern Europe",3036666,3031390,5276,2298697,3831162,"POL",3064930
1,464.0,"Central Asia",1742113,1730365,11748,1301183,2168638,"UZB",1734911
1,464.0,"Southern Europe",908537,0,908537,675580,1125967,"ITA",900774
1,464.0,"Central America",448023,0,448023,337353,562256,"MEX",449805
1,464.0,"Southern Asia",815261,0,815261,612234,1020391,"IRN",816313
1,464.0,"Western Asia",1628610,0,1628610,1231761,2052936,"IRQ",1642349
1,464.0,"Eastern Asia",1065854,0,1065854,795954,1326591,"JPN",1061273
1,464.0,"Southern Africa",166392,0,166392,120858,201431,"ZAF",161145
1,464.0,"South-Eastern Asia",1406480,0,1406480,1059633,1766055,"IDN",1412844
1,464.0,"Caribbean",162660,0,162660,122337,203895,"CUB",163116
1,465.0,"Pakistan",2055643,2011703,43940,1525824,2543040,"PAK",2034432
1,465.0,"India",7059410,7058942,468,5354195,8923658,"IND",7138927
1,465.0,"Western Europe",4014281,4006100,8181,3048483,5080806,"NLD",4064645
1,465.0,"China",10827069,10073683,753386,7958510,13264183,"CPR",10611347
1,465.0,"United States of America",3162392,3161664,728,2386698,3977830,"USA",3182264
1,465.0,"Northern Africa",1781354,0,1781354,1353072,2255121,"EGY",1804097
1,465.0,"Russian Federation",2547304,2546285,1019,1885895,3143158,"RUS",2514527
1,465.0,"Western Africa",557608,0,557608,417438,695730,"NGA",556584
1,465.0,"South America",2128516,1468377,660139,1644215,2740358,"BRA",2192287
1,465.0,"Northern Europe",2306018,2006421,299597,1636416,2727361,"GBR",2181889
1,465.0,"Northern America",686903,686375,528,518751,864586,"CAN",691669
1,465.0,"Oceania",653364,653101,263,491279,818798,"NZL",655039
1,465.0,"Eastern Africa",470473,0,470473,353277,588796,"ETH",471037
1,465.0,"Middle Africa",153116,0,153116,113889,189816,"AGO",151853
1,465.0,"Eastern Europe",3008951,3002521,6430,2298697,3831162,"POL",3064930
1,465.0,"Central Asia",1708825,1699689,9136,1301183,2168638,"UZB",1734911
1,465.0,"Southern Europe",893316,0,893316,675580,1125967,"ITA",900774
1,465.0,"Central America",447718,0,447718,337353,562256,"MEX",449805
1,465.0,"Southern Asia",813549,0,813549,612234,1020391,"IRN",816313
1,465.0,"Western Asia",1620709,0,1620709,1231761,2052936,"IRQ",1642349
1,465.0,"Eastern Asia",1065511,0,1065511,795954,1326591,"JPN",1061273
1,465.0,"Southern Africa",165531,0,165531,120858,201431,"ZAF",161145
1,465.0,"South-Eastern Asia",1409508,0,1409508,1059633,1766055,"IDN",1412844
1,465.0,"Caribbean",162468,0,162468,122337,203895,"CUB",163116
1,466.0,"Pakistan",2060989,2018301,42688,1525824,2543040,"PAK",2034432
1,466.0,"India",7084331,7084034,297,5354195,8923658,"IND",7138927
1,466.0,"Western Europe",4029866,4021006,8860,3048483,5080806,"NLD",4064645
1,466.0,"China",10846792,10073050,773742,7958510,13264183,"CPR",10611347
1,466.0,"United States of America",3133719,3133253,466,2386698,3977830,"USA",3182264
1,466.0,"Northern Africa",1791895,0,1791895,1353072,2255121,"EGY",1804097
1,466.0,"Russian Federation",2492724,2492078,646,1885895,3143158,"RUS",2514527
1,466.0,"Western Africa",544896,0,544896,417438,695730,"NGA",556584
1,466.0,"South America",2203774,1472319,731455,1644215,2740358,"BRA",2192287
1,466.0,"Northern Europe",2306970,2006893,300077,1636416,2727361,"GBR",2181889
1,466.0,"Northern America",661953,661608,345,518751,864586,"CAN",691669
1,466.0,"Oceania",650064,649961,103,491279,818798,"NZL",655039
1,466.0,"Eastern Africa",463316,0,463316,353277,588796,"ETH",471037
1,466.0,"Middle Africa",149305,0,149305,113889,189816,"AGO",151853
1,466.0,"Eastern Europe",3081328,3073217,8111,2298697,3831162,"POL",3064930
1,466.0,"Central Asia",1727616,1718071,9545,1301183,2168638,"UZB",1734911
1,466.0,"Southern Europe",884695,0,884695,675580,1125967,"ITA",900774
1,466.0,"Central America",443087,0,443087,337353,562256,"MEX",449805
1,466.0,"Southern Asia",808755,0,808755,612234,1020391,"IRN",816313
1,466.0,"Western Asia",1640740,0,1640740,1231761,2052936,"IRQ",1642349
1,466.0,"Eastern Asia",1041446,0,1041446,795954,1326591,"JPN",1061273
1,466.0,"Southern Africa",164115,0,164115,120858,201431,"ZAF",161145
1,466.0,"South-Eastern Asia",1402308,0,1402308,1059633,1766055,"IDN",1412844
1,466.0,"Caribbean",160666,0,160666,122337,203895,"CUB",163116
1,467.0,"Pakistan",2028102,1999120,28982,1525824,2543040,"PAK",2034432
1,467.0,"India",7059033,7058816,217,5354195,8923658,"IND",7138927
1,467.0,"Western Europe",4016540,4008553,7987,3048483,5080806,"NLD",4064645
1,467.0,"China",10863567,10067923,795644,7958510,13264183,"CPR",10611347
1,467.0,"United States of America",3132116,3131780,336,2386698,3977830,"USA",3182264
1,467.0,"Northern Africa",1781165,0,1781165,1353072,2255121,"EGY",1804097
1,467.0,"Russian Federation",2455692,2455226,466,1885895,3143158,"RUS",2514527
1,467.0,"Western Africa",568176,0,568176,417438,695730,"NGA",556584
1,467.0,"South America",2262004,1464653,797351,1644215,2740358,"BRA",2192287
1,467.0,"Northern Europe",2281515,1998148,283367,1636416,2727361,"GBR",2181889
1,467.0,"Northern America",721708,721361,347,518751,864586,"CAN",691669
1,467.0,"Oceania",647817,647817,0,491279,818798,"NZL",655039
1,467.0,"Eastern Africa",481845,0,481845,353277,588796,"ETH",471037
1,467.0,"Middle Africa",156009,0,156009,113889,189816,"AGO",151853
1,467.0,"Eastern Europe",3002829,2997225,5604,2298697,3831162,"POL",3064930
1,467.0,"Central Asia",1719436,1711794,7642,1301183,2168638,"UZB",1734911
1,467.0,"Southern Europe",900308,0,900308,675580,1125967,"ITA",900774
1,467.0,"Central America",445026,0,445026,337353,562256,"MEX",449805
1,467.0,"Southern Asia",805759,0,805759,612234,1020391,"IRN",816313
1,467.0,"Western Asia",1610425,0,1610425,1231761,2052936,"IRQ",1642349
1,467.0,"Eastern Asia",1055141,0,1055141,795954,1326591,"JPN",1061273
1,467.0,"Southern Africa",165442,0,165442,120858,201431,"ZAF",161145
1,467.0,"South-Eastern Asia",1397908,0,1397908,1059633,1766055,"IDN",1412844
1,467.0,"Caribbean",161687,0,161687,122337,203895,"CUB",163116
1,468.0,"Pakistan",2029962,2002373,27589,1525824,2543040,"PAK",2034432
1,468.0,"India",7083944,7083435,509,5354195,8923658,"IND",7138927
1,468.0,"Western Europe",4007991,3999099,8892,3048483,5080806,"NLD",4064645
1,468.0,"China",10872333,10059260,813073,7958510,13264183,"CPR",10611347
1,468.0,"United States of America",3166513,3165580,933,2386698,3977830,"USA",3182264
1,468.0,"Northern Africa",1777793,0,1777793,1353072,2255121,"EGY",1804097
1,468.0,"Russian Federation",2503701,2502491,1210,1885895,3143158,"RUS",2514527
1,468.0,"Western Africa",545648,0,545648,417438,695730,"NGA",556584
1,468.0,"South America",2333837,1477891,855946,1644215,2740358,"BRA",2192287
1,468.0,"Northern Europe",2261665,1994794,266871,1636416,2727361,"GBR",2181889
1,468.0,"Northern America",661843,661612,231,518751,864586,"CAN",691669
1,468.0,"Oceania",646339,646339,0,491279,818798,"NZL",655039
1,468.0,"Eastern Africa",460360,0,460360,353277,588796,"ETH",471037
1,468.0,"Middle Africa",149448,0,149448,113889,189816,"AGO",151853
1,468.0,"Eastern Europe",3003307,2996432,6875,2298697,3831162,"POL",3064930
1,468.0,"Central Asia",1713595,1707250,6345,1301183,2168638,"UZB",1734911
1,468.0,"Southern Europe",884397,0,884397,675580,1125967,"ITA",900774
1,468.0,"Central America",447220,0,447220,337353,562256,"MEX",449805
1,468.0,"Southern Asia",807509,0,807509,612234,1020391,"IRN",816313
1,468.0,"Western Asia",1610511,0,1610511,1231761,2052936,"IRQ",1642349
1,468.0,"Eastern Asia",1045813,0,1045813,795954,1326591,"JPN",1061273
1,468.0,"Southern Africa",162634,0,162634,120858,201431,"ZAF",161145
1,468.0,"South-Eastern Asia",1395450,0,1395450,1059633,1766055,"IDN",1412844
1,468.0,"Caribbean",162076,0,162076,122337,203895,"CUB",163116
1,469.0,"Pakistan",2006572,1981210,25362,1525824,2543040,"PAK",2034432
1,469.0,"India",7015707,7015360,347,5354195,8923658,"IND",7138927
1,469.0,"Western Europe",4000969,3991678,9291,3048483,5080806,"NLD",4064645
1,469.0,"China",10873909,10049037,824872,7958510,13264183,"CPR",10611347
1,469.0,"United States of America",3118116,3117481,635,2386698,3977830,"USA",3182264
1,469.0,"Northern Africa",1785156,0,1785156,1353072,2255121,"EGY",1804097
1,469.0,"Russian Federation",2447931,2447104,827,1885895,3143158,"RUS",2514527
1,469.0,"Western Africa",550121,0,550121,417438,695730,"NGA",556584
1,469.0,"South America",2383270,1477946,905324,1644215,2740358,"BRA",2192287
1,469.0,"Northern Europe",2235873,1993269,242604,1636416,2727361,"GBR",2181889
1,469.0,"Northern America",679278,679048,230,518751,864586,"CAN",691669
1,469.0,"Oceania",641492,641492,0,491279,818798,"NZL",655039
1,469.0,"Eastern Africa",467468,0,467468,353277,588796,"ETH",471037
1,469.0,"Middle Africa",150436,0,150436,113889,189816,"AGO",151853
1,469.0,"Eastern Europe",3096382,3088424,7958,2298697,3831162,"POL",3064930
1,469.0,"Central Asia",1709461,1703809,5652,1301183,2168638,"UZB",1734911
1,469.0,"Southern Europe",886869,0,886869,675580,1125967,"ITA",900774
1,469.0,"Central America",441614,0,441614,337353,562256,"MEX",449805
1,469.0,"Southern Asia",802002,0,802002,612234,1020391,"IRN",816313
1,469.0,"Western Asia",1642117,0,1642117,1231761,2052936,"IRQ",1642349
1,469.0,"Eastern Asia",1035062,0,1035062,795954,1326591,"JPN",1061273
1,469.0,"Southern Africa",161925,0,161925,120858,201431,"ZAF",161145
1,469.0,"South-Eastern Asia",1384517,0,1384517,1059633,1766055,"IDN",1412844
1,469.0,"Caribbean",160251,0,160251,122337,203895,"CUB",163116
1,470.0,"Pakistan",2002541,1978582,23959,1525824,2543040,"PAK",2034432
1,470.0,"India",7053657,7053431,226,5354195,8923658,"IND",7138927
1,470.0,"Western Europe",3996406,3986573,9833,3048483,5080806,"NLD",4064645
1,470.0,"China",10879689,10039240,840449,7958510,13264183,"CPR",10611347
1,470.0,"United States of America",3193073,3192660,413,2386698,3977830,"USA",3182264
1,470.0,"Northern Africa",1778745,0,1778745,1353072,2255121,"EGY",1804097
1,470.0,"Russian Federation",2513314,2512440,874,1885895,3143158,"RUS",2514527
1,470.0,"Western Africa",544494,0,544494,417438,695730,"NGA",556584
1,470.0,"South America",2416809,1470194,946615,1644215,2740358,"BRA",2192287
1,470.0,"Northern Europe",2218570,1992270,226300,1636416,2727361,"GBR",2181889
1,470.0,"Northern America",656254,656095,159,518751,864586,"CAN",691669
1,470.0,"Oceania",638090,638090,0,491279,818798,"NZL",655039
1,470.0,"Eastern Africa",456931,0,456931,353277,588796,"ETH",471037
1,470.0,"Middle Africa",148780,0,148780,113889,189816,"AGO",151853
1,470.0,"Eastern Europe",3030867,3024298,6569,2298697,3831162,"POL",3064930
1,470.0,"Central Asia",1685507,1680865,4642,1301183,2168638,"UZB",1734911
1,470.0,"Southern Europe",882467,0,882467,675580,1125967,"ITA",900774
1,470.0,"Central America",449934,0,449934,337353,562256,"MEX",449805
1,470.0,"Southern Asia",804490,0,804490,612234,1020391,"IRN",816313
1,470.0,"Western Asia",1621008,0,1621008,1231761,2052936,"IRQ",1642349
1,470.0,"Eastern Asia",1048001,0,1048001,795954,1326591,"JPN",1061273
1,470.0,"Southern Africa",159852,0,159852,120858,201431,"ZAF",161145
1,470.0,"South-Eastern Asia",1378355,0,1378355,1059633,1766055,"IDN",1412844
1,470.0,"Caribbean",163155,0,163155,122337,203895,"CUB",163116
1,471.0,"Pakistan",2012049,1988129,23920,1525824,2543040,"PAK",2034432
1,471.0,"India",7036853,7036687,166,5354195,8923658,"IND",7138927
1,471.0,"Western Europe",3992554,3983071,9483,3048483,5080806,"NLD",4064645
1,471.0,"China",10879896,10028460,851436,7958510,13264183,"CPR",10611347
1,471.0,"United States of America",3135552,3135251,301,2386698,3977830,"USA",3182264
1,471.0,"Northern Africa",1776347,0,1776347,1353072,2255121,"EGY",1804097
1,471.0,"Russian Federation",2454025,2453382,643,1885895,3143158,"RUS",2514527
1,471.0,"Western Africa",566886,0,566886,417438,695730,"NGA",556584
1,471.0,"South America",2461327,1483404,977923,1644215,2740358,"BRA",2192287
1,471.0,"Northern Europe",2207653,1985302,222351,1636416,2727361,"GBR",2181889
1,471.0,"Northern America",718675,717639,1036,518751,864586,"CAN",691669
1,471.0,"Oceania",639602,639498,104,491279,818798,"NZL",655039
1,471.0,"Eastern Africa",478899,0,478899,353277,588796,"ETH",471037
1,471.0,"Middle Africa",155053,0,155053,113889,189816,"AGO",151853
1,471.0,"Eastern Europe",3004255,2998580,5675,2298697,3831162,"POL",3064930
1,471.0,"Central Asia",1700475,1694448,6027,1301183,2168638,"UZB",1734911
1,471.0,"Southern Europe",898633,0,898633,675580,1125967,"ITA",900774
1,471.0,"Central America",445665,0,445665,337353,562256,"MEX",449805
1,471.0,"Southern Asia",804011,0,804011,612234,1020391,"IRN",816313
1,471.0,"Western Asia",1610551,0,1610551,1231761,2052936,"IRQ",1642349
1,471.0,"Eastern Asia",1049660,0,1049660,795954,1326591,"JPN",1061273
1,471.0,"Southern Africa",162542,0,162542,120858,201431,"ZAF",161145
1,471.0,"South-Eastern Asia",1381332,0,1381332,1059633,1766055,"IDN",1412844
1,471.0,"Caribbean",161738,0,161738,122337,203895,"CUB",163116
1,472.0,"Pakistan",2006007,1982625,23382,1525824,2543040,"PAK",2034432
1,472.0,"India",6981562,6981253,309,5354195,8923658,"IND",7138927
1,472.0,"Western Europe",4039073,4028517,10556,3048483,5080806,"NLD",4064645
1,472.0,"China",10876308,10018210,858098,7958510,13264183,"CPR",10611347
1,472.0,"United States of America",3132724,3132058,666,2386698,3977830,"USA",3182264
1,472.0,"Northern Africa",1782038,0,1782038,1353072,2255121,"EGY",1804097
1,472.0,"Russian Federation",2502723,2501507,1216,1885895,3143158,"RUS",2514527
1,472.0,"Western Africa",545045,0,545045,417438,695730,"NGA",556584
1,472.0,"South America",2469100,1476184,992916,1644215,2740358,"BRA",2192287
1,472.0,"Northern Europe",2185045,1981932,203113,1636416,2727361,"GBR",2181889
1,472.0,"Northern America",666703,666019,684,518751,864586,"CAN",691669
1,472.0,"Oceania",640513,640342,171,491279,818798,"NZL",655039
1,472.0,"Eastern Africa",459359,0,459359,353277,588796,"ETH",471037
1,472.0,"Middle Africa",148612,0,148612,113889,189816,"AGO",151853
1,472.0,"Eastern Europe",3003805,2997337,6468,2298697,3831162,"POL",3064930
1,472.0,"Central Asia",1742823,1735932,6891,1301183,2168638,"UZB",1734911
1,472.0,"Southern Europe",886374,0,886374,675580,1125967,"ITA",900774
1,472.0,"Central America",442763,0,442763,337353,562256,"MEX",449805
1,472.0,"Southern Asia",809130,0,809130,612234,1020391,"IRN",816313
1,472.0,"Western Asia",1612311,0,1612311,1231761,2052936,"IRQ",1642349
1,472.0,"Eastern Asia",1046187,0,1046187,795954,1326591,"JPN",1061273
1,472.0,"Southern Africa",159913,0,159913,120858,201431,"ZAF",161145
1,472.0,"South-Eastern Asia",1381945,0,1381945,1059633,1766055,"IDN",1412844
1,472.0,"Caribbean",160517,0,160517,122337,203895,"CUB",163116
1,473.0,"Pakistan",1989568,1972891,16677,1525824,2543040,"PAK",2034432
1,473.0,"India",7029154,7028943,211,5354195,8923658,"IND",7138927
1,473.0,"Western Europe",3997071,3986582,10489,3048483,5080806,"NLD",4064645
1,473.0,"China",10874766,10009748,865018,7958510,13264183,"CPR",10611347
1,473.0,"United States of America",3148822,3148368,454,2386698,3977830,"USA",3182264
1,473.0,"Northern Africa",1775672,0,1775672,1353072,2255121,"EGY",1804097
1,473.0,"Russian Federation",2491334,2490501,833,1885895,3143158,"RUS",2514527
1,473.0,"Western Africa",549292,0,549292,417438,695730,"NGA",556584
1,473.0,"South America",2481131,1479682,1001449,1644215,2740358,"BRA",2192287
1,473.0,"Northern Europe",2170705,1979450,191255,1636416,2727361,"GBR",2181889
1,473.0,"Northern America",678649,678182,467,518751,864586,"CAN",691669
1,473.0,"Oceania",641058,640940,118,491279,818798,"NZL",655039
1,473.0,"Eastern Africa",464600,0,464600,353277,588796,"ETH",471037
1,473.0,"Middle Africa",150305,0,150305,113889,189816,"AGO",151853
1,473.0,"Eastern Europe",3022138,3015233,6905,2298697,3831162,"POL",3064930
1,473.0,"Central Asia",1708316,1702827,5489,1301183,2168638,"UZB",1734911
1,473.0,"Southern Europe",887998,0,887998,675580,1125967,"ITA",900774
1,473.0,"Central America",445397,0,445397,337353,562256,"MEX",449805
1,473.0,"Southern Asia",806860,0,806860,612234,1020391,"IRN",816313
1,473.0,"Western Asia",1619238,0,1619238,1231761,2052936,"IRQ",1642349
1,473.0,"Eastern Asia",1048272,0,1048272,795954,1326591,"JPN",1061273
1,473.0,"Southern Africa",160573,0,160573,120858,201431,"ZAF",161145
1,473.0,"South-Eastern Asia",1383776,0,1383776,1059633,1766055,"IDN",1412844
1,473.0,"Caribbean",161605,0,161605,122337,203895,"CUB",163116
1,474.0,"Pakistan",1990215,1973404,16811,1525824,2543040,"PAK",2034432
1,474.0,"India",7018575,7018436,139,5354195,8923658,"IND",7138927
1,474.0,"Western Europe",4042262,4031297,10965,3048483,5080806,"NLD",4064645
1,474.0,"China",10869220,10002354,866866,7958510,13264183,"CPR",10611347
1,474.0,"United States of America",3141455,3141154,301,2386698,3977830,"USA",3182264
1,474.0,"Northern Africa",1783523,0,1783523,1353072,2255121,"EGY",1804097
1,474.0,"Russian Federation",2483387,2482838,549,1885895,3143158,"RUS",2514527
1,474.0,"Western Africa",542575,0,542575,417438,695730,"NGA",556584
1,474.0,"South America",2467000,1476205,990795,1644215,2740358,"BRA",2192287
1,474.0,"Northern Europe",2159977,1976833,183144,1636416,2727361,"GBR",2181889
1,474.0,"Northern America",663046,662730,316,518751,864586,"CAN",691669
1,474.0,"Oceania",641301,641301,0,491279,818798,"NZL",655039
1,474.0,"Eastern Africa",458205,0,458205,353277,588796,"ETH",471037
1,474.0,"Middle Africa",148175,0,148175,113889,189816,"AGO",151853
1,474.0,"Eastern Europe",3016012,3008930,7082,2298697,3831162,"POL",3064930
1,474.0,"Central Asia",1716103,1711052,5051,1301183,2168638,"UZB",1734911
1,474.0,"Southern Europe",885697,0,885697,675580,1125967,"ITA",900774
1,474.0,"Central America",443944,0,443944,337353,562256,"MEX",449805
1,474.0,"Southern Asia",804603,0,804603,612234,1020391,"IRN",816313
1,474.0,"Western Asia",1615097,0,1615097,1231761,2052936,"IRQ",1642349
1,474.0,"Eastern Asia",1039932,0,1039932,795954,1326591,"JPN",1061273
1,474.0,"Southern Africa",159456,0,159456,120858,201431,"ZAF",161145
1,474.0,"South-Eastern Asia",1383651,0,1383651,1059633,1766055,"IDN",1412844
1,474.0,"Caribbean",160846,0,160846,122337,203895,"CUB",163116
1,475.0,"Pakistan",2003169,1986121,17048,1525824,2543040,"PAK",2034432
1,475.0,"India",7010757,7010655,102,5354195,8923658,"IND",7138927
1,475.0,"Western Europe",3999036,3989028,10008,3048483,5080806,"NLD",4064645
1,475.0,"China",10868702,9997229,871473,7958510,13264183,"CPR",10611347
1,475.0,"United States of America",3136352,3136131,221,2386698,3977830,"USA",3182264
1,475.0,"Northern Africa",1777542,0,1777542,1353072,2255121,"EGY",1804097
1,475.0,"Russian Federation",2462663,2462261,402,1885895,3143158,"RUS",2514527
1,475.0,"Western Africa",561162,0,561162,417438,695730,"NGA",556584
1,475.0,"South America",2465125,1484932,980193,1644215,2740358,"BRA",2192287
1,475.0,"Northern Europe",2167258,1987027,180231,1636416,2727361,"GBR",2181889
1,475.0,"Northern America",716154,715494,660,518751,864586,"CAN",691669
1,475.0,"Oceania",641598,641498,100,491279,818798,"NZL",655039
1,475.0,"Eastern Africa",478019,0,478019,353277,588796,"ETH",471037
1,475.0,"Middle Africa",153712,0,153712,113889,189816,"AGO",151853
1,475.0,"Eastern Europe",3011753,3005359,6394,2298697,3831162,"POL",3064930
1,475.0,"Central Asia",1700075,1695693,4382,1301183,2168638,"UZB",1734911
1,475.0,"Southern Europe",899229,0,899229,675580,1125967,"ITA",900774
1,475.0,"Central America",445364,0,445364,337353,562256,"MEX",449805
1,475.0,"Southern Asia",805124,0,805124,612234,1020391,"IRN",816313
1,475.0,"Western Asia",1613495,0,1613495,1231761,2052936,"IRQ",1642349
1,475.0,"Eastern Asia",1052170,0,1052170,795954,1326591,"JPN",1061273
1,475.0,"Southern Africa",161590,0,161590,120858,201431,"ZAF",161145
1,475.0,"South-Eastern Asia",1385475,0,1385475,1059633,1766055,"IDN",1412844
1,475.0,"Caribbean",161676,0,161676,122337,203895,"CUB",163116
1,476.0,"Pakistan",1999706,1982617,17089,1525824,2543040,"PAK",2034432
1,476.0,"India",7049051,7048801,250,5354195,8923658,"IND",7138927
1,476.0,"Western Europe",4018626,4007716,10910,3048483,5080806,"NLD",4064645
1,476.0,"China",10932936,10062839,870097,7958510,13264183,"CPR",10611347
1,476.0,"United States of America",3169470,3168957,513,2386698,3977830,"USA",3182264
1,476.0,"Northern Africa",1783682,0,1783682,1353072,2255121,"EGY",1804097
1,476.0,"Russian Federation",2463186,2462344,842,1885895,3143158,"RUS",2514527
1,476.0,"Western Africa",549625,0,549625,417438,695730,"NGA",556584
1,476.0,"South America",2445330,1482929,962401,1644215,2740358,"BRA",2192287
1,476.0,"Northern Europe",2157751,1980428,177323,1636416,2727361,"GBR",2181889
1,476.0,"Northern America",676246,675802,444,518751,864586,"CAN",691669
1,476.0,"Oceania",645673,645518,155,491279,818798,"NZL",655039
1,476.0,"Eastern Africa",464079,0,464079,353277,588796,"ETH",471037
1,476.0,"Middle Africa",150111,0,150111,113889,189816,"AGO",151853
1,476.0,"Eastern Europe",3027500,3020317,7183,2298697,3831162,"POL",3064930
1,476.0,"Central Asia",1721092,1716322,4770,1301183,2168638,"UZB",1734911
1,476.0,"Southern Europe",890257,0,890257,675580,1125967,"ITA",900774
1,476.0,"Central America",447956,0,447956,337353,562256,"MEX",449805
1,476.0,"Southern Asia",803912,0,803912,612234,1020391,"IRN",816313
1,476.0,"Western Asia",1620456,0,1620456,1231761,2052936,"IRQ",1642349
1,476.0,"Eastern Asia",1041768,0,1041768,795954,1326591,"JPN",1061273
1,476.0,"Southern Africa",160491,0,160491,120858,201431,"ZAF",161145
1,476.0,"South-Eastern Asia",1393035,0,1393035,1059633,1766055,"IDN",1412844
1,476.0,"Caribbean",162324,0,162324,122337,203895,"CUB",163116
1,477.0,"Pakistan",2009753,1992945,16808,1525824,2543040,"PAK",2034432
1,477.0,"India",7031478,7031312,166,5354195,8923658,"IND",7138927
1,477.0,"Western Europe",4057437,4046208,11229,3048483,5080806,"NLD",4064645
1,477.0,"China",10908930,10043811,865119,7958510,13264183,"CPR",10611347
1,477.0,"United States of America",3136766,3136429,337,2386698,3977830,"USA",3182264
1,477.0,"Northern Africa",1787355,0,1787355,1353072,2255121,"EGY",1804097
1,477.0,"Russian Federation",2509400,2508843,557,1885895,3143158,"RUS",2514527
1,477.0,"Western Africa",541068,0,541068,417438,695730,"NGA",556584
1,477.0,"South America",2424551,1484870,939681,1644215,2740358,"BRA",2192287
1,477.0,"Northern Europe",2163039,1987931,175108,1636416,2727361,"GBR",2181889
1,477.0,"Northern America",657178,656876,302,518751,864586,"CAN",691669
1,477.0,"Oceania",648497,648394,103,491279,818798,"NZL",655039
1,477.0,"Eastern Africa",455018,0,455018,353277,588796,"ETH",471037
1,477.0,"Middle Africa",147314,0,147314,113889,189816,"AGO",151853
1,477.0,"Eastern Europe",3019334,3011826,7508,2298697,3831162,"POL",3064930
1,477.0,"Central Asia",1714259,1710959,3300,1301183,2168638,"UZB",1734911
1,477.0,"Southern Europe",883695,0,883695,675580,1125967,"ITA",900774
1,477.0,"Central America",442557,0,442557,337353,562256,"MEX",449805
1,477.0,"Southern Asia",806802,0,806802,612234,1020391,"IRN",816313
1,477.0,"Western Asia",1620410,0,1620410,1231761,2052936,"IRQ",1642349
1,477.0,"Eastern Asia",1044577,0,1044577,795954,1326591,"JPN",1061273
1,477.0,"Southern Africa",159357,0,159357,120858,201431,"ZAF",161145
1,477.0,"South-Eastern Asia",1397465,0,1397465,1059633,1766055,"IDN",1412844
1,477.0,"Caribbean",160454,0,160454,122337,203895,"CUB",163116
1,478.0,"Pakistan",2029886,2012927,16959,1525824,2543040,"PAK",2034432
1,478.0,"India",7107990,7107867,123,5354195,8923658,"IND",7138927
1,478.0,"Western Europe",3983739,3975935,7804,3048483,5080806,"NLD",4064645
1,478.0,"China",10895267,10031248,864019,7958510,13264183,"CPR",10611347
1,478.0,"United States of America",3132815,3132564,251,2386698,3977830,"USA",3182264
1,478.0,"Northern Africa",1775205,0,1775205,1353072,2255121,"EGY",1804097
1,478.0,"Russian Federation",2480251,2479842,409,1885895,3143158,"RUS",2514527
1,478.0,"Western Africa",559121,0,559121,417438,695730,"NGA",556584
1,478.0,"South America",2343504,1485983,857521,1644215,2740358,"BRA",2192287
1,478.0,"Northern Europe",2156436,1980877,175559,1636416,2727361,"GBR",2181889
1,478.0,"Northern America",712456,711642,814,518751,864586,"CAN",691669
1,478.0,"Oceania",646371,646371,0,491279,818798,"NZL",655039
1,478.0,"Eastern Africa",477786,0,477786,353277,588796,"ETH",471037
1,478.0,"Middle Africa",152534,0,152534,113889,189816,"AGO",151853
1,478.0,"Eastern Europe",3013662,3006607,7055,2298697,3831162,"POL",3064930
1,478.0,"Central Asia",1709449,1706259,3190,1301183,2168638,"UZB",1734911
1,478.0,"Southern Europe",896316,0,896316,675580,1125967,"ITA",900774
1,478.0,"Central America",444826,0,444826,337353,562256,"MEX",449805
1,478.0,"Southern Asia",808964,0,808964,612234,1020391,"IRN",816313
1,478.0,"Western Asia",1617699,0,1617699,1231761,2052936,"IRQ",1642349
1,478.0,"Eastern Asia",1055893,0,1055893,795954,1326591,"JPN",1061273
1,478.0,"Southern Africa",161195,0,161195,120858,201431,"ZAF",161145
1,478.0,"South-Eastern Asia",1396710,0,1396710,1059633,1766055,"IDN",1412844
1,478.0,"Caribbean",161381,0,161381,122337,203895,"CUB",163116
1,479.0,"Pakistan",2031209,2014341,16868,1525824,2543040,"PAK",2034432
1,479.0,"India",7117145,7117145,0,5354195,8923658,"IND",7138927
1,479.0,"Western Europe",4007561,3998971,8590,3048483,5080806,"NLD",4064645
1,479.0,"China",10877134,10064183,812951,7958510,13264183,"CPR",10611347
1,479.0,"United States of America",3167083,3166623,460,2386698,3977830,"USA",3182264
1,479.0,"Northern Africa",1780561,0,1780561,1353072,2255121,"EGY",1804097
1,479.0,"Russian Federation",2475169,2474484,685,1885895,3143158,"RUS",2514527
1,479.0,"Western Africa",547030,0,547030,417438,695730,"NGA",556584
1,479.0,"South America",2271514,1489309,782205,1644215,2740358,"BRA",2192287
1,479.0,"Northern Europe",2162434,1987274,175160,1636416,2727361,"GBR",2181889
1,479.0,"Northern America",669447,668896,551,518751,864586,"CAN",691669
1,479.0,"Oceania",653021,653021,0,491279,818798,"NZL",655039
1,479.0,"Eastern Africa",461974,0,461974,353277,588796,"ETH",471037
1,479.0,"Middle Africa",149214,0,149214,113889,189816,"AGO",151853
1,479.0,"Eastern Europe",3028632,3020915,7717,2298697,3831162,"POL",3064930
1,479.0,"Central Asia",1727843,1724195,3648,1301183,2168638,"UZB",1734911
1,479.0,"Southern Europe",886236,0,886236,675580,1125967,"ITA",900774
1,479.0,"Central America",446752,0,446752,337353,562256,"MEX",449805
1,479.0,"Southern Asia",807230,0,807230,612234,1020391,"IRN",816313
1,479.0,"Western Asia",1621150,0,1621150,1231761,2052936,"IRQ",1642349
1,479.0,"Eastern Asia",1042189,0,1042189,795954,1326591,"JPN",1061273
1,479.0,"Southern Africa",160360,0,160360,120858,201431,"ZAF",161145
1,479.0,"South-Eastern Asia",1408106,0,1408106,1059633,1766055,"IDN",1412844
1,479.0,"Caribbean",161912,0,161912,122337,203895,"CUB",163116
1,480.0,"Pakistan",2032074,2015577,16497,1525824,2543040,"PAK",2034432
1,480.0,"India",7078941,7078941,0,5354195,8923658,"IND",7138927
1,480.0,"Western Europe",4024440,4015774,8666,3048483,5080806,"NLD",4064645
1,480.0,"China",10802861,10022164,780697,7958510,13264183,"CPR",10611347
1,480.0,"United States of America",3097475,3097138,337,2386698,3977830,"USA",3182264
1,480.0,"Northern Africa",1786283,0,1786283,1353072,2255121,"EGY",1804097
1,480.0,"Russian Federation",2502530,2502026,504,1885895,3143158,"RUS",2514527
1,480.0,"Western Africa",559472,0,559472,417438,695730,"NGA",556584
1,480.0,"South America",2272504,1489581,782923,1644215,2740358,"BRA",2192287
1,480.0,"Northern Europe",2168812,1992131,176681,1636416,2727361,"GBR",2181889
1,480.0,"Northern America",721037,720327,710,518751,864586,"CAN",691669
1,480.0,"Oceania",653630,653630,0,491279,818798,"NZL",655039
1,480.0,"Eastern Africa",481539,0,481539,353277,588796,"ETH",471037
1,480.0,"Middle Africa",152595,0,152595,113889,189816,"AGO",151853
1,480.0,"Eastern Europe",3039424,3031263,8161,2298697,3831162,"POL",3064930
1,480.0,"Central Asia",1729960,1727356,2604,1301183,2168638,"UZB",1734911
1,480.0,"Southern Europe",898708,0,898708,675580,1125967,"ITA",900774
1,480.0,"Central America",441151,0,441151,337353,562256,"MEX",449805
1,480.0,"Southern Asia",815141,0,815141,612234,1020391,"IRN",816313
1,480.0,"Western Asia",1629344,0,1629344,1231761,2052936,"IRQ",1642349
1,480.0,"Eastern Asia",1061948,0,1061948,795954,1326591,"JPN",1061273
1,480.0,"Southern Africa",161960,0,161960,120858,201431,"ZAF",161145
1,480.0,"South-Eastern Asia",1411341,0,1411341,1059633,1766055,"IDN",1412844
1,480.0,"Caribbean",159925,0,159925,122337,203895,"CUB",163116
1,481.0,"Pakistan",2032740,2020755,11985,1525824,2543040,"PAK",2034432
1,481.0,"India",7096837,7096609,228,5354195,8923658,"IND",7138927
1,481.0,"Western Europe",4010669,4002974,7695,3048483,5080806,"NLD",4064645
1,481.0,"China",10742907,10029946,712961,7958510,13264183,"CPR",10611347
1,481.0,"United States of America",3236559,3235633,926,2386698,3977830,"USA",3182264
1,481.0,"Northern Africa",1787472,0,1787472,1353072,2255121,"EGY",1804097
1,481.0,"Russian Federation",2506159,2505227,932,1885895,3143158,"RUS",2514527
1,481.0,"Western Africa",556422,0,556422,417438,695730,"NGA",556584
1,481.0,"South America",2227514,1482557,744957,1644215,2740358,"BRA",2192287
1,481.0,"Northern Europe",2160276,1981945,178331,1636416,2727361,"GBR",2181889
1,481.0,"Northern America",679249,678749,500,518751,864586,"CAN",691669
1,481.0,"Oceania",658109,658109,0,491279,818798,"NZL",655039
1,481.0,"Eastern Africa",465556,0,465556,353277,588796,"ETH",471037
1,481.0,"Middle Africa",151803,0,151803,113889,189816,"AGO",151853
1,481.0,"Eastern Europe",3046831,3039144,7687,2298697,3831162,"POL",3064930
1,481.0,"Central Asia",1709822,1706834,2988,1301183,2168638,"UZB",1734911
1,481.0,"Southern Europe",895808,0,895808,675580,1125967,"ITA",900774
1,481.0,"Central America",455967,0,455967,337353,562256,"MEX",449805
1,481.0,"Southern Asia",810946,0,810946,612234,1020391,"IRN",816313
1,481.0,"Western Asia",1631309,0,1631309,1231761,2052936,"IRQ",1642349
1,481.0,"Eastern Asia",1058523,0,1058523,795954,1326591,"JPN",1061273
1,481.0,"Southern Africa",161878,0,161878,120858,201431,"ZAF",161145
1,481.0,"South-Eastern Asia",1418371,0,1418371,1059633,1766055,"IDN",1412844
1,481.0,"Caribbean",165374,0,165374,122337,203895,"CUB",163116
1,482.0,"Pakistan",2020329,2011917,8412,1525824,2543040,"PAK",2034432
1,482.0,"India",7109324,7109169,155,5354195,8923658,"IND",7138927
1,482.0,"Western Europe",4077854,4069114,8740,3048483,5080806,"NLD",4064645
1,482.0,"China",10704538,10006909,697629,7958510,13264183,"CPR",10611347
1,482.0,"United States of America",3144322,3143695,627,2386698,3977830,"USA",3182264
1,482.0,"Northern Africa",1801176,0,1801176,1353072,2255121,"EGY",1804097
1,482.0,"Russian Federation",2524215,2523584,631,1885895,3143158,"RUS",2514527
1,482.0,"Western Africa",550297,0,550297,417438,695730,"NGA",556584
1,482.0,"South America",2234688,1486637,748051,1644215,2740358,"BRA",2192287
1,482.0,"Northern Europe",2165405,1986118,179287,1636416,2727361,"GBR",2181889
1,482.0,"Northern America",679148,678656,492,518751,864586,"CAN",691669
1,482.0,"Oceania",657176,657176,0,491279,818798,"NZL",655039
1,482.0,"Eastern Africa",465745,0,465745,353277,588796,"ETH",471037
1,482.0,"Middle Africa",149726,0,149726,113889,189816,"AGO",151853
1,482.0,"Eastern Europe",3052104,3043621,8483,2298697,3831162,"POL",3064930
1,482.0,"Central Asia",1750433,1746708,3725,1301183,2168638,"UZB",1734911
1,482.0,"Southern Europe",894803,0,894803,675580,1125967,"ITA",900774
1,482.0,"Central America",444338,0,444338,337353,562256,"MEX",449805
1,482.0,"Southern Asia",818381,0,818381,612234,1020391,"IRN",816313
1,482.0,"Western Asia",1637551,0,1637551,1231761,2052936,"IRQ",1642349
1,482.0,"Eastern Asia",1057878,0,1057878,795954,1326591,"JPN",1061273
1,482.0,"Southern Africa",161003,0,161003,120858,201431,"ZAF",161145
1,482.0,"South-Eastern Asia",1416324,0,1416324,1059633,1766055,"IDN",1412844
1,482.0,"Caribbean",161183,0,161183,122337,203895,"CUB",163116
1,483.0,"Pakistan",2024446,2016156,8290,1525824,2543040,"PAK",2034432
1,483.0,"India",7118106,7118002,104,5354195,8923658,"IND",7138927
1,483.0,"Western Europe",4048173,4040915,7258,3048483,5080806,"NLD",4064645
1,483.0,"China",10742601,10056922,685679,7958510,13264183,"CPR",10611347
1,483.0,"United States of America",3231274,3230853,421,2386698,3977830,"USA",3182264
1,483.0,"Northern Africa",1792176,0,1792176,1353072,2255121,"EGY",1804097
1,483.0,"Russian Federation",2490196,2489770,426,1885895,3143158,"RUS",2514527
1,483.0,"Western Africa",553316,0,553316,417438,695730,"NGA",556584
1,483.0,"South America",2221685,1490500,731185,1644215,2740358,"BRA",2192287
1,483.0,"Northern Europe",2170959,1989147,181812,1636416,2727361,"GBR",2181889
1,483.0,"Northern America",670935,670588,347,518751,864586,"CAN",691669
1,483.0,"Oceania",652482,652482,0,491279,818798,"NZL",655039
1,483.0,"Eastern Africa",462019,0,462019,353277,588796,"ETH",471037
1,483.0,"Middle Africa",151047,0,151047,113889,189816,"AGO",151853
1,483.0,"Eastern Europe",3036352,3027878,8474,2298697,3831162,"POL",3064930
1,483.0,"Central Asia",1723749,1720627,3122,1301183,2168638,"UZB",1734911
1,483.0,"Southern Europe",896959,0,896959,675580,1125967,"ITA",900774
1,483.0,"Central America",455073,0,455073,337353,562256,"MEX",449805
1,483.0,"Southern Asia",808506,0,808506,612234,1020391,"IRN",816313
1,483.0,"Western Asia",1626714,0,1626714,1231761,2052936,"IRQ",1642349
1,483.0,"Eastern Asia",1051130,0,1051130,795954,1326591,"JPN",1061273
1,483.0,"Southern Africa",160457,0,160457,120858,201431,"ZAF",161145
1,483.0,"South-Eastern Asia",1406558,0,1406558,1059633,1766055,"IDN",1412844
1,483.0,"Caribbean",165016,0,165016,122337,203895,"CUB",163116
1,484.0,"Pakistan",2027381,2019207,8174,1525824,2543040,"PAK",2034432
1,484.0,"India",7124216,7124216,0,5354195,8923658,"IND",7138927
1,484.0,"Western Europe",4053103,4046264,6839,3048483,5080806,"NLD",4064645
1,484.0,"China",10707470,10040352,667118,7958510,13264183,"CPR",10611347
1,484.0,"United States of America",3122187,3121875,312,2386698,3977830,"USA",3182264
1,484.0,"Northern Africa",1796813,0,1796813,1353072,2255121,"EGY",1804097
1,484.0,"Russian Federation",2497523,2497209,314,1885895,3143158,"RUS",2514527
1,484.0,"Western Africa",564969,0,564969,417438,695730,"NGA",556584
1,484.0,"South America",2213315,1491551,721764,1644215,2740358,"BRA",2192287
1,484.0,"Northern Europe",2174752,1990342,184410,1636416,2727361,"GBR",2181889
1,484.0,"Northern America",726439,725433,1006,518751,864586,"CAN",691669
1,484.0,"Oceania",657306,657306,0,491279,818798,"NZL",655039
1,484.0,"Eastern Africa",483127,0,483127,353277,588796,"ETH",471037
1,484.0,"Middle Africa",153547,0,153547,113889,189816,"AGO",151853
1,484.0,"Eastern Europe",3045000,3035178,9822,2298697,3831162,"POL",3064930
1,484.0,"Central Asia",1726964,1724196,2768,1301183,2168638,"UZB",1734911
1,484.0,"Southern Europe",906401,0,906401,675580,1125967,"ITA",900774
1,484.0,"Central America",444004,0,444004,337353,562256,"MEX",449805
1,484.0,"Southern Asia",814047,0,814047,612234,1020391,"IRN",816313
1,484.0,"Western Asia",1633244,0,1633244,1231761,2052936,"IRQ",1642349
1,484.0,"Eastern Asia",1063908,0,1063908,795954,1326591,"JPN",1061273
1,484.0,"Southern Africa",162516,0,162516,120858,201431,"ZAF",161145
1,484.0,"South-Eastern Asia",1419022,0,1419022,1059633,1766055,"IDN",1412844
1,484.0,"Caribbean",161119,0,161119,122337,203895,"CUB",163116
1,485.0,"Pakistan",2029367,2021266,8101,1525824,2543040,"PAK",2034432
1,485.0,"India",7128662,7128442,220,5354195,8923658,"IND",7138927
1,485.0,"Western Europe",4030665,4024351,6314,3048483,5080806,"NLD",4064645
1,485.0,"China",10675314,10045407,629907,7958510,13264183,"CPR",10611347
1,485.0,"United States of America",3234845,3234028,817,2386698,3977830,"USA",3182264
1,485.0,"Northern Africa",1791149,0,1791149,1353072,2255121,"EGY",1804097
1,485.0,"Russian Federation",2518242,2517429,813,1885895,3143158,"RUS",2514527
1,485.0,"Western Africa",554633,0,554633,417438,695730,"NGA",556584
1,485.0,"South America",2208175,1490204,717971,1644215,2740358,"BRA",2192287
1,485.0,"Northern Europe",2176595,1990425,186170,1636416,2727361,"GBR",2181889
1,485.0,"Northern America",674656,673956,700,518751,864586,"CAN",691669
1,485.0,"Oceania",656615,656615,0,491279,818798,"NZL",655039
1,485.0,"Eastern Africa",464019,0,464019,353277,588796,"ETH",471037
1,485.0,"Middle Africa",151567,0,151567,113889,189816,"AGO",151853
1,485.0,"Eastern Europe",3051745,3040962,10783,2298697,3831162,"POL",3064930
1,485.0,"Central Asia",1729808,1726523,3285,1301183,2168638,"UZB",1734911
1,485.0,"Southern Europe",897575,0,897575,675580,1125967,"ITA",900774
1,485.0,"Central America",455508,0,455508,337353,562256,"MEX",449805
1,485.0,"Southern Asia",814666,0,814666,612234,1020391,"IRN",816313
1,485.0,"Western Asia",1636157,0,1636157,1231761,2052936,"IRQ",1642349
1,485.0,"Eastern Asia",1060392,0,1060392,795954,1326591,"JPN",1061273
1,485.0,"Southern Africa",161120,0,161120,120858,201431,"ZAF",161145
1,485.0,"South-Eastern Asia",1415321,0,1415321,1059633,1766055,"IDN",1412844
1,485.0,"Caribbean",164996,0,164996,122337,203895,"CUB",163116
1,486.0,"Pakistan",2043797,2035850,7947,1525824,2543040,"PAK",2034432
1,486.0,"India",7131708,7131552,156,5354195,8923658,"IND",7138927
1,486.0,"Western Europe",4092352,4084980,7372,3048483,5080806,"NLD",4064645
1,486.0,"China",10658102,10029501,628601,7958510,13264183,"CPR",10611347
1,486.0,"United States of America",3124547,3123966,581,2386698,3977830,"USA",3182264
1,486.0,"Northern Africa",1810303,0,1810303,1353072,2255121,"EGY",1804097
1,486.0,"Russian Federation",2501533,2500950,583,1885895,3143158,"RUS",2514527
1,486.0,"Western Africa",559482,0,559482,417438,695730,"NGA",556584
1,486.0,"South America",2204040,1487239,716801,1644215,2740358,"BRA",2192287
1,486.0,"Northern Europe",2178300,1990052,188248,1636416,2727361,"GBR",2181889
1,486.0,"Northern America",708369,707350,1019,518751,864586,"CAN",691669
1,486.0,"Oceania",660178,660178,0,491279,818798,"NZL",655039
1,486.0,"Eastern Africa",476804,0,476804,353277,588796,"ETH",471037
1,486.0,"Middle Africa",152045,0,152045,113889,189816,"AGO",151853
1,486.0,"Eastern Europe",3075395,3063610,11785,2298697,3831162,"POL",3064930
1,486.0,"Central Asia",1731373,1728013,3360,1301183,2168638,"UZB",1734911
1,486.0,"Southern Europe",905943,0,905943,675580,1125967,"ITA",900774
1,486.0,"Central America",443142,0,443142,337353,562256,"MEX",449805
1,486.0,"Southern Asia",814426,0,814426,612234,1020391,"IRN",816313
1,486.0,"Western Asia",1647532,0,1647532,1231761,2052936,"IRQ",1642349
1,486.0,"Eastern Asia",1059146,0,1059146,795954,1326591,"JPN",1061273
1,486.0,"Southern Africa",162166,0,162166,120858,201431,"ZAF",161145
1,486.0,"South-Eastern Asia",1424293,0,1424293,1059633,1766055,"IDN",1412844
1,486.0,"Caribbean",160814,0,160814,122337,203895,"CUB",163116
1,487.0,"Pakistan",2015132,2009376,5756,1525824,2543040,"PAK",2034432
1,487.0,"India",7133847,7133744,103,5354195,8923658,"IND",7138927
1,487.0,"Western Europe",4058245,4051599,6646,3048483,5080806,"NLD",4064645
1,487.0,"China",10640782,10036488,604294,7958510,13264183,"CPR",10611347
1,487.0,"United States of America",3236496,3235646,850,2386698,3977830,"USA",3182264
1,487.0,"Northern Africa",1797057,0,1797057,1353072,2255121,"EGY",1804097
1,487.0,"Russian Federation",2521045,2520193,852,1885895,3143158,"RUS",2514527
1,487.0,"Western Africa",553408,0,553408,417438,695730,"NGA",556584
1,487.0,"South America",2205363,1485050,720313,1644215,2740358,"BRA",2192287
1,487.0,"Northern Europe",2179550,1989135,190415,1636416,2727361,"GBR",2181889
1,487.0,"Northern America",670727,670013,714,518751,864586,"CAN",691669
1,487.0,"Oceania",658609,658609,0,491279,818798,"NZL",655039
1,487.0,"Eastern Africa",462829,0,462829,353277,588796,"ETH",471037
1,487.0,"Middle Africa",151242,0,151242,113889,189816,"AGO",151853
1,487.0,"Eastern Europe",3052493,3041628,10865,2298697,3831162,"POL",3064930
1,487.0,"Central Asia",1732540,1729047,3493,1301183,2168638,"UZB",1734911
1,487.0,"Southern Europe",898791,0,898791,675580,1125967,"ITA",900774
1,487.0,"Central America",455824,0,455824,337353,562256,"MEX",449805
1,487.0,"Southern Asia",814034,0,814034,612234,1020391,"IRN",816313
1,487.0,"Western Asia",1637259,0,1637259,1231761,2052936,"IRQ",1642349
1,487.0,"Eastern Asia",1060253,0,1060253,795954,1326591,"JPN",1061273
1,487.0,"Southern Africa",161090,0,161090,120858,201431,"ZAF",161145
1,487.0,"South-Eastern Asia",1418689,0,1418689,1059633,1766055,"IDN",1412844
1,487.0,"Caribbean",165011,0,165011,122337,203895,"CUB",163116
1,488.0,"Pakistan",2020763,2014891,5872,1525824,2543040,"PAK",2034432
1,488.0,"India",7135281,7135281,0,5354195,8923658,"IND",7138927
1,488.0,"Western Europe",4060271,4053483,6788,3048483,5080806,"NLD",4064645
1,488.0,"China",10634790,10028629,606161,7958510,13264183,"CPR",10611347
1,488.0,"United States of America",3144320,3143704,616,2386698,3977830,"USA",3182264
1,488.0,"Northern Africa",1806246,0,1806246,1353072,2255121,"EGY",1804097
1,488.0,"Russian Federation",2503489,2502871,618,1885895,3143158,"RUS",2514527
1,488.0,"Western Africa",562587,0,562587,417438,695730,"NGA",556584
1,488.0,"South America",2205628,1482615,723013,1644215,2740358,"BRA",2192287
1,488.0,"Northern Europe",2180624,1987820,192804,1636416,2727361,"GBR",2181889
1,488.0,"Northern America",713819,712612,1207,518751,864586,"CAN",691669
1,488.0,"Oceania",657515,657515,0,491279,818798,"NZL",655039
1,488.0,"Eastern Africa",478718,0,478718,353277,588796,"ETH",471037
1,488.0,"Middle Africa",153050,0,153050,113889,189816,"AGO",151853
1,488.0,"Eastern Europe",3076082,3063767,12315,2298697,3831162,"POL",3064930
1,488.0,"Central Asia",1733249,1729741,3508,1301183,2168638,"UZB",1734911
1,488.0,"Southern Europe",906332,0,906332,675580,1125967,"ITA",900774
1,488.0,"Central America",446313,0,446313,337353,562256,"MEX",449805
1,488.0,"Southern Asia",814221,0,814221,612234,1020391,"IRN",816313
1,488.0,"Western Asia",1647708,0,1647708,1231761,2052936,"IRQ",1642349
1,488.0,"Eastern Asia",1062395,0,1062395,795954,1326591,"JPN",1061273
1,488.0,"Southern Africa",162187,0,162187,120858,201431,"ZAF",161145
1,488.0,"South-Eastern Asia",1419265,0,1419265,1059633,1766055,"IDN",1412844
1,488.0,"Caribbean",161901,0,161901,122337,203895,"CUB",163116
1,489.0,"Pakistan",2037738,2031349,6389,1525824,2543040,"PAK",2034432
1,489.0,"India",7136364,7136364,0,5354195,8923658,"IND",7138927
1,489.0,"Western Europe",4062084,4054772,7312,3048483,5080806,"NLD",4064645
1,489.0,"China",10624612,10022374,602238,7958510,13264183,"CPR",10611347
1,489.0,"United States of America",3231229,3230356,873,2386698,3977830,"USA",3182264
1,489.0,"Northern Africa",1797845,0,1797845,1353072,2255121,"EGY",1804097
1,489.0,"Russian Federation",2506778,2505832,946,1885895,3143158,"RUS",2514527
1,489.0,"Western Africa",551288,0,551288,417438,695730,"NGA",556584
1,489.0,"South America",2216657,1490611,726046,1644215,2740358,"BRA",2192287
1,489.0,"Northern Europe",2180605,1986189,194416,1636416,2727361,"GBR",2181889
1,489.0,"Northern America",666329,665492,837,518751,864586,"CAN",691669
1,489.0,"Oceania",656756,656756,0,491279,818798,"NZL",655039
1,489.0,"Eastern Africa",461239,0,461239,353277,588796,"ETH",471037
1,489.0,"Middle Africa",150691,0,150691,113889,189816,"AGO",151853
1,489.0,"Eastern Europe",3052912,3040934,11978,2298697,3831162,"POL",3064930
1,489.0,"Central Asia",1733983,1730226,3757,1301183,2168638,"UZB",1734911
1,489.0,"Southern Europe",896158,0,896158,675580,1125967,"ITA",900774
1,489.0,"Central America",454488,0,454488,337353,562256,"MEX",449805
1,489.0,"Southern Asia",813173,0,813173,612234,1020391,"IRN",816313
1,489.0,"Western Asia",1636723,0,1636723,1231761,2052936,"IRQ",1642349
1,489.0,"Eastern Asia",1055473,0,1055473,795954,1326591,"JPN",1061273
1,489.0,"Southern Africa",160624,0,160624,120858,201431,"ZAF",161145
1,489.0,"South-Eastern Asia",1414654,0,1414654,1059633,1766055,"IDN",1412844
1,489.0,"Caribbean",164674,0,164674,122337,203895,"CUB",163116
1,490.0,"Pakistan",2036761,2030562,6199,1525824,2543040,"PAK",2034432
1,490.0,"India",7092046,7092046,0,5354195,8923658,"IND",7138927
1,490.0,"Western Europe",4062962,4056109,6853,3048483,5080806,"NLD",4064645
1,490.0,"China",10625698,10017364,608334,7958510,13264183,"CPR",10611347
1,490.0,"United States of America",3122203,3121550,653,2386698,3977830,"USA",3182264
1,490.0,"Northern Africa",1801729,0,1801729,1353072,2255121,"EGY",1804097
1,490.0,"Russian Federation",2509157,2508446,711,1885895,3143158,"RUS",2514527
1,490.0,"Western Africa",566235,0,566235,417438,695730,"NGA",556584
1,490.0,"South America",2210896,1490581,720315,1644215,2740358,"BRA",2192287
1,490.0,"Northern Europe",2182248,1984633,197615,1636416,2727361,"GBR",2181889
1,490.0,"Northern America",731121,729629,1492,518751,864586,"CAN",691669
1,490.0,"Oceania",656234,656234,0,491279,818798,"NZL",655039
1,490.0,"Eastern Africa",483410,0,483410,353277,588796,"ETH",471037
1,490.0,"Middle Africa",154098,0,154098,113889,189816,"AGO",151853
1,490.0,"Eastern Europe",3057018,3043423,13595,2298697,3831162,"POL",3064930
1,490.0,"Central Asia",1745376,1742038,3338,1301183,2168638,"UZB",1734911
1,490.0,"Southern Europe",909956,0,909956,675580,1125967,"ITA",900774
1,490.0,"Central America",443985,0,443985,337353,562256,"MEX",449805
1,490.0,"Southern Asia",816850,0,816850,612234,1020391,"IRN",816313
1,490.0,"Western Asia",1640657,0,1640657,1231761,2052936,"IRQ",1642349
1,490.0,"Eastern Asia",1066375,0,1066375,795954,1326591,"JPN",1061273
1,490.0,"Southern Africa",162610,0,162610,120858,201431,"ZAF",161145
1,490.0,"South-Eastern Asia",1417258,0,1417258,1059633,1766055,"IDN",1412844
1,490.0,"Caribbean",161276,0,161276,122337,203895,"CUB",163116
1,491.0,"Pakistan",2036113,2031083,5030,1525824,2543040,"PAK",2034432
1,491.0,"India",7151137,7150690,447,5354195,8923658,"IND",7138927
1,491.0,"Western Europe",4063367,4056824,6543,3048483,5080806,"NLD",4064645
1,491.0,"China",10617414,10025177,592237,7958510,13264183,"CPR",10611347
1,491.0,"United States of America",3216073,3214770,1303,2386698,3977830,"USA",3182264
1,491.0,"Northern Africa",1799414,0,1799414,1353072,2255121,"EGY",1804097
1,491.0,"Russian Federation",2510772,2509422,1350,1885895,3143158,"RUS",2514527
1,491.0,"Western Africa",556294,0,556294,417438,695730,"NGA",556584
1,491.0,"South America",2211647,1487098,724549,1644215,2740358,"BRA",2192287
1,491.0,"Northern Europe",2182039,1982462,199577,1636416,2727361,"GBR",2181889
1,491.0,"Northern America",681953,680922,1031,518751,864586,"CAN",691669
1,491.0,"Oceania",659885,659885,0,491279,818798,"NZL",655039
1,491.0,"Eastern Africa",467788,0,467788,353277,588796,"ETH",471037
1,491.0,"Middle Africa",151928,0,151928,113889,189816,"AGO",151853
1,491.0,"Eastern Europe",3060299,3045714,14585,2298697,3831162,"POL",3064930
1,491.0,"Central Asia",1720181,1716935,3246,1301183,2168638,"UZB",1734911
1,491.0,"Southern Europe",901316,0,901316,675580,1125967,"ITA",900774
1,491.0,"Central America",453811,0,453811,337353,562256,"MEX",449805
1,491.0,"Southern Asia",813910,0,813910,612234,1020391,"IRN",816313
1,491.0,"Western Asia",1639943,0,1639943,1231761,2052936,"IRQ",1642349
1,491.0,"Eastern Asia",1060816,0,1060816,795954,1326591,"JPN",1061273
1,491.0,"Southern Africa",161784,0,161784,120858,201431,"ZAF",161145
1,491.0,"South-Eastern Asia",1422427,0,1422427,1059633,1766055,"IDN",1412844
1,491.0,"Caribbean",164519,0,164519,122337,203895,"CUB",163116
1,492.0,"Pakistan",2035566,2030871,4695,1525824,2543040,"PAK",2034432
1,492.0,"India",7147488,7147197,291,5354195,8923658,"IND",7138927
1,492.0,"Western Europe",4063594,4056458,7136,3048483,5080806,"NLD",4064645
1,492.0,"China",10613497,10023556,589941,7958510,13264183,"CPR",10611347
1,492.0,"United States of America",3186474,3185632,842,2386698,3977830,"USA",3182264
1,492.0,"Northern Africa",1802330,0,1802330,1353072,2255121,"EGY",1804097
1,492.0,"Russian Federation",2527497,2526209,1288,1885895,3143158,"RUS",2514527
1,492.0,"Western Africa",542152,0,542152,417438,695730,"NGA",556584
1,492.0,"South America",2202886,1484302,718584,1644215,2740358,"BRA",2192287
1,492.0,"Northern Europe",2192410,1993255,199155,1636416,2727361,"GBR",2181889
1,492.0,"Northern America",652902,652203,699,518751,864586,"CAN",691669
1,492.0,"Oceania",654386,654386,0,491279,818798,"NZL",655039
1,492.0,"Eastern Africa",456702,0,456702,353277,588796,"ETH",471037
1,492.0,"Middle Africa",148394,0,148394,113889,189816,"AGO",151853
1,492.0,"Eastern Europe",3080885,3065476,15409,2298697,3831162,"POL",3064930
1,492.0,"Central Asia",1768729,1765328,3401,1301183,2168638,"UZB",1734911
1,492.0,"Southern Europe",886772,0,886772,675580,1125967,"ITA",900774
1,492.0,"Central America",448247,0,448247,337353,562256,"MEX",449805
1,492.0,"Southern Asia",818572,0,818572,612234,1020391,"IRN",816313
1,492.0,"Western Asia",1648930,0,1648930,1231761,2052936,"IRQ",1642349
1,492.0,"Eastern Asia",1053592,0,1053592,795954,1326591,"JPN",1061273
1,492.0,"Southern Africa",159131,0,159131,120858,201431,"ZAF",161145
1,492.0,"South-Eastern Asia",1409312,0,1409312,1059633,1766055,"IDN",1412844
1,492.0,"Caribbean",162522,0,162522,122337,203895,"CUB",163116
1,493.0,"Pakistan",2035253,2030721,4532,1525824,2543040,"PAK",2034432
1,493.0,"India",7144965,7144746,219,5354195,8923658,"IND",7138927
1,493.0,"Western Europe",4064055,4057633,6422,3048483,5080806,"NLD",4064645
1,493.0,"China",10614257,10044315,569942,7958510,13264183,"CPR",10611347
1,493.0,"United States of America",3147795,3147165,630,2386698,3977830,"USA",3182264
1,493.0,"Northern Africa",1804669,0,1804669,1353072,2255121,"EGY",1804097
1,493.0,"Russian Federation",2523635,2522675,960,1885895,3143158,"RUS",2514527
1,493.0,"Western Africa",562066,0,562066,417438,695730,"NGA",556584
1,493.0,"South America",2214518,1487522,726996,1644215,2740358,"BRA",2192287
1,493.0,"Northern Europe",2177016,1989164,187852,1636416,2727361,"GBR",2181889
1,493.0,"Northern America",713735,712186,1549,518751,864586,"CAN",691669
1,493.0,"Oceania",654587,654587,0,491279,818798,"NZL",655039
1,493.0,"Eastern Africa",478562,0,478562,353277,588796,"ETH",471037
1,493.0,"Middle Africa",152915,0,152915,113889,189816,"AGO",151853
1,493.0,"Eastern Europe",3076534,3063159,13375,2298697,3831162,"POL",3064930
1,493.0,"Central Asia",1725550,1723188,2362,1301183,2168638,"UZB",1734911
1,493.0,"Southern Europe",907968,0,907968,675580,1125967,"ITA",900774
1,493.0,"Central America",446731,0,446731,337353,562256,"MEX",449805
1,493.0,"Southern Asia",820811,0,820811,612234,1020391,"IRN",816313
1,493.0,"Western Asia",1650519,0,1650519,1231761,2052936,"IRQ",1642349
1,493.0,"Eastern Asia",1067927,0,1067927,795954,1326591,"JPN",1061273
1,493.0,"Southern Africa",161537,0,161537,120858,201431,"ZAF",161145
1,493.0,"South-Eastern Asia",1413986,0,1413986,1059633,1766055,"IDN",1412844
1,493.0,"Caribbean",162028,0,162028,122337,203895,"CUB",163116
1,494.0,"Pakistan",2035009,2030484,4525,1525824,2543040,"PAK",2034432
1,494.0,"India",7143156,7143015,141,5354195,8923658,"IND",7138927
1,494.0,"Western Europe",4064759,4057803,6956,3048483,5080806,"NLD",4064645
1,494.0,"China",10611060,10043536,567524,7958510,13264183,"CPR",10611347
1,494.0,"United States of America",3214923,3214094,829,2386698,3977830,"USA",3182264
1,494.0,"Northern Africa",1800201,0,1800201,1353072,2255121,"EGY",1804097
1,494.0,"Russian Federation",2505232,2504091,1141,1885895,3143158,"RUS",2514527
1,494.0,"Western Africa",554702,0,554702,417438,695730,"NGA",556584
1,494.0,"South America",2208454,1483344,725110,1644215,2740358,"BRA",2192287
1,494.0,"Northern Europe",2178838,1988553,190285,1636416,2727361,"GBR",2181889
1,494.0,"Northern America",678237,677171,1066,518751,864586,"CAN",691669
1,494.0,"Oceania",654724,654724,0,491279,818798,"NZL",655039
1,494.0,"Eastern Africa",466353,0,466353,353277,588796,"ETH",471037
1,494.0,"Middle Africa",151588,0,151588,113889,189816,"AGO",151853
1,494.0,"Eastern Europe",3053393,3040197,13196,2298697,3831162,"POL",3064930
1,494.0,"Central Asia",1761375,1758577,2798,1301183,2168638,"UZB",1734911
1,494.0,"Southern Europe",899734,0,899734,675580,1125967,"ITA",900774
1,494.0,"Central America",453132,0,453132,337353,562256,"MEX",449805
1,494.0,"Southern Asia",816750,0,816750,612234,1020391,"IRN",816313
1,494.0,"Western Asia",1637299,0,1637299,1231761,2052936,"IRQ",1642349
1,494.0,"Eastern Asia",1058080,0,1058080,795954,1326591,"JPN",1061273
1,494.0,"Southern Africa",160667,0,160667,120858,201431,"ZAF",161145
1,494.0,"South-Eastern Asia",1411572,0,1411572,1059633,1766055,"IDN",1412844
1,494.0,"Caribbean",164248,0,164248,122337,203895,"CUB",163116
1,495.0,"Pakistan",2034831,2030487,4344,1525824,2543040,"PAK",2034432
1,495.0,"India",7141804,7141804,0,5354195,8923658,"IND",7138927
1,495.0,"Western Europe",4090555,4083024,7531,3048483,5080806,"NLD",4064645
1,495.0,"China",10612832,10041239,571593,7958510,13264183,"CPR",10611347
1,495.0,"United States of America",3148349,3147773,576,2386698,3977830,"USA",3182264
1,495.0,"Northern Africa",1814736,0,1814736,1353072,2255121,"EGY",1804097
1,495.0,"Russian Federation",2539303,2538504,799,1885895,3143158,"RUS",2514527
1,495.0,"Western Africa",555460,0,555460,417438,695730,"NGA",556584
1,495.0,"South America",2220811,1490642,730169,1644215,2740358,"BRA",2192287
1,495.0,"Northern Europe",2179297,1987479,191818,1636416,2727361,"GBR",2181889
1,495.0,"Northern America",694640,693419,1221,518751,864586,"CAN",691669
1,495.0,"Oceania",654819,654819,0,491279,818798,"NZL",655039
1,495.0,"Eastern Africa",470735,0,470735,353277,588796,"ETH",471037
1,495.0,"Middle Africa",151265,0,151265,113889,189816,"AGO",151853
1,495.0,"Eastern Europe",3096048,3081736,14312,2298697,3831162,"POL",3064930
1,495.0,"Central Asia",1698512,1696554,1958,1301183,2168638,"UZB",1734911
1,495.0,"Southern Europe",902657,0,902657,675580,1125967,"ITA",900774
1,495.0,"Central America",445634,0,445634,337353,562256,"MEX",449805
1,495.0,"Southern Asia",817395,0,817395,612234,1020391,"IRN",816313
1,495.0,"Western Asia",1655841,0,1655841,1231761,2052936,"IRQ",1642349
1,495.0,"Eastern Asia",1066694,0,1066694,795954,1326591,"JPN",1061273
1,495.0,"Southern Africa",160896,0,160896,120858,201431,"ZAF",161145
1,495.0,"South-Eastern Asia",1412809,0,1412809,1059633,1766055,"IDN",1412844
1,495.0,"Caribbean",161661,0,161661,122337,203895,"CUB",163116
1,496.0,"Pakistan",2034697,2030494,4203,1525824,2543040,"PAK",2034432
1,496.0,"India",7140950,7140950,0,5354195,8923658,"IND",7138927
1,496.0,"Western Europe",4056951,4050562,6389,3048483,5080806,"NLD",4064645
1,496.0,"China",10610090,10049836,560254,7958510,13264183,"CPR",10611347
1,496.0,"United States of America",3215323,3214946,377,2386698,3977830,"USA",3182264
1,496.0,"Northern Africa",1801535,0,1801535,1353072,2255121,"EGY",1804097
1,496.0,"Russian Federation",2516135,2515617,518,1885895,3143158,"RUS",2514527
1,496.0,"Western Africa",549708,0,549708,417438,695730,"NGA",556584
1,496.0,"South America",2211432,1489381,722051,1644215,2740358,"BRA",2192287
1,496.0,"Northern Europe",2179975,1986373,193602,1636416,2727361,"GBR",2181889
1,496.0,"Northern America",665241,664389,852,518751,864586,"CAN",691669
1,496.0,"Oceania",654887,654887,0,491279,818798,"NZL",655039
1,496.0,"Eastern Africa",461527,0,461527,353277,588796,"ETH",471037
1,496.0,"Middle Africa",150324,0,150324,113889,189816,"AGO",151853
1,496.0,"Eastern Europe",3086518,3074059,12459,2298697,3831162,"POL",3064930
1,496.0,"Central Asia",1764469,1761393,3076,1301183,2168638,"UZB",1734911
1,496.0,"Southern Europe",892570,0,892570,675580,1125967,"ITA",900774
1,496.0,"Central America",452957,0,452957,337353,562256,"MEX",449805
1,496.0,"Southern Asia",816620,0,816620,612234,1020391,"IRN",816313
1,496.0,"Western Asia",1650475,0,1650475,1231761,2052936,"IRQ",1642349
1,496.0,"Eastern Asia",1055970,0,1055970,795954,1326591,"JPN",1061273
1,496.0,"Southern Africa",160060,0,160060,120858,201431,"ZAF",161145
1,496.0,"South-Eastern Asia",1410753,0,1410753,1059633,1766055,"IDN",1412844
1,496.0,"Caribbean",164119,0,164119,122337,203895,"CUB",163116
1,497.0,"Pakistan",2034629,2030495,4134,1525824,2543040,"PAK",2034432
1,497.0,"India",7140450,7140349,101,5354195,8923658,"IND",7138927
1,497.0,"Western Europe",4059362,4053436,5926,3048483,5080806,"NLD",4064645
1,497.0,"China",10611435,10064505,546930,7958510,13264183,"CPR",10611347
1,497.0,"United States of America",3148624,3148343,281,2386698,3977830,"USA",3182264
1,497.0,"Northern Africa",1802148,0,1802148,1353072,2255121,"EGY",1804097
1,497.0,"Russian Federation",2515678,2515287,391,1885895,3143158,"RUS",2514527
1,497.0,"Western Africa",566783,0,566783,417438,695730,"NGA",556584
1,497.0,"South America",2209117,1485760,723357,1644215,2740358,"BRA",2192287
1,497.0,"Northern Europe",2181628,1985265,196363,1636416,2727361,"GBR",2181889
1,497.0,"Northern America",726792,725105,1687,518751,864586,"CAN",691669
1,497.0,"Oceania",658944,658944,0,491279,818798,"NZL",655039
1,497.0,"Eastern Africa",481996,0,481996,353277,588796,"ETH",471037
1,497.0,"Middle Africa",154087,0,154087,113889,189816,"AGO",151853
1,497.0,"Eastern Europe",3060910,3050352,10558,2298697,3831162,"POL",3064930
1,497.0,"Central Asia",1722580,1720480,2100,1301183,2168638,"UZB",1734911
1,497.0,"Southern Europe",913401,0,913401,675580,1125967,"ITA",900774
1,497.0,"Central America",447120,0,447120,337353,562256,"MEX",449805
1,497.0,"Southern Asia",818877,0,818877,612234,1020391,"IRN",816313
1,497.0,"Western Asia",1641189,0,1641189,1231761,2052936,"IRQ",1642349
1,497.0,"Eastern Asia",1069464,0,1069464,795954,1326591,"JPN",1061273
1,497.0,"Southern Africa",162960,0,162960,120858,201431,"ZAF",161145
1,497.0,"South-Eastern Asia",1423119,0,1423119,1059633,1766055,"IDN",1412844
1,497.0,"Caribbean",162338,0,162338,122337,203895,"CUB",163116
1,498.0,"Pakistan",2034580,2030438,4142,1525824,2543040,"PAK",2034432
1,498.0,"India",7140001,7139829,172,5354195,8923658,"IND",7138927
1,498.0,"Western Europe",4061630,4054992,6638,3048483,5080806,"NLD",4064645
1,498.0,"China",10609577,10064483,545094,7958510,13264183,"CPR",10611347
1,498.0,"United States of America",3234287,3233640,647,2386698,3977830,"USA",3182264
1,498.0,"Northern Africa",1798647,0,1798647,1353072,2255121,"EGY",1804097
1,498.0,"Russian Federation",2499743,2498996,747,1885895,3143158,"RUS",2514527
1,498.0,"Western Africa",559924,0,559924,417438,695730,"NGA",556584
1,498.0,"South America",2218200,1492849,725351,1644215,2740358,"BRA",2192287
1,498.0,"Northern Europe",2182682,1983306,199376,1636416,2727361,"GBR",2181889
1,498.0,"Northern America",686897,685735,1162,518751,864586,"CAN",691669
1,498.0,"Oceania",657741,657741,0,491279,818798,"NZL",655039
1,498.0,"Eastern Africa",469669,0,469669,353277,588796,"ETH",471037
1,498.0,"Middle Africa",152936,0,152936,113889,189816,"AGO",151853
1,498.0,"Eastern Europe",3042455,3032007,10448,2298697,3831162,"POL",3064930
1,498.0,"Central Asia",1759266,1756627,2639,1301183,2168638,"UZB",1734911
1,498.0,"Southern Europe",904575,0,904575,675580,1125967,"ITA",900774
1,498.0,"Central America",456300,0,456300,337353,562256,"MEX",449805
1,498.0,"Southern Asia",815641,0,815641,612234,1020391,"IRN",816313
1,498.0,"Western Asia",1631792,0,1631792,1231761,2052936,"IRQ",1642349
1,498.0,"Eastern Asia",1060391,0,1060391,795954,1326591,"JPN",1061273
1,498.0,"Southern Africa",161858,0,161858,120858,201431,"ZAF",161145
1,498.0,"South-Eastern Asia",1417894,0,1417894,1059633,1766055,"IDN",1412844
1,498.0,"Caribbean",165359,0,165359,122337,203895,"CUB",163116
1,499.0,"Pakistan",2034523,2030538,3985,1525824,2543040,"PAK",2034432
1,499.0,"India",7139674,7139558,116,5354195,8923658,"IND",7138927
1,499.0,"Western Europe",4088283,4080826,7457,3048483,5080806,"NLD",4064645
1,499.0,"China",10613879,10062085,551794,7958510,13264183,"CPR",10611347
1,499.0,"United States of America",3142812,3142375,437,2386698,3977830,"USA",3182264
1,499.0,"Northern Africa",1811377,0,1811377,1353072,2255121,"EGY",1804097
1,499.0,"Russian Federation",2566638,2566126,512,1885895,3143158,"RUS",2514527
1,499.0,"Western Africa",552490,0,552490,417438,695730,"NGA",556584
1,499.0,"South America",2151445,1488772,662673,1644215,2740358,"BRA",2192287
1,499.0,"Northern Europe",2180866,1980930,199936,1636416,2727361,"GBR",2181889
1,499.0,"Northern America",688386,687247,1139,518751,864586,"CAN",691669
1,499.0,"Oceania",656910,656910,0,491279,818798,"NZL",655039
1,499.0,"Eastern Africa",469795,0,469795,353277,588796,"ETH",471037
1,499.0,"Middle Africa",150543,0,150543,113889,189816,"AGO",151853
1,499.0,"Eastern Europe",3088119,3076363,11756,2298697,3831162,"POL",3064930
1,499.0,"Central Asia",1730012,1728180,1832,1301183,2168638,"UZB",1734911
1,499.0,"Southern Europe",899307,0,899307,675580,1125967,"ITA",900774
1,499.0,"Central America",444605,0,444605,337353,562256,"MEX",449805
1,499.0,"Southern Asia",826017,0,826017,612234,1020391,"IRN",816313
1,499.0,"Western Asia",1654356,0,1654356,1231761,2052936,"IRQ",1642349
1,499.0,"Eastern Asia",1070535,0,1070535,795954,1326591,"JPN",1061273
1,499.0,"Southern Africa",160991,0,160991,120858,201431,"ZAF",161145
1,499.0,"South-Eastern Asia",1416288,0,1416288,1059633,1766055,"IDN",1412844
1,499.0,"Caribbean",161255,0,161255,122337,203895,"CUB",163116
1,500.0,"Pakistan",2034580,2030512,4068,1525824,2543040,"PAK",2034432
1,500.0,"India",7139375,7139375,0,5354195,8923658,"IND",7138927
1,500.0,"Western Europe",4081174,4074824,6350,3048483,5080806,"NLD",4064645
1,500.0,"China",10610512,10061404,549108,7958510,13264183,"CPR",10611347
1,500.0,"United States of America",3230227,3229932,295,2386698,3977830,"USA",3182264
1,500.0,"Northern Africa",1804325,0,1804325,1353072,2255121,"EGY",1804097
1,500.0,"Russian Federation",2519533,2519195,338,1885895,3143158,"RUS",2514527
1,500.0,"Western Africa",554345,0,554345,417438,695730,"NGA",556584
1,500.0,"South America",2166161,1488758,677403,1644215,2740358,"BRA",2192287
1,500.0,"Northern Europe",2195704,1992157,203547,1636416,2727361,"GBR",2181889
1,500.0,"Northern America",673178,672379,799,518751,864586,"CAN",691669
1,500.0,"Oceania",656334,656334,0,491279,818798,"NZL",655039
1,500.0,"Eastern Africa",464771,0,464771,353277,588796,"ETH",471037
1,500.0,"Middle Africa",151464,0,151464,113889,189816,"AGO",151853
1,500.0,"Eastern Europe",3061681,3051056,10625,2298697,3831162,"POL",3064930
1,500.0,"Central Asia",1742340,1740584,1756,1301183,2168638,"UZB",1734911
1,500.0,"Southern Europe",898937,0,898937,675580,1125967,"ITA",900774
1,500.0,"Central America",454929,0,454929,337353,562256,"MEX",449805
1,500.0,"Southern Asia",816759,0,816759,612234,1020391,"IRN",816313
1,500.0,"Western Asia",1640320,0,1640320,1231761,2052936,"IRQ",1642349
1,500.0,"Eastern Asia",1060143,0,1060143,795954,1326591,"JPN",1061273
1,500.0,"Southern Africa",160858,0,160858,120858,201431,"ZAF",161145
1,500.0,"South-Eastern Asia",1414079,0,1414079,1059633,1766055,"IDN",1412844
1,500.0,"Caribbean",164972,0,164972,122337,203895,"CUB",163116
1,501.0,"Pakistan",2034545,2030536,4009,1525824,2543040,"PAK",2034432
1,501.0,"India",7139239,7139239,0,5354195,8923658,"IND",7138927
1,501.0,"Western Europe",4076387,4070538,5849,3048483,5080806,"NLD",4064645
1,501.0,"China",10612173,10058857,553316,7958510,13264183,"CPR",10611347
1,501.0,"United States of America",3140142,3139923,219,2386698,3977830,"USA",3182264
1,501.0,"Northern Africa",1810322,0,1810322,1353072,2255121,"EGY",1804097
1,501.0,"Russian Federation",2502517,2502266,251,1885895,3143158,"RUS",2514527
1,501.0,"Western Africa",567528,0,567528,417438,695730,"NGA",556584
1,501.0,"South America",2176763,1485842,690921,1644215,2740358,"BRA",2192287
1,501.0,"Northern Europe",2192318,1986919,205399,1636416,2727361,"GBR",2181889
1,501.0,"Northern America",732167,730709,1458,518751,864586,"CAN",691669
1,501.0,"Oceania",655937,655937,0,491279,818798,"NZL",655039
1,501.0,"Eastern Africa",483720,0,483720,353277,588796,"ETH",471037
1,501.0,"Middle Africa",154308,0,154308,113889,189816,"AGO",151853
1,501.0,"Eastern Europe",3082537,3071530,11007,2298697,3831162,"POL",3064930
1,501.0,"Central Asia",1718195,1716610,1585,1301183,2168638,"UZB",1734911
1,501.0,"Southern Europe",917222,0,917222,675580,1125967,"ITA",900774
1,501.0,"Central America",446770,0,446770,337353,562256,"MEX",449805
1,501.0,"Southern Asia",816670,0,816670,612234,1020391,"IRN",816313
1,501.0,"Western Asia",1649856,0,1649856,1231761,2052936,"IRQ",1642349
1,501.0,"Eastern Asia",1065751,0,1065751,795954,1326591,"JPN",1061273
1,501.0,"Southern Africa",162386,0,162386,120858,201431,"ZAF",161145
1,501.0,"South-Eastern Asia",1417575,0,1417575,1059633,1766055,"IDN",1412844
1,501.0,"Caribbean",162051,0,162051,122337,203895,"CUB",163116
1,502.0,"Pakistan",2034530,2030503,4027,1525824,2543040,"PAK",2034432
1,502.0,"India",7139244,7138938,306,5354195,8923658,"IND",7138927
1,502.0,"Western Europe",4072814,4067225,5589,3048483,5080806,"NLD",4064645
1,502.0,"China",10609452,10058635,550817,7958510,13264183,"CPR",10611347
1,502.0,"United States of America",3228335,3227604,731,2386698,3977830,"USA",3182264
1,502.0,"Northern Africa",1803598,0,1803598,1353072,2255121,"EGY",1804097
1,502.0,"Russian Federation",2490630,2489868,762,1885895,3143158,"RUS",2514527
1,502.0,"Western Africa",557768,0,557768,417438,695730,"NGA",556584
1,502.0,"South America",2192669,1491306,701363,1644215,2740358,"BRA",2192287
1,502.0,"Northern Europe",2189804,1982278,207526,1636416,2727361,"GBR",2181889
1,502.0,"Northern America",682470,681468,1002,518751,864586,"CAN",691669
1,502.0,"Oceania",655661,655661,0,491279,818798,"NZL",655039
1,502.0,"Eastern Africa",468071,0,468071,353277,588796,"ETH",471037
1,502.0,"Middle Africa",152354,0,152354,113889,189816,"AGO",151853
1,502.0,"Eastern Europe",3057582,3047209,10373,2298697,3831162,"POL",3064930
1,502.0,"Central Asia",1756136,1753787,2349,1301183,2168638,"UZB",1734911
1,502.0,"Southern Europe",902607,0,902607,675580,1125967,"ITA",900774
1,502.0,"Central America",455081,0,455081,337353,562256,"MEX",449805
1,502.0,"Southern Asia",812969,0,812969,612234,1020391,"IRN",816313
1,502.0,"Western Asia",1638850,0,1638850,1231761,2052936,"IRQ",1642349
1,502.0,"Eastern Asia",1056103,0,1056103,795954,1326591,"JPN",1061273
1,502.0,"Southern Africa",161305,0,161305,120858,201431,"ZAF",161145
1,502.0,"South-Eastern Asia",1413441,0,1413441,1059633,1766055,"IDN",1412844
1,502.0,"Caribbean",164981,0,164981,122337,203895,"CUB",163116
1,503.0,"Pakistan",2034487,2030717,3770,1525824,2543040,"PAK",2034432
1,503.0,"India",7139143,7138936,207,5354195,8923658,"IND",7138927
1,503.0,"Western Europe",4096039,4089861,6178,3048483,5080806,"NLD",4064645
1,503.0,"China",10612804,10056271,556533,7958510,13264183,"CPR",10611347
1,503.0,"United States of America",3138885,3138386,499,2386698,3977830,"USA",3182264
1,503.0,"Northern Africa",1812316,0,1812316,1353072,2255121,"EGY",1804097
1,503.0,"Russian Federation",2544526,2544005,521,1885895,3143158,"RUS",2514527
1,503.0,"Western Africa",550931,0,550931,417438,695730,"NGA",556584
1,503.0,"South America",2190784,1483989,706795,1644215,2740358,"BRA",2192287
1,503.0,"Northern Europe",2198633,1991097,207536,1636416,2727361,"GBR",2181889
1,503.0,"Northern America",685366,684382,984,518751,864586,"CAN",691669
1,503.0,"Oceania",655468,655468,0,491279,818798,"NZL",655039
1,503.0,"Eastern Africa",469019,0,469019,353277,588796,"ETH",471037
1,503.0,"Middle Africa",150157,0,150157,113889,189816,"AGO",151853
1,503.0,"Eastern Europe",3079159,3067837,11322,2298697,3831162,"POL",3064930
1,503.0,"Central Asia",1727848,1726213,1635,1301183,2168638,"UZB",1734911
1,503.0,"Southern Europe",897645,0,897645,675580,1125967,"ITA",900774
1,503.0,"Central America",443881,0,443881,337353,562256,"MEX",449805
1,503.0,"Southern Asia",822188,0,822188,612234,1020391,"IRN",816313
1,503.0,"Western Asia",1649234,0,1649234,1231761,2052936,"IRQ",1642349
1,503.0,"Eastern Asia",1064193,0,1064193,795954,1326591,"JPN",1061273
1,503.0,"Southern Africa",160597,0,160597,120858,201431,"ZAF",161145
1,503.0,"South-Eastern Asia",1413195,0,1413195,1059633,1766055,"IDN",1412844
1,503.0,"Caribbean",161006,0,161006,122337,203895,"CUB",163116
1,504.0,"Pakistan",2047449,2043691,3758,1525824,2543040,"PAK",2034432
1,504.0,"India",7139070,7138931,139,5354195,8923658,"IND",7138927
1,504.0,"Western Europe",4086581,4081214,5367,3048483,5080806,"NLD",4064645
1,504.0,"China",10609757,10055878,553879,7958510,13264183,"CPR",10611347
1,504.0,"United States of America",3227465,3227134,331,2386698,3977830,"USA",3182264
1,504.0,"Northern Africa",1804855,0,1804855,1353072,2255121,"EGY",1804097
1,504.0,"Russian Federation",2504288,2503940,348,1885895,3143158,"RUS",2514527
1,504.0,"Western Africa",553151,0,553151,417438,695730,"NGA",556584
1,504.0,"South America",2205089,1487469,717620,1644215,2740358,"BRA",2192287
1,504.0,"Northern Europe",2195141,1985553,209588,1636416,2727361,"GBR",2181889
1,504.0,"Northern America",671160,670470,690,518751,864586,"CAN",691669
1,504.0,"Oceania",655336,655336,0,491279,818798,"NZL",655039
1,504.0,"Eastern Africa",463913,0,463913,353277,588796,"ETH",471037
1,504.0,"Middle Africa",151198,0,151198,113889,189816,"AGO",151853
1,504.0,"Eastern Europe",3055313,3044768,10545,2298697,3831162,"POL",3064930
1,504.0,"Central Asia",1740881,1739272,1609,1301183,2168638,"UZB",1734911
1,504.0,"Southern Europe",897332,0,897332,675580,1125967,"ITA",900774
1,504.0,"Central America",454747,0,454747,337353,562256,"MEX",449805
1,504.0,"Southern Asia",813677,0,813677,612234,1020391,"IRN",816313
1,504.0,"Western Asia",1637228,0,1637228,1231761,2052936,"IRQ",1642349
1,504.0,"Eastern Asia",1055860,0,1055860,795954,1326591,"JPN",1061273
1,504.0,"Southern Africa",160683,0,160683,120858,201431,"ZAF",161145
1,504.0,"South-Eastern Asia",1411939,0,1411939,1059633,1766055,"IDN",1412844
1,504.0,"Caribbean",164796,0,164796,122337,203895,"CUB",163116
1,505.0,"Pakistan",2030637,2027993,2644,1525824,2543040,"PAK",2034432
1,505.0,"India",7139035,7138932,103,5354195,8923658,"IND",7138927
1,505.0,"Western Europe",4080155,4075406,4749,3048483,5080806,"NLD",4064645
1,505.0,"China",10611823,10053584,558239,7958510,13264183,"CPR",10611347
1,505.0,"United States of America",3138318,3138072,246,2386698,3977830,"USA",3182264
1,505.0,"Northern Africa",1808018,0,1808018,1353072,2255121,"EGY",1804097
1,505.0,"Russian Federation",2491859,2491601,258,1885895,3143158,"RUS",2514527
1,505.0,"Western Africa",567044,0,567044,417438,695730,"NGA",556584
1,505.0,"South America",2214603,1488897,725706,1644215,2740358,"BRA",2192287
1,505.0,"Northern Europe",2191948,1980566,211382,1636416,2727361,"GBR",2181889
1,505.0,"Northern America",730672,729322,1350,518751,864586,"CAN",691669
1,505.0,"Oceania",655246,655246,0,491279,818798,"NZL",655039
1,505.0,"Eastern Africa",482686,0,482686,353277,588796,"ETH",471037
1,505.0,"Middle Africa",154122,0,154122,113889,189816,"AGO",151853
1,505.0,"Eastern Europe",3058566,3047576,10990,2298697,3831162,"POL",3064930
1,505.0,"Central Asia",1728145,1727005,1140,1301183,2168638,"UZB",1734911
1,505.0,"Southern Europe",917671,0,917671,675580,1125967,"ITA",900774
1,505.0,"Central America",445969,0,445969,337353,562256,"MEX",449805
1,505.0,"Southern Asia",814831,0,814831,612234,1020391,"IRN",816313
1,505.0,"Western Asia",1640175,0,1640175,1231761,2052936,"IRQ",1642349
1,505.0,"Eastern Asia",1061541,0,1061541,795954,1326591,"JPN",1061273
1,505.0,"Southern Africa",161929,0,161929,120858,201431,"ZAF",161145
1,505.0,"South-Eastern Asia",1416083,0,1416083,1059633,1766055,"IDN",1412844
1,505.0,"Caribbean",161934,0,161934,122337,203895,"CUB",163116
1,506.0,"Pakistan",2031766,2029105,2661,1525824,2543040,"PAK",2034432
1,506.0,"India",7139009,7138689,320,5354195,8923658,"IND",7138927
1,506.0,"Western Europe",4075431,4070714,4717,3048483,5080806,"NLD",4064645
1,506.0,"China",10611820,10053458,558362,7958510,13264183,"CPR",10611347
1,506.0,"United States of America",3227062,3226301,761,2386698,3977830,"USA",3182264
1,506.0,"Northern Africa",1802589,0,1802589,1353072,2255121,"EGY",1804097
1,506.0,"Russian Federation",2529847,2529004,843,1885895,3143158,"RUS",2514527
1,506.0,"Western Africa",557201,0,557201,417438,695730,"NGA",556584
1,506.0,"South America",2214899,1484694,730205,1644215,2740358,"BRA",2192287
1,506.0,"Northern Europe",2202176,1988876,213300,1636416,2727361,"GBR",2181889
1,506.0,"Northern America",681517,680587,930,518751,864586,"CAN",691669
1,506.0,"Oceania",655180,655180,0,491279,818798,"NZL",655039
1,506.0,"Eastern Africa",467594,0,467594,353277,588796,"ETH",471037
1,506.0,"Middle Africa",152228,0,152228,113889,189816,"AGO",151853
1,506.0,"Eastern Europe",3040650,3029559,11091,2298697,3831162,"POL",3064930
1,506.0,"Central Asia",1719174,1717679,1495,1301183,2168638,"UZB",1734911
1,506.0,"Southern Europe",901831,0,901831,675580,1125967,"ITA",900774
1,506.0,"Central America",455055,0,455055,337353,562256,"MEX",449805
1,506.0,"Southern Asia",816859,0,816859,612234,1020391,"IRN",816313
1,506.0,"Western Asia",1630087,0,1630087,1231761,2052936,"IRQ",1642349
1,506.0,"Eastern Asia",1065439,0,1065439,795954,1326591,"JPN",1061273
1,506.0,"Southern Africa",161221,0,161221,120858,201431,"ZAF",161145
1,506.0,"South-Eastern Asia",1412362,0,1412362,1059633,1766055,"IDN",1412844
1,506.0,"Caribbean",164899,0,164899,122337,203895,"CUB",163116
1,507.0,"Pakistan",2032528,2030072,2456,1525824,2543040,"PAK",2034432
1,507.0,"India",7138981,7138763,218,5354195,8923658,"IND",7138927
1,507.0,"Western Europe",4072208,4067110,5098,3048483,5080806,"NLD",4064645
1,507.0,"China",10610755,10050404,560351,7958510,13264183,"CPR",10611347
1,507.0,"United States of America",3156678,3156160,518,2386698,3977830,"USA",3182264
1,507.0,"Northern Africa",1813072,0,1813072,1353072,2255121,"EGY",1804097
1,507.0,"Russian Federation",2509624,2509048,576,1885895,3143158,"RUS",2514527
1,507.0,"Western Africa",552193,0,552193,417438,695730,"NGA",556584
1,507.0,"South America",2216357,1485489,730868,1644215,2740358,"BRA",2192287
1,507.0,"Northern Europe",2194534,1982104,212430,1636416,2727361,"GBR",2181889
1,507.0,"Northern America",684725,683806,919,518751,864586,"CAN",691669
1,507.0,"Oceania",655140,655140,0,491279,818798,"NZL",655039
1,507.0,"Eastern Africa",468720,0,468720,353277,588796,"ETH",471037
1,507.0,"Middle Africa",150598,0,150598,113889,189816,"AGO",151853
1,507.0,"Eastern Europe",3106514,3093504,13010,2298697,3831162,"POL",3064930
1,507.0,"Central Asia",1745803,1744319,1484,1301183,2168638,"UZB",1734911
1,507.0,"Southern Europe",897028,0,897028,675580,1125967,"ITA",900774
1,507.0,"Central America",446183,0,446183,337353,562256,"MEX",449805
1,507.0,"Southern Asia",816369,0,816369,612234,1020391,"IRN",816313
1,507.0,"Western Asia",1660865,0,1660865,1231761,2052936,"IRQ",1642349
1,507.0,"Eastern Asia",1056894,0,1056894,795954,1326591,"JPN",1061273
1,507.0,"Southern Africa",160718,0,160718,120858,201431,"ZAF",161145
1,507.0,"South-Eastern Asia",1412597,0,1412597,1059633,1766055,"IDN",1412844
1,507.0,"Caribbean",161816,0,161816,122337,203895,"CUB",163116
1,508.0,"Pakistan",2032971,2030797,2174,1525824,2543040,"PAK",2034432
1,508.0,"India",7138956,7138812,144,5354195,8923658,"IND",7138927
1,508.0,"Western Europe",4069824,4065321,4503,3048483,5080806,"NLD",4064645
1,508.0,"China",10609785,10048081,561704,7958510,13264183,"CPR",10611347
1,508.0,"United States of America",3220849,3220510,339,2386698,3977830,"USA",3182264
1,508.0,"Northern Africa",1808987,0,1808987,1353072,2255121,"EGY",1804097
1,508.0,"Russian Federation",2511087,2510707,380,1885895,3143158,"RUS",2514527
1,508.0,"Western Africa",548990,0,548990,417438,695730,"NGA",556584
1,508.0,"South America",2220824,1491200,729624,1644215,2740358,"BRA",2192287
1,508.0,"Northern Europe",2191240,1977827,213413,1636416,2727361,"GBR",2181889
1,508.0,"Northern America",662618,661978,640,518751,864586,"CAN",691669
1,508.0,"Oceania",655106,655106,0,491279,818798,"NZL",655039
1,508.0,"Eastern Africa",461175,0,461175,353277,588796,"ETH",471037
1,508.0,"Middle Africa",150453,0,150453,113889,189816,"AGO",151853
1,508.0,"Eastern Europe",3093873,3081970,11903,2298697,3831162,"POL",3064930
1,508.0,"Central Asia",1742539,1741530,1009,1301183,2168638,"UZB",1734911
1,508.0,"Southern Europe",889784,0,889784,675580,1125967,"ITA",900774
1,508.0,"Central America",453075,0,453075,337353,562256,"MEX",449805
1,508.0,"Southern Asia",813460,0,813460,612234,1020391,"IRN",816313
1,508.0,"Western Asia",1652785,0,1652785,1231761,2052936,"IRQ",1642349
1,508.0,"Eastern Asia",1054657,0,1054657,795954,1326591,"JPN",1061273
1,508.0,"Southern Africa",160438,0,160438,120858,201431,"ZAF",161145
1,508.0,"South-Eastern Asia",1410835,0,1410835,1059633,1766055,"IDN",1412844
1,508.0,"Caribbean",164306,0,164306,122337,203895,"CUB",163116
1,509.0,"Pakistan",2033413,2031310,2103,1525824,2543040,"PAK",2034432
1,509.0,"India",7138952,7138845,107,5354195,8923658,"IND",7138927
1,509.0,"Western Europe",4068410,4064434,3976,3048483,5080806,"NLD",4064645
1,509.0,"China",10612367,10058944,553423,7958510,13264183,"CPR",10611347
1,509.0,"United States of America",3133942,3133690,252,2386698,3977830,"USA",3182264
1,509.0,"Northern Africa",1808057,0,1808057,1353072,2255121,"EGY",1804097
1,509.0,"Russian Federation",2527712,2527431,281,1885895,3143158,"RUS",2514527
1,509.0,"Western Africa",563182,0,563182,417438,695730,"NGA",556584
1,509.0,"South America",2202206,1489435,712771,1644215,2740358,"BRA",2192287
1,509.0,"Northern Europe",2187628,1985340,202288,1636416,2727361,"GBR",2181889
1,509.0,"Northern America",720735,719092,1643,518751,864586,"CAN",691669
1,509.0,"Oceania",655088,655088,0,491279,818798,"NZL",655039
1,509.0,"Eastern Africa",479193,0,479193,353277,588796,"ETH",471037
1,509.0,"Middle Africa",152853,0,152853,113889,189816,"AGO",151853
1,509.0,"Eastern Europe",3066147,3055942,10205,2298697,3831162,"POL",3064930
1,509.0,"Central Asia",1740293,1739568,725,1301183,2168638,"UZB",1734911
1,509.0,"Southern Europe",912455,0,912455,675580,1125967,"ITA",900774
1,509.0,"Central America",445350,0,445350,337353,562256,"MEX",449805
1,509.0,"Southern Asia",822407,0,822407,612234,1020391,"IRN",816313
1,509.0,"Western Asia",1645042,0,1645042,1231761,2052936,"IRQ",1642349
1,509.0,"Eastern Asia",1068414,0,1068414,795954,1326591,"JPN",1061273
1,509.0,"Southern Africa",161349,0,161349,120858,201431,"ZAF",161145
1,509.0,"South-Eastern Asia",1415138,0,1415138,1059633,1766055,"IDN",1412844
1,509.0,"Caribbean",161515,0,161515,122337,203895,"CUB",163116
1,510.0,"Pakistan",2046705,2044603,2102,1525824,2543040,"PAK",2034432
1,510.0,"India",7138938,7138836,102,5354195,8923658,"IND",7138927
1,510.0,"Western Europe",4067181,4063285,3896,3048483,5080806,"NLD",4064645
1,510.0,"China",10610643,10058671,551972,7958510,13264183,"CPR",10611347
1,510.0,"United States of America",3223991,3223457,534,2386698,3977830,"USA",3182264
1,510.0,"Northern Africa",1804655,0,1804655,1353072,2255121,"EGY",1804097
1,510.0,"Russian Federation",2523691,2523204,487,1885895,3143158,"RUS",2514527
1,510.0,"Western Africa",554084,0,554084,417438,695730,"NGA",556584
1,510.0,"South America",2200621,1483392,717229,1644215,2740358,"BRA",2192287
1,510.0,"Northern Europe",2186934,1982636,204298,1636416,2727361,"GBR",2181889
1,510.0,"Northern America",674790,673654,1136,518751,864586,"CAN",691669
1,510.0,"Oceania",655074,655074,0,491279,818798,"NZL",655039
1,510.0,"Eastern Africa",465339,0,465339,353277,588796,"ETH",471037
1,510.0,"Middle Africa",151651,0,151651,113889,189816,"AGO",151853
1,510.0,"Eastern Europe",3065461,3055490,9971,2298697,3831162,"POL",3064930
1,510.0,"Central Asia",1727716,1726830,886,1301183,2168638,"UZB",1734911
1,510.0,"Southern Europe",896557,0,896557,675580,1125967,"ITA",900774
1,510.0,"Central America",453919,0,453919,337353,562256,"MEX",449805
1,510.0,"Southern Asia",816221,0,816221,612234,1020391,"IRN",816313
1,510.0,"Western Asia",1642244,0,1642244,1231761,2052936,"IRQ",1642349
1,510.0,"Eastern Asia",1061600,0,1061600,795954,1326591,"JPN",1061273
1,510.0,"Southern Africa",160996,0,160996,120858,201431,"ZAF",161145
1,510.0,"South-Eastern Asia",1411578,0,1411578,1059633,1766055,"IDN",1412844
1,510.0,"Caribbean",164519,0,164519,122337,203895,"CUB",163116
1,511.0,"Pakistan",2030125,2028631,1494,1525824,2543040,"PAK",2034432
1,511.0,"India",7138865,7138865,0,5354195,8923658,"IND",7138927
1,511.0,"Western Europe",4066526,4063054,3472,3048483,5080806,"NLD",4064645
1,511.0,"China",10612925,10056016,556909,7958510,13264183,"CPR",10611347
1,511.0,"United States of America",3117411,3117015,396,2386698,3977830,"USA",3182264
1,511.0,"Northern Africa",1808246,0,1808246,1353072,2255121,"EGY",1804097
1,511.0,"Russian Federation",2520923,2520564,359,1885895,3143158,"RUS",2514527
1,511.0,"Western Africa",566059,0,566059,417438,695730,"NGA",556584
1,511.0,"South America",2209738,1487461,722277,1644215,2740358,"BRA",2192287
1,511.0,"Northern Europe",2184691,1980120,204571,1636416,2727361,"GBR",2181889
1,511.0,"Northern America",733037,731427,1610,518751,864586,"CAN",691669
1,511.0,"Oceania",655062,655062,0,491279,818798,"NZL",655039
1,511.0,"Eastern Africa",482591,0,482591,353277,588796,"ETH",471037
1,511.0,"Middle Africa",153351,0,153351,113889,189816,"AGO",151853
1,511.0,"Eastern Europe",3065666,3055333,10333,2298697,3831162,"POL",3064930
1,511.0,"Central Asia",1729861,1729015,846,1301183,2168638,"UZB",1734911
1,511.0,"Southern Europe",916392,0,916392,675580,1125967,"ITA",900774
1,511.0,"Central America",443551,0,443551,337353,562256,"MEX",449805
1,511.0,"Southern Asia",819642,0,819642,612234,1020391,"IRN",816313
1,511.0,"Western Asia",1643840,0,1643840,1231761,2052936,"IRQ",1642349
1,511.0,"Eastern Asia",1068311,0,1068311,795954,1326591,"JPN",1061273
1,511.0,"Southern Africa",161545,0,161545,120858,201431,"ZAF",161145
1,511.0,"South-Eastern Asia",1415948,0,1415948,1059633,1766055,"IDN",1412844
1,511.0,"Caribbean",161064,0,161064,122337,203895,"CUB",163116
1,512.0,"Pakistan",2044390,2042735,1655,1525824,2543040,"PAK",2034432
1,512.0,"India",7138978,7138603,375,5354195,8923658,"IND",7138927
1,512.0,"Western Europe",4040431,4036640,3791,3048483,5080806,"NLD",4064645
1,512.0,"China",10610021,10057920,552101,7958510,13264183,"CPR",10611347
1,512.0,"United States of America",3212734,3211669,1065,2386698,3977830,"USA",3182264
1,512.0,"Northern Africa",1799741,0,1799741,1353072,2255121,"EGY",1804097
1,512.0,"Russian Federation",2503478,2502606,872,1885895,3143158,"RUS",2514527
1,512.0,"Western Africa",558113,0,558113,417438,695730,"NGA",556584
1,512.0,"South America",2209773,1484140,725633,1644215,2740358,"BRA",2192287
1,512.0,"Northern Europe",2185858,1979375,206483,1636416,2727361,"GBR",2181889
1,512.0,"Northern America",687176,686064,1112,518751,864586,"CAN",691669
1,512.0,"Oceania",655055,655055,0,491279,818798,"NZL",655039
1,512.0,"Eastern Africa",469634,0,469634,353277,588796,"ETH",471037
1,512.0,"Middle Africa",152392,0,152392,113889,189816,"AGO",151853
1,512.0,"Eastern Europe",3065253,3054652,10601,2298697,3831162,"POL",3064930
1,512.0,"Central Asia",1742377,1740756,1621,1301183,2168638,"UZB",1734911
1,512.0,"Southern Europe",899573,0,899573,675580,1125967,"ITA",900774
1,512.0,"Central America",453678,0,453678,337353,562256,"MEX",449805
1,512.0,"Southern Asia",815378,0,815378,612234,1020391,"IRN",816313
1,512.0,"Western Asia",1641525,0,1641525,1231761,2052936,"IRQ",1642349
1,512.0,"Eastern Asia",1058999,0,1058999,795954,1326591,"JPN",1061273
1,512.0,"Southern Africa",161409,0,161409,120858,201431,"ZAF",161145
1,512.0,"South-Eastern Asia",1413203,0,1413203,1059633,1766055,"IDN",1412844
1,512.0,"Caribbean",164484,0,164484,122337,203895,"CUB",163116
1,513.0,"Pakistan",2041419,2040292,1127,1525824,2543040,"PAK",2034432
1,513.0,"India",7184029,7183786,243,5354195,8923658,"IND",7138927
1,513.0,"Western Europe",4073077,4068766,4311,3048483,5080806,"NLD",4064645
1,513.0,"China",10612945,10055307,557638,7958510,13264183,"CPR",10611347
1,513.0,"United States of America",3202918,3202226,692,2386698,3977830,"USA",3182264
1,513.0,"Northern Africa",1804364,0,1804364,1353072,2255121,"EGY",1804097
1,513.0,"Russian Federation",2537852,2537013,839,1885895,3143158,"RUS",2514527
1,513.0,"Western Africa",546388,0,546388,417438,695730,"NGA",556584
1,513.0,"South America",2200952,1488029,712923,1644215,2740358,"BRA",2192287
1,513.0,"Northern Europe",2184039,1977119,206920,1636416,2727361,"GBR",2181889
1,513.0,"Northern America",660512,659758,754,518751,864586,"CAN",691669
1,513.0,"Oceania",655051,655051,0,491279,818798,"NZL",655039
1,513.0,"Eastern Africa",462830,0,462830,353277,588796,"ETH",471037
1,513.0,"Middle Africa",149725,0,149725,113889,189816,"AGO",151853
1,513.0,"Eastern Europe",3065617,3054556,11061,2298697,3831162,"POL",3064930
1,513.0,"Central Asia",1740124,1738695,1429,1301183,2168638,"UZB",1734911
1,513.0,"Southern Europe",887163,0,887163,675580,1125967,"ITA",900774
1,513.0,"Central America",450712,0,450712,337353,562256,"MEX",449805
1,513.0,"Southern Asia",819251,0,819251,612234,1020391,"IRN",816313
1,513.0,"Western Asia",1641078,0,1641078,1231761,2052936,"IRQ",1642349
1,513.0,"Eastern Asia",1060256,0,1060256,795954,1326591,"JPN",1061273
1,513.0,"Southern Africa",160403,0,160403,120858,201431,"ZAF",161145
1,513.0,"South-Eastern Asia",1411130,0,1411130,1059633,1766055,"IDN",1412844
1,513.0,"Caribbean",163428,0,163428,122337,203895,"CUB",163116
1,514.0,"Pakistan",2039376,2038388,988,1525824,2543040,"PAK",2034432
1,514.0,"India",7170568,7170386,182,5354195,8923658,"IND",7138927
1,514.0,"Western Europe",4019649,4015937,3712,3048483,5080806,"NLD",4064645
1,514.0,"China",10613422,10054879,558543,7958510,13264183,"CPR",10611347
1,514.0,"United States of America",3177677,3177162,515,2386698,3977830,"USA",3182264
1,514.0,"Northern Africa",1795755,0,1795755,1353072,2255121,"EGY",1804097
1,514.0,"Russian Federation",2515261,2514637,624,1885895,3143158,"RUS",2514527
1,514.0,"Western Africa",568460,0,568460,417438,695730,"NGA",556584
1,514.0,"South America",2214221,1492106,722115,1644215,2740358,"BRA",2192287
1,514.0,"Northern Europe",2183054,1983983,199071,1636416,2727361,"GBR",2181889
1,514.0,"Northern America",723019,721576,1443,518751,864586,"CAN",691669
1,514.0,"Oceania",655047,655047,0,491279,818798,"NZL",655039
1,514.0,"Eastern Africa",481036,0,481036,353277,588796,"ETH",471037
1,514.0,"Middle Africa",154309,0,154309,113889,189816,"AGO",151853
1,514.0,"Eastern Europe",3065662,3055797,9865,2298697,3831162,"POL",3064930
1,514.0,"Central Asia",1727653,1726376,1277,1301183,2168638,"UZB",1734911
1,514.0,"Southern Europe",913342,0,913342,675580,1125967,"ITA",900774
1,514.0,"Central America",451233,0,451233,337353,562256,"MEX",449805
1,514.0,"Southern Asia",818564,0,818564,612234,1020391,"IRN",816313
1,514.0,"Western Asia",1643325,0,1643325,1231761,2052936,"IRQ",1642349
1,514.0,"Eastern Asia",1069230,0,1069230,795954,1326591,"JPN",1061273
1,514.0,"Southern Africa",161796,0,161796,120858,201431,"ZAF",161145
1,514.0,"South-Eastern Asia",1416100,0,1416100,1059633,1766055,"IDN",1412844
1,514.0,"Caribbean",163613,0,163613,122337,203895,"CUB",163116
1,515.0,"Pakistan",2037926,2036829,1097,1525824,2543040,"PAK",2034432
1,515.0,"India",7161116,7160866,250,5354195,8923658,"IND",7138927
1,515.0,"Western Europe",4084148,4079325,4823,3048483,5080806,"NLD",4064645
1,515.0,"China",10611127,10050831,560296,7958510,13264183,"CPR",10611347
1,515.0,"United States of America",3216439,3215645,794,2386698,3977830,"USA",3182264
1,515.0,"Northern Africa",1806890,0,1806890,1353072,2255121,"EGY",1804097
1,515.0,"Russian Federation",2499543,2498570,973,1885895,3143158,"RUS",2514527
1,515.0,"Western Africa",557419,0,557419,417438,695730,"NGA",556584
1,515.0,"South America",2207825,1491867,715958,1644215,2740358,"BRA",2192287
1,515.0,"Northern Europe",2185438,1983674,201764,1636416,2727361,"GBR",2181889
1,515.0,"Northern America",684544,683564,980,518751,864586,"CAN",691669
1,515.0,"Oceania",655044,655044,0,491279,818798,"NZL",655039
1,515.0,"Eastern Africa",469747,0,469747,353277,588796,"ETH",471037
1,515.0,"Middle Africa",152293,0,152293,113889,189816,"AGO",151853
1,515.0,"Eastern Europe",3045959,3036106,9853,2298697,3831162,"POL",3064930
1,515.0,"Central Asia",1751763,1749876,1887,1301183,2168638,"UZB",1734911
1,515.0,"Southern Europe",902651,0,902651,675580,1125967,"ITA",900774
1,515.0,"Central America",453746,0,453746,337353,562256,"MEX",449805
1,515.0,"Southern Asia",814931,0,814931,612234,1020391,"IRN",816313
1,515.0,"Western Asia",1633566,0,1633566,1231761,2052936,"IRQ",1642349
1,515.0,"Eastern Asia",1058481,0,1058481,795954,1326591,"JPN",1061273
1,515.0,"Southern Africa",161180,0,161180,120858,201431,"ZAF",161145
1,515.0,"South-Eastern Asia",1412731,0,1412731,1059633,1766055,"IDN",1412844
1,515.0,"Caribbean",164506,0,164506,122337,203895,"CUB",163116
1,516.0,"Pakistan",2036873,2036002,871,1525824,2543040,"PAK",2034432
1,516.0,"India",7154479,7154312,167,5354195,8923658,"IND",7138927
1,516.0,"Western Europe",4078278,4073052,5226,3048483,5080806,"NLD",4064645
1,516.0,"China",10615327,10047564,567763,7958510,13264183,"CPR",10611347
1,516.0,"United States of America",3168203,3167673,530,2386698,3977830,"USA",3182264
1,516.0,"Northern Africa",1810676,0,1810676,1353072,2255121,"EGY",1804097
1,516.0,"Russian Federation",2566114,2565462,652,1885895,3143158,"RUS",2514527
1,516.0,"Western Africa",549459,0,549459,417438,695730,"NGA",556584
1,516.0,"South America",2176814,1492430,684384,1644215,2740358,"BRA",2192287
1,516.0,"Northern Europe",2182899,1981278,201621,1636416,2727361,"GBR",2181889
1,516.0,"Northern America",674725,674066,659,518751,864586,"CAN",691669
1,516.0,"Oceania",655043,655043,0,491279,818798,"NZL",655039
1,516.0,"Eastern Africa",466340,0,466340,353277,588796,"ETH",471037
1,516.0,"Middle Africa",150104,0,150104,113889,189816,"AGO",151853
1,516.0,"Eastern Europe",3090382,3079252,11130,2298697,3831162,"POL",3064930
1,516.0,"Central Asia",1724786,1723500,1286,1301183,2168638,"UZB",1734911
1,516.0,"Southern Europe",892886,0,892886,675580,1125967,"ITA",900774
1,516.0,"Central America",447180,0,447180,337353,562256,"MEX",449805
1,516.0,"Southern Asia",824883,0,824883,612234,1020391,"IRN",816313
1,516.0,"Western Asia",1652459,0,1652459,1231761,2052936,"IRQ",1642349
1,516.0,"Eastern Asia",1069049,0,1069049,795954,1326591,"JPN",1061273
1,516.0,"Southern Africa",160513,0,160513,120858,201431,"ZAF",161145
1,516.0,"South-Eastern Asia",1411667,0,1411667,1059633,1766055,"IDN",1412844
1,516.0,"Caribbean",162123,0,162123,122337,203895,"CUB",163116
1,517.0,"Pakistan",2036266,2035281,985,1525824,2543040,"PAK",2034432
1,517.0,"India",7149837,7149715,122,5354195,8923658,"IND",7138927
1,517.0,"Western Europe",4048779,4044357,4422,3048483,5080806,"NLD",4064645
1,517.0,"China",10611823,10043335,568488,7958510,13264183,"CPR",10611347
1,517.0,"United States of America",3172721,3172330,391,2386698,3977830,"USA",3182264
1,517.0,"Northern Africa",1802362,0,1802362,1353072,2255121,"EGY",1804097
1,517.0,"Russian Federation",2488476,2487996,480,1885895,3143158,"RUS",2514527
1,517.0,"Western Africa",568578,0,568578,417438,695730,"NGA",556584
1,517.0,"South America",2189308,1489684,699624,1644215,2740358,"BRA",2192287
1,517.0,"Northern Europe",2183852,1980081,203771,1636416,2727361,"GBR",2181889
1,517.0,"Northern America",732813,732149,664,518751,864586,"CAN",691669
1,517.0,"Oceania",651058,651058,0,491279,818798,"NZL",655039
1,517.0,"Eastern Africa",482878,0,482878,353277,588796,"ETH",471037
1,517.0,"Middle Africa",154738,0,154738,113889,189816,"AGO",151853
1,517.0,"Eastern Europe",3063917,3052324,11593,2298697,3831162,"POL",3064930
1,517.0,"Central Asia",1727802,1726271,1531,1301183,2168638,"UZB",1734911
1,517.0,"Southern Europe",921637,0,921637,675580,1125967,"ITA",900774
1,517.0,"Central America",450689,0,450689,337353,562256,"MEX",449805
1,517.0,"Southern Asia",814398,0,814398,612234,1020391,"IRN",816313
1,517.0,"Western Asia",1640846,0,1640846,1231761,2052936,"IRQ",1642349
1,517.0,"Eastern Asia",1064962,0,1064962,795954,1326591,"JPN",1061273
1,517.0,"Southern Africa",160854,0,160854,120858,201431,"ZAF",161145
1,517.0,"South-Eastern Asia",1408754,0,1408754,1059633,1766055,"IDN",1412844
1,517.0,"Caribbean",163589,0,163589,122337,203895,"CUB",163116
1,518.0,"Pakistan",2035754,2034447,1307,1525824,2543040,"PAK",2034432
1,518.0,"India",7191447,7191027,420,5354195,8923658,"IND",7138927
1,518.0,"Western Europe",4053492,4048003,5489,3048483,5080806,"NLD",4064645
1,518.0,"China",10614239,10039689,574550,7958510,13264183,"CPR",10611347
1,518.0,"United States of America",3213028,3212127,901,2386698,3977830,"USA",3182264
1,518.0,"Northern Africa",1800881,0,1800881,1353072,2255121,"EGY",1804097
1,518.0,"Russian Federation",2527301,2526161,1140,1885895,3143158,"RUS",2514527
1,518.0,"Western Africa",556384,0,556384,417438,695730,"NGA",556584
1,518.0,"South America",2187931,1488492,699439,1644215,2740358,"BRA",2192287
1,518.0,"Northern Europe",2183499,1977902,205597,1636416,2727361,"GBR",2181889
1,518.0,"Northern America",683078,682630,448,518751,864586,"CAN",691669
1,518.0,"Oceania",652353,652204,149,491279,818798,"NZL",655039
1,518.0,"Eastern Africa",470540,0,470540,353277,588796,"ETH",471037
1,518.0,"Middle Africa",152200,0,152200,113889,189816,"AGO",151853
1,518.0,"Eastern Europe",3064038,3052265,11773,2298697,3831162,"POL",3064930
1,518.0,"Central Asia",1729934,1727938,1996,1301183,2168638,"UZB",1734911
1,518.0,"Southern Europe",898509,0,898509,675580,1125967,"ITA",900774
1,518.0,"Central America",453370,0,453370,337353,562256,"MEX",449805
1,518.0,"Southern Asia",819872,0,819872,612234,1020391,"IRN",816313
1,518.0,"Western Asia",1641367,0,1641367,1231761,2052936,"IRQ",1642349
1,518.0,"Eastern Asia",1064410,0,1064410,795954,1326591,"JPN",1061273
1,518.0,"Southern Africa",160611,0,160611,120858,201431,"ZAF",161145
1,518.0,"South-Eastern Asia",1407819,0,1407819,1059633,1766055,"IDN",1412844
1,518.0,"Caribbean",164347,0,164347,122337,203895,"CUB",163116
1,519.0,"Pakistan",2035326,2034056,1270,1525824,2543040,"PAK",2034432
1,519.0,"India",7175645,7175366,279,5354195,8923658,"IND",7138927
1,519.0,"Western Europe",4082349,4076140,6209,3048483,5080806,"NLD",4064645
1,519.0,"China",10611286,10035253,576033,7958510,13264183,"CPR",10611347
1,519.0,"United States of America",3184497,3183900,597,2386698,3977830,"USA",3182264
1,519.0,"Northern Africa",1807247,0,1807247,1353072,2255121,"EGY",1804097
1,519.0,"Russian Federation",2492466,2491712,754,1885895,3143158,"RUS",2514527
1,519.0,"Western Africa",549149,0,549149,417438,695730,"NGA",556584
1,519.0,"South America",2186335,1483538,702797,1644215,2740358,"BRA",2192287
1,519.0,"Northern Europe",2182451,1976124,206327,1636416,2727361,"GBR",2181889
1,519.0,"Northern America",669826,669522,304,518751,864586,"CAN",691669
1,519.0,"Oceania",653071,653071,0,491279,818798,"NZL",655039
1,519.0,"Eastern Africa",465641,0,465641,353277,588796,"ETH",471037
1,519.0,"Middle Africa",150343,0,150343,113889,189816,"AGO",151853
1,519.0,"Eastern Europe",3064104,3052253,11851,2298697,3831162,"POL",3064930
1,519.0,"Central Asia",1786319,1784049,2270,1301183,2168638,"UZB",1734911
1,519.0,"Southern Europe",890944,0,890944,675580,1125967,"ITA",900774
1,519.0,"Central America",448844,0,448844,337353,562256,"MEX",449805
1,519.0,"Southern Asia",814895,0,814895,612234,1020391,"IRN",816313
1,519.0,"Western Asia",1642204,0,1642204,1231761,2052936,"IRQ",1642349
1,519.0,"Eastern Asia",1049524,0,1049524,795954,1326591,"JPN",1061273
1,519.0,"Southern Africa",160456,0,160456,120858,201431,"ZAF",161145
1,519.0,"South-Eastern Asia",1407863,0,1407863,1059633,1766055,"IDN",1412844
1,519.0,"Caribbean",162763,0,162763,122337,203895,"CUB",163116
1,520.0,"Pakistan",2035175,2033689,1486,1525824,2543040,"PAK",2034432
1,520.0,"India",7119934,7119731,203,5354195,8923658,"IND",7138927
1,520.0,"Western Europe",4026039,4020599,5440,3048483,5080806,"NLD",4064645
1,520.0,"China",10613254,10031958,581296,7958510,13264183,"CPR",10611347
1,520.0,"United States of America",3146655,3146216,439,2386698,3977830,"USA",3182264
1,520.0,"Northern Africa",1794371,0,1794371,1353072,2255121,"EGY",1804097
1,520.0,"Russian Federation",2514653,2514099,554,1885895,3143158,"RUS",2514527
1,520.0,"Western Africa",563706,0,563706,417438,695730,"NGA",556584
1,520.0,"South America",2202098,1492304,709794,1644215,2740358,"BRA",2192287
1,520.0,"Northern Europe",2194441,1987521,206920,1636416,2727361,"GBR",2181889
1,520.0,"Northern America",725161,724691,470,518751,864586,"CAN",691669
1,520.0,"Oceania",653776,653670,106,491279,818798,"NZL",655039
1,520.0,"Eastern Africa",479315,0,479315,353277,588796,"ETH",471037
1,520.0,"Middle Africa",152941,0,152941,113889,189816,"AGO",151853
1,520.0,"Eastern Europe",3064904,3051893,13011,2298697,3831162,"POL",3064930
1,520.0,"Central Asia",1738047,1736419,1628,1301183,2168638,"UZB",1734911
1,520.0,"Southern Europe",913334,0,913334,675580,1125967,"ITA",900774
1,520.0,"Central America",447387,0,447387,337353,562256,"MEX",449805
1,520.0,"Southern Asia",819314,0,819314,612234,1020391,"IRN",816313
1,520.0,"Western Asia",1643156,0,1643156,1231761,2052936,"IRQ",1642349
1,520.0,"Eastern Asia",1067090,0,1067090,795954,1326591,"JPN",1061273
1,520.0,"Southern Africa",161265,0,161265,120858,201431,"ZAF",161145
1,520.0,"South-Eastern Asia",1413719,0,1413719,1059633,1766055,"IDN",1412844
1,520.0,"Caribbean",162205,0,162205,122337,203895,"CUB",163116
1,521.0,"Pakistan",2034977,2033369,1608,1525824,2543040,"PAK",2034432
1,521.0,"India",7170338,7169912,426,5354195,8923658,"IND",7138927
1,521.0,"Western Europe",4063108,4056535,6573,3048483,5080806,"NLD",4064645
1,521.0,"China",10612992,10027924,585068,7958510,13264183,"CPR",10611347
1,521.0,"United States of America",3213880,3212921,959,2386698,3977830,"USA",3182264
1,521.0,"Northern Africa",1801590,0,1801590,1353072,2255121,"EGY",1804097
1,521.0,"Russian Federation",2514626,2513560,1066,1885895,3143158,"RUS",2514527
1,521.0,"Western Africa",558288,0,558288,417438,695730,"NGA",556584
1,521.0,"South America",2200863,1487459,713404,1644215,2740358,"BRA",2192287
1,521.0,"Northern Europe",2166574,1979897,186677,1636416,2727361,"GBR",2181889
1,521.0,"Northern America",686074,685752,322,518751,864586,"CAN",691669
1,521.0,"Oceania",654160,654058,102,491279,818798,"NZL",655039
1,521.0,"Eastern Africa",470513,0,470513,353277,588796,"ETH",471037
1,521.0,"Middle Africa",152554,0,152554,113889,189816,"AGO",151853
1,521.0,"Eastern Europe",3065142,3051899,13243,2298697,3831162,"POL",3064930
1,521.0,"Central Asia",1726219,1724283,1936,1301183,2168638,"UZB",1734911
1,521.0,"Southern Europe",900262,0,900262,675580,1125967,"ITA",900774
1,521.0,"Central America",453555,0,453555,337353,562256,"MEX",449805
1,521.0,"Southern Asia",816629,0,816629,612234,1020391,"IRN",816313
1,521.0,"Western Asia",1641377,0,1641377,1231761,2052936,"IRQ",1642349
1,521.0,"Eastern Asia",1062516,0,1062516,795954,1326591,"JPN",1061273
1,521.0,"Southern Africa",161329,0,161329,120858,201431,"ZAF",161145
1,521.0,"South-Eastern Asia",1411555,0,1411555,1059633,1766055,"IDN",1412844
1,521.0,"Caribbean",164477,0,164477,122337,203895,"CUB",163116
1,522.0,"Pakistan",2047604,2046235,1369,1525824,2543040,"PAK",2034432
1,522.0,"India",7160869,7160596,273,5354195,8923658,"IND",7138927
1,522.0,"Western Europe",4089055,4081789,7266,3048483,5080806,"NLD",4064645
1,522.0,"China",10615398,10023808,591590,7958510,13264183,"CPR",10611347
1,522.0,"United States of America",3203636,3203023,613,2386698,3977830,"USA",3182264
1,522.0,"Northern Africa",1805869,0,1805869,1353072,2255121,"EGY",1804097
1,522.0,"Russian Federation",2560991,2559980,1011,1885895,3143158,"RUS",2514527
1,522.0,"Western Africa",545519,0,545519,417438,695730,"NGA",556584
1,522.0,"South America",2203783,1492372,711411,1644215,2740358,"BRA",2192287
1,522.0,"Northern Europe",2170241,1982201,188040,1636416,2727361,"GBR",2181889
1,522.0,"Northern America",651967,651749,218,518751,864586,"CAN",691669
1,522.0,"Oceania",658363,658363,0,491279,818798,"NZL",655039
1,522.0,"Eastern Africa",460040,0,460040,353277,588796,"ETH",471037
1,522.0,"Middle Africa",149652,0,149652,113889,189816,"AGO",151853
1,522.0,"Eastern Europe",3064705,3051237,13468,2298697,3831162,"POL",3064930
1,522.0,"Central Asia",1739700,1737762,1938,1301183,2168638,"UZB",1734911
1,522.0,"Southern Europe",881879,0,881879,675580,1125967,"ITA",900774
1,522.0,"Central America",450469,0,450469,337353,562256,"MEX",449805
1,522.0,"Southern Asia",821797,0,821797,612234,1020391,"IRN",816313
1,522.0,"Western Asia",1640662,0,1640662,1231761,2052936,"IRQ",1642349
1,522.0,"Eastern Asia",1063356,0,1063356,795954,1326591,"JPN",1061273
1,522.0,"Southern Africa",160992,0,160992,120858,201431,"ZAF",161145
1,522.0,"South-Eastern Asia",1415815,0,1415815,1059633,1766055,"IDN",1412844
1,522.0,"Caribbean",163246,0,163246,122337,203895,"CUB",163116
1,523.0,"Pakistan",2043740,2042327,1413,1525824,2543040,"PAK",2034432
1,523.0,"India",7154290,7154085,205,5354195,8923658,"IND",7138927
1,523.0,"Western Europe",4081883,4075255,6628,3048483,5080806,"NLD",4064645
1,523.0,"China",10612188,10029361,582827,7958510,13264183,"CPR",10611347
1,523.0,"United States of America",3122586,3122126,460,2386698,3977830,"USA",3182264
1,523.0,"Northern Africa",1810263,0,1810263,1353072,2255121,"EGY",1804097
1,523.0,"Russian Federation",2515858,2515100,758,1885895,3143158,"RUS",2514527
1,523.0,"Western Africa",560332,0,560332,417438,695730,"NGA",556584
1,523.0,"South America",2208289,1490160,718129,1644215,2740358,"BRA",2192287
1,523.0,"Northern Europe",2159544,1978026,181518,1636416,2727361,"GBR",2181889
1,523.0,"Northern America",720956,719723,1233,518751,864586,"CAN",691669
1,523.0,"Oceania",657342,657342,0,491279,818798,"NZL",655039
1,523.0,"Eastern Africa",479655,0,479655,353277,588796,"ETH",471037
1,523.0,"Middle Africa",151911,0,151911,113889,189816,"AGO",151853
1,523.0,"Eastern Europe",3065205,3052885,12320,2298697,3831162,"POL",3064930
1,523.0,"Central Asia",1705654,1703852,1802,1301183,2168638,"UZB",1734911
1,523.0,"Southern Europe",913498,0,913498,675580,1125967,"ITA",900774
1,523.0,"Central America",443517,0,443517,337353,562256,"MEX",449805
1,523.0,"Southern Asia",818309,0,818309,612234,1020391,"IRN",816313
1,523.0,"Western Asia",1642404,0,1642404,1231761,2052936,"IRQ",1642349
1,523.0,"Eastern Asia",1065556,0,1065556,795954,1326591,"JPN",1061273
1,523.0,"Southern Africa",161949,0,161949,120858,201431,"ZAF",161145
1,523.0,"South-Eastern Asia",1421038,0,1421038,1059633,1766055,"IDN",1412844
1,523.0,"Caribbean",160985,0,160985,122337,203895,"CUB",163116
1,524.0,"Pakistan",2040966,2039568,1398,1525824,2543040,"PAK",2034432
1,524.0,"India",7149659,7149466,193,5354195,8923658,"IND",7138927
1,524.0,"Western Europe",4076596,4070665,5931,3048483,5080806,"NLD",4064645
1,524.0,"China",10611161,10029133,582028,7958510,13264183,"CPR",10611347
1,524.0,"United States of America",3197356,3196476,880,2386698,3977830,"USA",3182264
1,524.0,"Northern Africa",1806663,0,1806663,1353072,2255121,"EGY",1804097
1,524.0,"Russian Federation",2515413,2514405,1008,1885895,3143158,"RUS",2514527
1,524.0,"Western Africa",551586,0,551586,417438,695730,"NGA",556584
1,524.0,"South America",2206903,1487089,719814,1644215,2740358,"BRA",2192287
1,524.0,"Northern Europe",2167093,1981981,185112,1636416,2727361,"GBR",2181889
1,524.0,"Northern America",671207,670359,848,518751,864586,"CAN",691669
1,524.0,"Oceania",656633,656633,0,491279,818798,"NZL",655039
1,524.0,"Eastern Africa",465644,0,465644,353277,588796,"ETH",471037
1,524.0,"Middle Africa",150937,0,150937,113889,189816,"AGO",151853
1,524.0,"Eastern Europe",3064780,3053320,11460,2298697,3831162,"POL",3064930
1,524.0,"Central Asia",1747237,1744059,3178,1301183,2168638,"UZB",1734911
1,524.0,"Southern Europe",891877,0,891877,675580,1125967,"ITA",900774
1,524.0,"Central America",450508,0,450508,337353,562256,"MEX",449805
1,524.0,"Southern Asia",816194,0,816194,612234,1020391,"IRN",816313
1,524.0,"Western Asia",1641608,0,1641608,1231761,2052936,"IRQ",1642349
1,524.0,"Eastern Asia",1057338,0,1057338,795954,1326591,"JPN",1061273
1,524.0,"Southern Africa",161155,0,161155,120858,201431,"ZAF",161145
1,524.0,"South-Eastern Asia",1414123,0,1414123,1059633,1766055,"IDN",1412844
1,524.0,"Caribbean",163250,0,163250,122337,203895,"CUB",163116
1,525.0,"Pakistan",2038945,2037854,1091,1525824,2543040,"PAK",2034432
1,525.0,"India",7146442,7146300,142,5354195,8923658,"IND",7138927
1,525.0,"Western Europe",4022080,4016830,5250,3048483,5080806,"NLD",4064645
1,525.0,"China",10610466,10025702,584764,7958510,13264183,"CPR",10611347
1,525.0,"United States of America",3173938,3173285,653,2386698,3977830,"USA",3182264
1,525.0,"Northern Africa",1794194,0,1794194,1353072,2255121,"EGY",1804097
1,525.0,"Russian Federation",2484400,2483654,746,1885895,3143158,"RUS",2514527
1,525.0,"Western Africa",568390,0,568390,417438,695730,"NGA",556584
1,525.0,"South America",2213335,1484285,729050,1644215,2740358,"BRA",2192287
1,525.0,"Northern Europe",2171532,1984127,187405,1636416,2727361,"GBR",2181889
1,525.0,"Northern America",730180,729161,1019,518751,864586,"CAN",691669
1,525.0,"Oceania",656140,656140,0,491279,818798,"NZL",655039
1,525.0,"Eastern Africa",481131,0,481131,353277,588796,"ETH",471037
1,525.0,"Middle Africa",154237,0,154237,113889,189816,"AGO",151853
1,525.0,"Eastern Europe",3065337,3052918,12419,2298697,3831162,"POL",3064930
1,525.0,"Central Asia",1721750,1719171,2579,1301183,2168638,"UZB",1734911
1,525.0,"Southern Europe",917923,0,917923,675580,1125967,"ITA",900774
1,525.0,"Central America",451208,0,451208,337353,562256,"MEX",449805
1,525.0,"Southern Asia",812553,0,812553,612234,1020391,"IRN",816313
1,525.0,"Western Asia",1643031,0,1643031,1231761,2052936,"IRQ",1642349
1,525.0,"Eastern Asia",1061822,0,1061822,795954,1326591,"JPN",1061273
1,525.0,"Southern Africa",162241,0,162241,120858,201431,"ZAF",161145
1,525.0,"South-Eastern Asia",1419421,0,1419421,1059633,1766055,"IDN",1412844
1,525.0,"Caribbean",163612,0,163612,122337,203895,"CUB",163116
1,526.0,"Pakistan",2037715,2036287,1428,1525824,2543040,"PAK",2034432
1,526.0,"India",7144192,7143829,363,5354195,8923658,"IND",7138927
1,526.0,"Western Europe",4060250,4053690,6560,3048483,5080806,"NLD",4064645
1,526.0,"China",10612771,10022086,590685,7958510,13264183,"CPR",10611347
1,526.0,"United States of America",3195207,3194057,1150,2386698,3977830,"USA",3182264
1,526.0,"Northern Africa",1798870,0,1798870,1353072,2255121,"EGY",1804097
1,526.0,"Russian Federation",2524406,2523013,1393,1885895,3143158,"RUS",2514527
1,526.0,"Western Africa",555095,0,555095,417438,695730,"NGA",556584
1,526.0,"South America",2217457,1490374,727083,1644215,2740358,"BRA",2192287
1,526.0,"Northern Europe",2174772,1984646,190126,1636416,2727361,"GBR",2181889
1,526.0,"Northern America",681438,680750,688,518751,864586,"CAN",691669
1,526.0,"Oceania",655802,655802,0,491279,818798,"NZL",655039
1,526.0,"Eastern Africa",468503,0,468503,353277,588796,"ETH",471037
1,526.0,"Middle Africa",151659,0,151659,113889,189816,"AGO",151853
1,526.0,"Eastern Europe",3045588,3032691,12897,2298697,3831162,"POL",3064930
1,526.0,"Central Asia",1747457,1744650,2807,1301183,2168638,"UZB",1734911
1,526.0,"Southern Europe",897322,0,897322,675580,1125967,"ITA",900774
1,526.0,"Central America",450854,0,450854,337353,562256,"MEX",449805
1,526.0,"Southern Asia",819339,0,819339,612234,1020391,"IRN",816313
1,526.0,"Western Asia",1633042,0,1633042,1231761,2052936,"IRQ",1642349
1,526.0,"Eastern Asia",1061799,0,1061799,795954,1326591,"JPN",1061273
1,526.0,"Southern Africa",161137,0,161137,120858,201431,"ZAF",161145
1,526.0,"South-Eastern Asia",1413935,0,1413935,1059633,1766055,"IDN",1412844
1,526.0,"Caribbean",163521,0,163521,122337,203895,"CUB",163116
1,527.0,"Pakistan",2036632,2035604,1028,1525824,2543040,"PAK",2034432
1,527.0,"India",7098050,7097809,241,5354195,8923658,"IND",7138927
1,527.0,"Western Europe",4061521,4054402,7119,3048483,5080806,"NLD",4064645
1,527.0,"China",10610403,10017964,592439,7958510,13264183,"CPR",10611347
1,527.0,"United States of America",3191032,3190271,761,2386698,3977830,"USA",3182264
1,527.0,"Northern Africa",1811996,0,1811996,1353072,2255121,"EGY",1804097
1,527.0,"Russian Federation",2521341,2520417,924,1885895,3143158,"RUS",2514527
1,527.0,"Western Africa",550190,0,550190,417438,695730,"NGA",556584
1,527.0,"South America",2187007,1487560,699447,1644215,2740358,"BRA",2192287
1,527.0,"Northern Europe",2189389,1997452,191937,1636416,2727361,"GBR",2181889
1,527.0,"Northern America",668746,668280,466,518751,864586,"CAN",691669
1,527.0,"Oceania",655567,655567,0,491279,818798,"NZL",655039
1,527.0,"Eastern Africa",463005,0,463005,353277,588796,"ETH",471037
1,527.0,"Middle Africa",150530,0,150530,113889,189816,"AGO",151853
1,527.0,"Eastern Europe",3128862,3114888,13974,2298697,3831162,"POL",3064930
1,527.0,"Central Asia",1732705,1730603,2102,1301183,2168638,"UZB",1734911
1,527.0,"Southern Europe",890205,0,890205,675580,1125967,"ITA",900774
1,527.0,"Central America",449659,0,449659,337353,562256,"MEX",449805
1,527.0,"Southern Asia",814851,0,814851,612234,1020391,"IRN",816313
1,527.0,"Western Asia",1668277,0,1668277,1231761,2052936,"IRQ",1642349
1,527.0,"Eastern Asia",1056888,0,1056888,795954,1326591,"JPN",1061273
1,527.0,"Southern Africa",160601,0,160601,120858,201431,"ZAF",161145
1,527.0,"South-Eastern Asia",1411334,0,1411334,1059633,1766055,"IDN",1412844
1,527.0,"Caribbean",163043,0,163043,122337,203895,"CUB",163116
1,528.0,"Pakistan",2036006,2035259,747,1525824,2543040,"PAK",2034432
1,528.0,"India",7110266,7110089,177,5354195,8923658,"IND",7138927
1,528.0,"Western Europe",4062677,4055326,7351,3048483,5080806,"NLD",4064645
1,528.0,"China",10610274,10014870,595404,7958510,13264183,"CPR",10611347
1,528.0,"United States of America",3169658,3169096,562,2386698,3977830,"USA",3182264
1,528.0,"Northern Africa",1800317,0,1800317,1353072,2255121,"EGY",1804097
1,528.0,"Russian Federation",2488457,2487776,681,1885895,3143158,"RUS",2514527
1,528.0,"Western Africa",567230,0,567230,417438,695730,"NGA",556584
1,528.0,"South America",2196353,1483396,712957,1644215,2740358,"BRA",2192287
1,528.0,"Northern Europe",2188308,1994007,194301,1636416,2727361,"GBR",2181889
1,528.0,"Northern America",728393,727752,641,518751,864586,"CAN",691669
1,528.0,"Oceania",651417,651417,0,491279,818798,"NZL",655039
1,528.0,"Eastern Africa",478470,0,478470,353277,588796,"ETH",471037
1,528.0,"Middle Africa",153951,0,153951,113889,189816,"AGO",151853
1,528.0,"Eastern Europe",3032528,3022592,9936,2298697,3831162,"POL",3064930
1,528.0,"Central Asia",1733329,1731551,1778,1301183,2168638,"UZB",1734911
1,528.0,"Southern Europe",920656,0,920656,675580,1125967,"ITA",900774
1,528.0,"Central America",450064,0,450064,337353,562256,"MEX",449805
1,528.0,"Southern Asia",812537,0,812537,612234,1020391,"IRN",816313
1,528.0,"Western Asia",1628558,0,1628558,1231761,2052936,"IRQ",1642349
1,528.0,"Eastern Asia",1061186,0,1061186,795954,1326591,"JPN",1061273
1,528.0,"Southern Africa",161166,0,161166,120858,201431,"ZAF",161145
1,528.0,"South-Eastern Asia",1410289,0,1410289,1059633,1766055,"IDN",1412844
1,528.0,"Caribbean",163352,0,163352,122337,203895,"CUB",163116
1,529.0,"Pakistan",2035565,2034467,1098,1525824,2543040,"PAK",2034432
1,529.0,"India",7118849,7118371,478,5354195,8923658,"IND",7138927
1,529.0,"Western Europe",4037666,4029240,8426,3048483,5080806,"NLD",4064645
1,529.0,"China",10610900,10011586,599314,7958510,13264183,"CPR",10611347
1,529.0,"United States of America",3192299,3191218,1081,2386698,3977830,"USA",3182264
1,529.0,"Northern Africa",1799269,0,1799269,1353072,2255121,"EGY",1804097
1,529.0,"Russian Federation",2511833,2510480,1353,1885895,3143158,"RUS",2514527
1,529.0,"Western Africa",558310,0,558310,417438,695730,"NGA",556584
1,529.0,"South America",2207561,1492819,714742,1644215,2740358,"BRA",2192287
1,529.0,"Northern Europe",2186194,1990332,195862,1636416,2727361,"GBR",2181889
1,529.0,"Northern America",692197,691767,430,518751,864586,"CAN",691669
1,529.0,"Oceania",652600,652454,146,491279,818798,"NZL",655039
1,529.0,"Eastern Africa",470478,0,470478,353277,588796,"ETH",471037
1,529.0,"Middle Africa",152365,0,152365,113889,189816,"AGO",151853
1,529.0,"Eastern Europe",3080755,3069385,11370,2298697,3831162,"POL",3064930
1,529.0,"Central Asia",1711952,1709765,2187,1301183,2168638,"UZB",1734911
1,529.0,"Southern Europe",901848,0,901848,675580,1125967,"ITA",900774
1,529.0,"Central America",451251,0,451251,337353,562256,"MEX",449805
1,529.0,"Southern Asia",813430,0,813430,612234,1020391,"IRN",816313
1,529.0,"Western Asia",1647330,0,1647330,1231761,2052936,"IRQ",1642349
1,529.0,"Eastern Asia",1060628,0,1060628,795954,1326591,"JPN",1061273
1,529.0,"Southern Africa",160691,0,160691,120858,201431,"ZAF",161145
1,529.0,"South-Eastern Asia",1408845,0,1408845,1059633,1766055,"IDN",1412844
1,529.0,"Caribbean",163700,0,163700,122337,203895,"CUB",163116
1,530.0,"Pakistan",2022344,2021348,996,1525824,2543040,"PAK",2034432
1,530.0,"India",7124820,7124510,310,5354195,8923658,"IND",7138927
1,530.0,"Western Europe",4096864,4087467,9397,3048483,5080806,"NLD",4064645
1,530.0,"China",10610794,10008368,602426,7958510,13264183,"CPR",10611347
1,530.0,"United States of America",3207643,3206605,1038,2386698,3977830,"USA",3182264
1,530.0,"Northern Africa",1811044,0,1811044,1353072,2255121,"EGY",1804097
1,530.0,"Russian Federation",2512605,2511157,1448,1885895,3143158,"RUS",2514527
1,530.0,"Western Africa",550367,0,550367,417438,695730,"NGA",556584
1,530.0,"South America",2202267,1485675,716592,1644215,2740358,"BRA",2192287
1,530.0,"Northern Europe",2185558,1987614,197944,1636416,2727361,"GBR",2181889
1,530.0,"Northern America",664253,663959,294,518751,864586,"CAN",691669
1,530.0,"Oceania",653244,653244,0,491279,818798,"NZL",655039
1,530.0,"Eastern Africa",463154,0,463154,353277,588796,"ETH",471037
1,530.0,"Middle Africa",150570,0,150570,113889,189816,"AGO",151853
1,530.0,"Eastern Europe",3056396,3044997,11399,2298697,3831162,"POL",3064930
1,530.0,"Central Asia",1762624,1759744,2880,1301183,2168638,"UZB",1734911
1,530.0,"Southern Europe",889767,0,889767,675580,1125967,"ITA",900774
1,530.0,"Central America",451357,0,451357,337353,562256,"MEX",449805
1,530.0,"Southern Asia",814381,0,814381,612234,1020391,"IRN",816313
1,530.0,"Western Asia",1638626,0,1638626,1231761,2052936,"IRQ",1642349
1,530.0,"Eastern Asia",1054324,0,1054324,795954,1326591,"JPN",1061273
1,530.0,"Southern Africa",160132,0,160132,120858,201431,"ZAF",161145
1,530.0,"South-Eastern Asia",1406384,0,1406384,1059633,1766055,"IDN",1412844
1,530.0,"Caribbean",163514,0,163514,122337,203895,"CUB",163116
1,531.0,"Pakistan",2013063,2012288,775,1525824,2543040,"PAK",2034432
1,531.0,"India",7129043,7128816,227,5354195,8923658,"IND",7138927
1,531.0,"Western Europe",4087311,4078961,8350,3048483,5080806,"NLD",4064645
1,531.0,"China",10677043,10071860,605183,7958510,13264183,"CPR",10611347
1,531.0,"United States of America",3125260,3124497,763,2386698,3977830,"USA",3182264
1,531.0,"Northern Africa",1811614,0,1811614,1353072,2255121,"EGY",1804097
1,531.0,"Russian Federation",2497768,2496705,1063,1885895,3143158,"RUS",2514527
1,531.0,"Western Africa",559972,0,559972,417438,695730,"NGA",556584
1,531.0,"South America",2206290,1483757,722533,1644215,2740358,"BRA",2192287
1,531.0,"Northern Europe",2183431,1985055,198376,1636416,2727361,"GBR",2181889
1,531.0,"Northern America",721046,720420,626,518751,864586,"CAN",691669
1,531.0,"Oceania",653893,653793,100,491279,818798,"NZL",655039
1,531.0,"Eastern Africa",477573,0,477573,353277,588796,"ETH",471037
1,531.0,"Middle Africa",152335,0,152335,113889,189816,"AGO",151853
1,531.0,"Eastern Europe",3078762,3066172,12590,2298697,3831162,"POL",3064930
1,531.0,"Central Asia",1710548,1708576,1972,1301183,2168638,"UZB",1734911
1,531.0,"Southern Europe",915842,0,915842,675580,1125967,"ITA",900774
1,531.0,"Central America",444475,0,444475,337353,562256,"MEX",449805
1,531.0,"Southern Asia",812170,0,812170,612234,1020391,"IRN",816313
1,531.0,"Western Asia",1648130,0,1648130,1231761,2052936,"IRQ",1642349
1,531.0,"Eastern Asia",1059253,0,1059253,795954,1326591,"JPN",1061273
1,531.0,"Southern Africa",161623,0,161623,120858,201431,"ZAF",161145
1,531.0,"South-Eastern Asia",1414690,0,1414690,1059633,1766055,"IDN",1412844
1,531.0,"Caribbean",161145,0,161145,122337,203895,"CUB",163116
1,532.0,"Pakistan",2019332,2017834,1498,1525824,2543040,"PAK",2034432
1,532.0,"India",7131999,7131559,440,5354195,8923658,"IND",7138927
1,532.0,"Western Europe",4080372,4072888,7484,3048483,5080806,"NLD",4064645
1,532.0,"China",10656992,10056788,600204,7958510,13264183,"CPR",10611347
1,532.0,"United States of America",3199203,3197879,1324,2386698,3977830,"USA",3182264
1,532.0,"Northern Africa",1810019,0,1810019,1353072,2255121,"EGY",1804097
1,532.0,"Russian Federation",2502805,2501200,1605,1885895,3143158,"RUS",2514527
1,532.0,"Western Africa",552103,0,552103,417438,695730,"NGA",556584
1,532.0,"South America",2211113,1486571,724542,1644215,2740358,"BRA",2192287
1,532.0,"Northern Europe",2196572,1995592,200980,1636416,2727361,"GBR",2181889
1,532.0,"Northern America",671566,671135,431,518751,864586,"CAN",691669
1,532.0,"Oceania",654145,654145,0,491279,818798,"NZL",655039
1,532.0,"Eastern Africa",465447,0,465447,353277,588796,"ETH",471037
1,532.0,"Middle Africa",150912,0,150912,113889,189816,"AGO",151853
1,532.0,"Eastern Europe",3074250,3062414,11836,2298697,3831162,"POL",3064930
1,532.0,"Central Asia",1750578,1747808,2770,1301183,2168638,"UZB",1734911
1,532.0,"Southern Europe",891122,0,891122,675580,1125967,"ITA",900774
1,532.0,"Central America",450625,0,450625,337353,562256,"MEX",449805
1,532.0,"Southern Asia",813828,0,813828,612234,1020391,"IRN",816313
1,532.0,"Western Asia",1646260,0,1646260,1231761,2052936,"IRQ",1642349
1,532.0,"Eastern Asia",1054121,0,1054121,795954,1326591,"JPN",1061273
1,532.0,"Southern Africa",160512,0,160512,120858,201431,"ZAF",161145
1,532.0,"South-Eastern Asia",1409285,0,1409285,1059633,1766055,"IDN",1412844
1,532.0,"Caribbean",163422,0,163422,122337,203895,"CUB",163116
1,533.0,"Pakistan",2023739,2022353,1386,1525824,2543040,"PAK",2034432
1,533.0,"India",7134058,7133757,301,5354195,8923658,"IND",7138927
1,533.0,"Western Europe",4075673,4067971,7702,3048483,5080806,"NLD",4064645
1,533.0,"China",10646082,10044525,601557,7958510,13264183,"CPR",10611347
1,533.0,"United States of America",3156503,3155595,908,2386698,3977830,"USA",3182264
1,533.0,"Northern Africa",1806466,0,1806466,1353072,2255121,"EGY",1804097
1,533.0,"Russian Federation",2537389,2536286,1103,1885895,3143158,"RUS",2514527
1,533.0,"Western Africa",551064,0,551064,417438,695730,"NGA",556584
1,533.0,"South America",2207129,1482946,724183,1644215,2740358,"BRA",2192287
1,533.0,"Northern Europe",2191101,1990440,200661,1636416,2727361,"GBR",2181889
1,533.0,"Northern America",681942,681648,294,518751,864586,"CAN",691669
1,533.0,"Oceania",654415,654415,0,491279,818798,"NZL",655039
1,533.0,"Eastern Africa",467638,0,467638,353277,588796,"ETH",471037
1,533.0,"Middle Africa",150394,0,150394,113889,189816,"AGO",151853
1,533.0,"Eastern Europe",3071523,3059593,11930,2298697,3831162,"POL",3064930
1,533.0,"Central Asia",1713037,1711127,1910,1301183,2168638,"UZB",1734911
1,533.0,"Southern Europe",893190,0,893190,675580,1125967,"ITA",900774
1,533.0,"Central America",445916,0,445916,337353,562256,"MEX",449805
1,533.0,"Southern Asia",818809,0,818809,612234,1020391,"IRN",816313
1,533.0,"Western Asia",1644264,0,1644264,1231761,2052936,"IRQ",1642349
1,533.0,"Eastern Asia",1064495,0,1064495,795954,1326591,"JPN",1061273
1,533.0,"Southern Africa",160610,0,160610,120858,201431,"ZAF",161145
1,533.0,"South-Eastern Asia",1410956,0,1410956,1059633,1766055,"IDN",1412844
1,533.0,"Caribbean",161742,0,161742,122337,203895,"CUB",163116
1,534.0,"Pakistan",2026910,2025365,1545,1525824,2543040,"PAK",2034432
1,534.0,"India",7135500,7135302,198,5354195,8923658,"IND",7138927
1,534.0,"Western Europe",4072176,4065591,6585,3048483,5080806,"NLD",4064645
1,534.0,"China",10635681,10035196,600485,7958510,13264183,"CPR",10611347
1,534.0,"United States of America",3202019,3201427,592,2386698,3977830,"USA",3182264
1,534.0,"Northern Africa",1805733,0,1805733,1353072,2255121,"EGY",1804097
1,534.0,"Russian Federation",2530348,2529630,718,1885895,3143158,"RUS",2514527
1,534.0,"Western Africa",547089,0,547089,417438,695730,"NGA",556584
1,534.0,"South America",2215521,1490140,725381,1644215,2740358,"BRA",2192287
1,534.0,"Northern Europe",2188808,1986997,201811,1636416,2727361,"GBR",2181889
1,534.0,"Northern America",656898,656697,201,518751,864586,"CAN",691669
1,534.0,"Oceania",654605,654605,0,491279,818798,"NZL",655039
1,534.0,"Eastern Africa",461235,0,461235,353277,588796,"ETH",471037
1,534.0,"Middle Africa",149712,0,149712,113889,189816,"AGO",151853
1,534.0,"Eastern Europe",3069185,3058287,10898,2298697,3831162,"POL",3064930
1,534.0,"Central Asia",1752358,1750058,2300,1301183,2168638,"UZB",1734911
1,534.0,"Southern Europe",880647,0,880647,675580,1125967,"ITA",900774
1,534.0,"Central America",450465,0,450465,337353,562256,"MEX",449805
1,534.0,"Southern Asia",817420,0,817420,612234,1020391,"IRN",816313
1,534.0,"Western Asia",1642385,0,1642385,1231761,2052936,"IRQ",1642349
1,534.0,"Eastern Asia",1056483,0,1056483,795954,1326591,"JPN",1061273
1,534.0,"Southern Africa",159883,0,159883,120858,201431,"ZAF",161145
1,534.0,"South-Eastern Asia",1407524,0,1407524,1059633,1766055,"IDN",1412844
1,534.0,"Caribbean",163293,0,163293,122337,203895,"CUB",163116
1,535.0,"Pakistan",2029137,2027370,1767,1525824,2543040,"PAK",2034432
1,535.0,"India",7136532,7136387,145,5354195,8923658,"IND",7138927
1,535.0,"Western Europe",4044558,4038919,5639,3048483,5080806,"NLD",4064645
1,535.0,"China",10626543,10035464,591079,7958510,13264183,"CPR",10611347
1,535.0,"United States of America",3177063,3176625,438,2386698,3977830,"USA",3182264
1,535.0,"Northern Africa",1803702,0,1803702,1353072,2255121,"EGY",1804097
1,535.0,"Russian Federation",2494614,2494087,527,1885895,3143158,"RUS",2514527
1,535.0,"Western Africa",561644,0,561644,417438,695730,"NGA",556584
1,535.0,"South America",2203609,1484426,719183,1644215,2740358,"BRA",2192287
1,535.0,"Northern Europe",2186464,1991195,195269,1636416,2727361,"GBR",2181889
1,535.0,"Northern America",708377,707318,1059,518751,864586,"CAN",691669
1,535.0,"Oceania",654739,654739,0,491279,818798,"NZL",655039
1,535.0,"Eastern Africa",473816,0,473816,353277,588796,"ETH",471037
1,535.0,"Middle Africa",153021,0,153021,113889,189816,"AGO",151853
1,535.0,"Eastern Europe",3087519,3078677,8842,2298697,3831162,"POL",3064930
1,535.0,"Central Asia",1736231,1734331,1900,1301183,2168638,"UZB",1734911
1,535.0,"Southern Europe",907899,0,907899,675580,1125967,"ITA",900774
1,535.0,"Central America",450018,0,450018,337353,562256,"MEX",449805
1,535.0,"Southern Asia",814209,0,814209,612234,1020391,"IRN",816313
1,535.0,"Western Asia",1654145,0,1654145,1231761,2052936,"IRQ",1642349
1,535.0,"Eastern Asia",1060674,0,1060674,795954,1326591,"JPN",1061273
1,535.0,"Southern Africa",161713,0,161713,120858,201431,"ZAF",161145
1,535.0,"South-Eastern Asia",1414876,0,1414876,1059633,1766055,"IDN",1412844
1,535.0,"Caribbean",163254,0,163254,122337,203895,"CUB",163116
1,536.0,"Pakistan",2030681,2028712,1969,1525824,2543040,"PAK",2034432
1,536.0,"India",7137142,7137142,0,5354195,8923658,"IND",7138927
1,536.0,"Western Europe",4050463,4044297,6166,3048483,5080806,"NLD",4064645
1,536.0,"China",10624200,10031381,592819,7958510,13264183,"CPR",10611347
1,536.0,"United States of America",3197366,3196943,423,2386698,3977830,"USA",3182264
1,536.0,"Northern Africa",1802328,0,1802328,1353072,2255121,"EGY",1804097
1,536.0,"Russian Federation",2531615,2530956,659,1885895,3143158,"RUS",2514527
1,536.0,"Western Africa",554243,0,554243,417438,695730,"NGA",556584
1,536.0,"South America",2208096,1488115,719981,1644215,2740358,"BRA",2192287
1,536.0,"Northern Europe",2185293,1988792,196501,1636416,2727361,"GBR",2181889
1,536.0,"Northern America",678657,677937,720,518751,864586,"CAN",691669
1,536.0,"Oceania",654830,654830,0,491279,818798,"NZL",655039
1,536.0,"Eastern Africa",467329,0,467329,353277,588796,"ETH",471037
1,536.0,"Middle Africa",151331,0,151331,113889,189816,"AGO",151853
1,536.0,"Eastern Europe",3080545,3072398,8147,2298697,3831162,"POL",3064930
1,536.0,"Central Asia",1735817,1734052,1765,1301183,2168638,"UZB",1734911
1,536.0,"Southern Europe",892392,0,892392,675580,1125967,"ITA",900774
1,536.0,"Central America",451059,0,451059,337353,562256,"MEX",449805
1,536.0,"Southern Asia",818589,0,818589,612234,1020391,"IRN",816313
1,536.0,"Western Asia",1649302,0,1649302,1231761,2052936,"IRQ",1642349
1,536.0,"Eastern Asia",1063436,0,1063436,795954,1326591,"JPN",1061273
1,536.0,"Southern Africa",160755,0,160755,120858,201431,"ZAF",161145
1,536.0,"South-Eastern Asia",1410822,0,1410822,1059633,1766055,"IDN",1412844
1,536.0,"Caribbean",163547,0,163547,122337,203895,"CUB",163116
1,537.0,"Pakistan",2031800,2029591,2209,1525824,2543040,"PAK",2034432
1,537.0,"India",7137778,7137677,101,5354195,8923658,"IND",7138927
1,537.0,"Western Europe",4054885,4048503,6382,3048483,5080806,"NLD",4064645
1,537.0,"China",10619418,10027925,591493,7958510,13264183,"CPR",10611347
1,537.0,"United States of America",3155279,3154969,310,2386698,3977830,"USA",3182264
1,537.0,"Northern Africa",1798631,0,1798631,1353072,2255121,"EGY",1804097
1,537.0,"Russian Federation",2495482,2494995,487,1885895,3143158,"RUS",2514527
1,537.0,"Western Africa",567038,0,567038,417438,695730,"NGA",556584
1,537.0,"South America",2213636,1485050,728586,1644215,2740358,"BRA",2192287
1,537.0,"Northern Europe",2184335,1986961,197374,1636416,2727361,"GBR",2181889
1,537.0,"Northern America",735701,734817,884,518751,864586,"CAN",691669
1,537.0,"Oceania",659004,658904,100,491279,818798,"NZL",655039
1,537.0,"Eastern Africa",479935,0,479935,353277,588796,"ETH",471037
1,537.0,"Middle Africa",154322,0,154322,113889,189816,"AGO",151853
1,537.0,"Eastern Europe",3037567,3031207,6360,2298697,3831162,"POL",3064930
1,537.0,"Central Asia",1724633,1723060,1573,1301183,2168638,"UZB",1734911
1,537.0,"Southern Europe",922304,0,922304,675580,1125967,"ITA",900774
1,537.0,"Central America",448658,0,448658,337353,562256,"MEX",449805
1,537.0,"Southern Asia",813870,0,813870,612234,1020391,"IRN",816313
1,537.0,"Western Asia",1633133,0,1633133,1231761,2052936,"IRQ",1642349
1,537.0,"Eastern Asia",1064051,0,1064051,795954,1326591,"JPN",1061273
1,537.0,"Southern Africa",163149,0,163149,120858,201431,"ZAF",161145
1,537.0,"South-Eastern Asia",1426690,0,1426690,1059633,1766055,"IDN",1412844
1,537.0,"Caribbean",162828,0,162828,122337,203895,"CUB",163116
1,538.0,"Pakistan",2045580,2042663,2917,1525824,2543040,"PAK",2034432
1,538.0,"India",7138134,7137738,396,5354195,8923658,"IND",7138927
1,538.0,"Western Europe",4058600,4051394,7206,3048483,5080806,"NLD",4064645
1,538.0,"China",10617548,10025753,591795,7958510,13264183,"CPR",10611347
1,538.0,"United States of America",3219859,3218969,890,2386698,3977830,"USA",3182264
1,538.0,"Northern Africa",1798740,0,1798740,1353072,2255121,"EGY",1804097
1,538.0,"Russian Federation",2516744,2515613,1131,1885895,3143158,"RUS",2514527
1,538.0,"Western Africa",556398,0,556398,417438,695730,"NGA",556584
1,538.0,"South America",2204556,1485396,719160,1644215,2740358,"BRA",2192287
1,538.0,"Northern Europe",2184669,1984804,199865,1636416,2727361,"GBR",2181889
1,538.0,"Northern America",676924,676322,602,518751,864586,"CAN",691669
1,538.0,"Oceania",657686,657686,0,491279,818798,"NZL",655039
1,538.0,"Eastern Africa",467187,0,467187,353277,588796,"ETH",471037
1,538.0,"Middle Africa",151926,0,151926,113889,189816,"AGO",151853
1,538.0,"Eastern Europe",3045417,3038798,6619,2298697,3831162,"POL",3064930
1,538.0,"Central Asia",1727658,1725604,2054,1301183,2168638,"UZB",1734911
1,538.0,"Southern Europe",895042,0,895042,675580,1125967,"ITA",900774
1,538.0,"Central America",453749,0,453749,337353,562256,"MEX",449805
1,538.0,"Southern Asia",815758,0,815758,612234,1020391,"IRN",816313
1,538.0,"Western Asia",1632257,0,1632257,1231761,2052936,"IRQ",1642349
1,538.0,"Eastern Asia",1059632,0,1059632,795954,1326591,"JPN",1061273
1,538.0,"Southern Africa",161393,0,161393,120858,201431,"ZAF",161145
1,538.0,"South-Eastern Asia",1416560,0,1416560,1059633,1766055,"IDN",1412844
1,538.0,"Caribbean",164453,0,164453,122337,203895,"CUB",163116
1,539.0,"Pakistan",2042285,2039716,2569,1525824,2543040,"PAK",2034432
1,539.0,"India",7138366,7138092,274,5354195,8923658,"IND",7138927
1,539.0,"Western Europe",4086030,4078170,7860,3048483,5080806,"NLD",4064645
1,539.0,"China",10616733,10021529,595204,7958510,13264183,"CPR",10611347
1,539.0,"United States of America",3133289,3132674,615,2386698,3977830,"USA",3182264
1,539.0,"Northern Africa",1810178,0,1810178,1353072,2255121,"EGY",1804097
1,539.0,"Russian Federation",2516067,2515282,785,1885895,3143158,"RUS",2514527
1,539.0,"Western Africa",551831,0,551831,417438,695730,"NGA",556584
1,539.0,"South America",2196888,1485261,711627,1644215,2740358,"BRA",2192287
1,539.0,"Northern Europe",2194534,1995532,199002,1636416,2727361,"GBR",2181889
1,539.0,"Northern America",693649,693060,589,518751,864586,"CAN",691669
1,539.0,"Oceania",656870,656870,0,491279,818798,"NZL",655039
1,539.0,"Eastern Africa",470858,0,470858,353277,588796,"ETH",471037
1,539.0,"Middle Africa",150528,0,150528,113889,189816,"AGO",151853
1,539.0,"Eastern Europe",3070643,3063270,7373,2298697,3831162,"POL",3064930
1,539.0,"Central Asia",1762738,1761034,1704,1301183,2168638,"UZB",1734911
1,539.0,"Southern Europe",900578,0,900578,675580,1125967,"ITA",900774
1,539.0,"Central America",443791,0,443791,337353,562256,"MEX",449805
1,539.0,"Southern Asia",820001,0,820001,612234,1020391,"IRN",816313
1,539.0,"Western Asia",1648561,0,1648561,1231761,2052936,"IRQ",1642349
1,539.0,"Eastern Asia",1060059,0,1060059,795954,1326591,"JPN",1061273
1,539.0,"Southern Africa",161227,0,161227,120858,201431,"ZAF",161145
1,539.0,"South-Eastern Asia",1417259,0,1417259,1059633,1766055,"IDN",1412844
1,539.0,"Caribbean",160922,0,160922,122337,203895,"CUB",163116
1,540.0,"Pakistan",2039927,2037631,2296,1525824,2543040,"PAK",2034432
1,540.0,"India",7138517,7138342,175,5354195,8923658,"IND",7138927
1,540.0,"Western Europe",4053878,4047015,6863,3048483,5080806,"NLD",4064645
1,540.0,"China",10613904,10021518,592386,7958510,13264183,"CPR",10611347
1,540.0,"United States of America",3204821,3204156,665,2386698,3977830,"USA",3182264
1,540.0,"Northern Africa",1800445,0,1800445,1353072,2255121,"EGY",1804097
1,540.0,"Russian Federation",2515560,2514811,749,1885895,3143158,"RUS",2514527
1,540.0,"Western Africa",549690,0,549690,417438,695730,"NGA",556584
1,540.0,"South America",2194070,1485051,709019,1644215,2740358,"BRA",2192287
1,540.0,"Northern Europe",2192209,1992124,200085,1636416,2727361,"GBR",2181889
1,540.0,"Northern America",660871,660460,411,518751,864586,"CAN",691669
1,540.0,"Oceania",656307,656307,0,491279,818798,"NZL",655039
1,540.0,"Eastern Africa",463568,0,463568,353277,588796,"ETH",471037
1,540.0,"Middle Africa",150129,0,150129,113889,189816,"AGO",151853
1,540.0,"Eastern Europe",3068681,3061669,7012,2298697,3831162,"POL",3064930
1,540.0,"Central Asia",1754316,1753191,1125,1301183,2168638,"UZB",1734911
1,540.0,"Southern Europe",883033,0,883033,675580,1125967,"ITA",900774
1,540.0,"Central America",450410,0,450410,337353,562256,"MEX",449805
1,540.0,"Southern Asia",815683,0,815683,612234,1020391,"IRN",816313
1,540.0,"Western Asia",1642173,0,1642173,1231761,2052936,"IRQ",1642349
1,540.0,"Eastern Asia",1054046,0,1054046,795954,1326591,"JPN",1061273
1,540.0,"Southern Africa",160353,0,160353,120858,201431,"ZAF",161145
1,540.0,"South-Eastern Asia",1410983,0,1410983,1059633,1766055,"IDN",1412844
1,540.0,"Caribbean",163295,0,163295,122337,203895,"CUB",163116
1,541.0,"Pakistan",2038250,2036166,2084,1525824,2543040,"PAK",2034432
1,541.0,"India",7138652,7138519,133,5354195,8923658,"IND",7138927
1,541.0,"Western Europe",4082865,4076783,6082,3048483,5080806,"NLD",4064645
1,541.0,"China",10612103,10025571,586532,7958510,13264183,"CPR",10611347
1,541.0,"United States of America",3141646,3141146,500,2386698,3977830,"USA",3182264
1,541.0,"Northern Africa",1806463,0,1806463,1353072,2255121,"EGY",1804097
1,541.0,"Russian Federation",2499801,2499234,567,1885895,3143158,"RUS",2514527
1,541.0,"Western Africa",563643,0,563643,417438,695730,"NGA",556584
1,541.0,"South America",2201349,1484375,716974,1644215,2740358,"BRA",2192287
1,541.0,"Northern Europe",2188408,1994515,193893,1636416,2727361,"GBR",2181889
1,541.0,"Northern America",731446,730361,1085,518751,864586,"CAN",691669
1,541.0,"Oceania",656016,655916,100,491279,818798,"NZL",655039
1,541.0,"Eastern Africa",478713,0,478713,353277,588796,"ETH",471037
1,541.0,"Middle Africa",153592,0,153592,113889,189816,"AGO",151853
1,541.0,"Eastern Europe",3048434,3042836,5598,2298697,3831162,"POL",3064930
1,541.0,"Central Asia",1715815,1714998,817,1301183,2168638,"UZB",1734911
1,541.0,"Southern Europe",920992,0,920992,675580,1125967,"ITA",900774
1,541.0,"Central America",446897,0,446897,337353,562256,"MEX",449805
1,541.0,"Southern Asia",815986,0,815986,612234,1020391,"IRN",816313
1,541.0,"Western Asia",1638547,0,1638547,1231761,2052936,"IRQ",1642349
1,541.0,"Eastern Asia",1064793,0,1064793,795954,1326591,"JPN",1061273
1,541.0,"Southern Africa",162269,0,162269,120858,201431,"ZAF",161145
1,541.0,"South-Eastern Asia",1420768,0,1420768,1059633,1766055,"IDN",1412844
1,541.0,"Caribbean",162181,0,162181,122337,203895,"CUB",163116
1,542.0,"Pakistan",2050058,2047977,2081,1525824,2543040,"PAK",2034432
1,542.0,"India",7138735,7138390,345,5354195,8923658,"IND",7138927
1,542.0,"Western Europe",4077209,4071401,5808,3048483,5080806,"NLD",4064645
1,542.0,"China",10612185,10025479,586706,7958510,13264183,"CPR",10611347
1,542.0,"United States of America",3229350,3228296,1054,2386698,3977830,"USA",3182264
1,542.0,"Northern Africa",1804169,0,1804169,1353072,2255121,"EGY",1804097
1,542.0,"Russian Federation",2519747,2518634,1113,1885895,3143158,"RUS",2514527
1,542.0,"Western Africa",554159,0,554159,417438,695730,"NGA",556584
1,542.0,"South America",2206466,1490687,715779,1644215,2740358,"BRA",2192287
1,542.0,"Northern Europe",2189378,1992755,196623,1636416,2727361,"GBR",2181889
1,542.0,"Northern America",666123,665378,745,518751,864586,"CAN",691669
1,542.0,"Oceania",655646,655646,0,491279,818798,"NZL",655039
1,542.0,"Eastern Africa",464980,0,464980,353277,588796,"ETH",471037
1,542.0,"Middle Africa",151342,0,151342,113889,189816,"AGO",151853
1,542.0,"Eastern Europe",3053126,3046978,6148,2298697,3831162,"POL",3064930
1,542.0,"Central Asia",1721447,1720091,1356,1301183,2168638,"UZB",1734911
1,542.0,"Southern Europe",890150,0,890150,675580,1125967,"ITA",900774
1,542.0,"Central America",454444,0,454444,337353,562256,"MEX",449805
1,542.0,"Southern Asia",815033,0,815033,612234,1020391,"IRN",816313
1,542.0,"Western Asia",1633551,0,1633551,1231761,2052936,"IRQ",1642349
1,542.0,"Eastern Asia",1058360,0,1058360,795954,1326591,"JPN",1061273
1,542.0,"Southern Africa",160451,0,160451,120858,201431,"ZAF",161145
1,542.0,"South-Eastern Asia",1410653,0,1410653,1059633,1766055,"IDN",1412844
1,542.0,"Caribbean",164613,0,164613,122337,203895,"CUB",163116
1,543.0,"Pakistan",2032537,2031048,1489,1525824,2543040,"PAK",2034432
1,543.0,"India",7138803,7138548,255,5354195,8923658,"IND",7138927
1,543.0,"Western Europe",4073593,4068498,5095,3048483,5080806,"NLD",4064645
1,543.0,"China",10612072,10022838,589234,7958510,13264183,"CPR",10611347
1,543.0,"United States of America",3120975,3120194,781,2386698,3977830,"USA",3182264
1,543.0,"Northern Africa",1805972,0,1805972,1353072,2255121,"EGY",1804097
1,543.0,"Russian Federation",2502706,2501876,830,1885895,3143158,"RUS",2514527
1,543.0,"Western Africa",561191,0,561191,417438,695730,"NGA",556584
1,543.0,"South America",2206053,1487913,718140,1644215,2740358,"BRA",2192287
1,543.0,"Northern Europe",2184762,1990734,194028,1636416,2727361,"GBR",2181889
1,543.0,"Northern America",730695,729462,1233,518751,864586,"CAN",691669
1,543.0,"Oceania",655461,655461,0,491279,818798,"NZL",655039
1,543.0,"Eastern Africa",478347,0,478347,353277,588796,"ETH",471037
1,543.0,"Middle Africa",152903,0,152903,113889,189816,"AGO",151853
1,543.0,"Eastern Europe",3056947,3050452,6495,2298697,3831162,"POL",3064930
1,543.0,"Central Asia",1736499,1735014,1485,1301183,2168638,"UZB",1734911
1,543.0,"Southern Europe",918574,0,918574,675580,1125967,"ITA",900774
1,543.0,"Central America",444730,0,444730,337353,562256,"MEX",449805
1,543.0,"Southern Asia",817409,0,817409,612234,1020391,"IRN",816313
1,543.0,"Western Asia",1642483,0,1642483,1231761,2052936,"IRQ",1642349
1,543.0,"Eastern Asia",1063817,0,1063817,795954,1326591,"JPN",1061273
1,543.0,"Southern Africa",162153,0,162153,120858,201431,"ZAF",161145
1,543.0,"South-Eastern Asia",1420537,0,1420537,1059633,1766055,"IDN",1412844
1,543.0,"Caribbean",161223,0,161223,122337,203895,"CUB",163116
1,544.0,"Pakistan",2033116,2031404,1712,1525824,2543040,"PAK",2034432
1,544.0,"India",7138851,7138302,549,5354195,8923658,"IND",7138927
1,544.0,"Western Europe",4045357,4040132,5225,3048483,5080806,"NLD",4064645
1,544.0,"China",10610933,10021889,589044,7958510,13264183,"CPR",10611347
1,544.0,"United States of America",3233974,3232459,1515,2386698,3977830,"USA",3182264
1,544.0,"Northern Africa",1800313,0,1800313,1353072,2255121,"EGY",1804097
1,544.0,"Russian Federation",2506286,2504809,1477,1885895,3143158,"RUS",2514527
1,544.0,"Western Africa",560997,0,560997,417438,695730,"NGA",556584
1,544.0,"South America",2207058,1485220,721838,1644215,2740358,"BRA",2192287
1,544.0,"Northern Europe",2144595,1985241,159354,1636416,2727361,"GBR",2181889
1,544.0,"Northern America",685778,684919,859,518751,864586,"CAN",691669
1,544.0,"Oceania",655331,655331,0,491279,818798,"NZL",655039
1,544.0,"Eastern Africa",469765,0,469765,353277,588796,"ETH",471037
1,544.0,"Middle Africa",153132,0,153132,113889,189816,"AGO",151853
1,544.0,"Eastern Europe",3059184,3052056,7128,2298697,3831162,"POL",3064930
1,544.0,"Central Asia",1725091,1723149,1942,1301183,2168638,"UZB",1734911
1,544.0,"Southern Europe",899956,0,899956,675580,1125967,"ITA",900774
1,544.0,"Central America",456188,0,456188,337353,562256,"MEX",449805
1,544.0,"Southern Asia",813418,0,813418,612234,1020391,"IRN",816313
1,544.0,"Western Asia",1638762,0,1638762,1231761,2052936,"IRQ",1642349
1,544.0,"Eastern Asia",1059805,0,1059805,795954,1326591,"JPN",1061273
1,544.0,"Southern Africa",161345,0,161345,120858,201431,"ZAF",161145
1,544.0,"South-Eastern Asia",1413471,0,1413471,1059633,1766055,"IDN",1412844
1,544.0,"Caribbean",165460,0,165460,122337,203895,"CUB",163116
1,545.0,"Pakistan",2033439,2032099,1340,1525824,2543040,"PAK",2034432
1,545.0,"India",7138841,7138488,353,5354195,8923658,"IND",7138927
1,545.0,"Western Europe",4076490,4070579,5911,3048483,5080806,"NLD",4064645
1,545.0,"China",10613409,10019353,594056,7958510,13264183,"CPR",10611347
1,545.0,"United States of America",3217217,3216250,967,2386698,3977830,"USA",3182264
1,545.0,"Northern Africa",1804844,0,1804844,1353072,2255121,"EGY",1804097
1,545.0,"Russian Federation",2539788,2538312,1476,1885895,3143158,"RUS",2514527
1,545.0,"Western Africa",547923,0,547923,417438,695730,"NGA",556584
1,545.0,"South America",2196366,1486089,710277,1644215,2740358,"BRA",2192287
1,545.0,"Northern Europe",2155208,1993107,162101,1636416,2727361,"GBR",2181889
1,545.0,"Northern America",651793,651211,582,518751,864586,"CAN",691669
1,545.0,"Oceania",659227,659227,0,491279,818798,"NZL",655039
1,545.0,"Eastern Africa",462285,0,462285,353277,588796,"ETH",471037
1,545.0,"Middle Africa",149788,0,149788,113889,189816,"AGO",151853
1,545.0,"Eastern Europe",3060646,3053040,7606,2298697,3831162,"POL",3064930
1,545.0,"Central Asia",1738890,1737014,1876,1301183,2168638,"UZB",1734911
1,545.0,"Southern Europe",880930,0,880930,675580,1125967,"ITA",900774
1,545.0,"Central America",452018,0,452018,337353,562256,"MEX",449805
1,545.0,"Southern Asia",817380,0,817380,612234,1020391,"IRN",816313
1,545.0,"Western Asia",1636674,0,1636674,1231761,2052936,"IRQ",1642349
1,545.0,"Eastern Asia",1059931,0,1059931,795954,1326591,"JPN",1061273
1,545.0,"Southern Africa",160466,0,160466,120858,201431,"ZAF",161145
1,545.0,"South-Eastern Asia",1414719,0,1414719,1059633,1766055,"IDN",1412844
1,545.0,"Caribbean",163905,0,163905,122337,203895,"CUB",163116
1,546.0,"Pakistan",2033764,2032589,1175,1525824,2543040,"PAK",2034432
1,546.0,"India",7138885,7138620,265,5354195,8923658,"IND",7138927
1,546.0,"Western Europe",4073136,4067876,5260,3048483,5080806,"NLD",4064645
1,546.0,"China",10610411,10021878,588533,7958510,13264183,"CPR",10611347
1,546.0,"United States of America",3150202,3149475,727,2386698,3977830,"USA",3182264
1,546.0,"Northern Africa",1809623,0,1809623,1353072,2255121,"EGY",1804097
1,546.0,"Russian Federation",2501146,2500040,1106,1885895,3143158,"RUS",2514527
1,546.0,"Western Africa",562187,0,562187,417438,695730,"NGA",556584
1,546.0,"South America",2201200,1487349,713851,1644215,2740358,"BRA",2192287
1,546.0,"Northern Europe",2162632,2000284,162348,1636416,2727361,"GBR",2181889
1,546.0,"Northern America",720797,719192,1605,518751,864586,"CAN",691669
1,546.0,"Oceania",653954,653954,0,491279,818798,"NZL",655039
1,546.0,"Eastern Africa",476624,0,476624,353277,588796,"ETH",471037
1,546.0,"Middle Africa",153104,0,153104,113889,189816,"AGO",151853
1,546.0,"Eastern Europe",3062195,3055367,6828,2298697,3831162,"POL",3064930
1,546.0,"Central Asia",1726722,1725260,1462,1301183,2168638,"UZB",1734911
1,546.0,"Southern Europe",916314,0,916314,675580,1125967,"ITA",900774
1,546.0,"Central America",447268,0,447268,337353,562256,"MEX",449805
1,546.0,"Southern Asia",815816,0,815816,612234,1020391,"IRN",816313
1,546.0,"Western Asia",1643499,0,1643499,1231761,2052936,"IRQ",1642349
1,546.0,"Eastern Asia",1062848,0,1062848,795954,1326591,"JPN",1061273
1,546.0,"Southern Africa",162057,0,162057,120858,201431,"ZAF",161145
1,546.0,"South-Eastern Asia",1416202,0,1416202,1059633,1766055,"IDN",1412844
1,546.0,"Caribbean",162301,0,162301,122337,203895,"CUB",163116
1,547.0,"Pakistan",2033936,2032706,1230,1525824,2543040,"PAK",2034432
1,547.0,"India",7138884,7138564,320,5354195,8923658,"IND",7138927
1,547.0,"Western Europe",4095923,4090933,4990,3048483,5080806,"NLD",4064645
1,547.0,"China",10612559,10021291,591268,7958510,13264183,"CPR",10611347
1,547.0,"United States of America",3216292,3215249,1043,2386698,3977830,"USA",3182264
1,547.0,"Northern Africa",1811464,0,1811464,1353072,2255121,"EGY",1804097
1,547.0,"Russian Federation",2536165,2534695,1470,1885895,3143158,"RUS",2514527
1,547.0,"Western Africa",551487,0,551487,417438,695730,"NGA",556584
1,547.0,"South America",2196086,1485680,710406,1644215,2740358,"BRA",2192287
1,547.0,"Northern Europe",2169338,2003252,166086,1636416,2727361,"GBR",2181889
1,547.0,"Northern America",663116,662018,1098,518751,864586,"CAN",691669
1,547.0,"Oceania",654284,654284,0,491279,818798,"NZL",655039
1,547.0,"Eastern Africa",464867,0,464867,353277,588796,"ETH",471037
1,547.0,"Middle Africa",150698,0,150698,113889,189816,"AGO",151853
1,547.0,"Eastern Europe",3062735,3055807,6928,2298697,3831162,"POL",3064930
1,547.0,"Central Asia",1729080,1727270,1810,1301183,2168638,"UZB",1734911
1,547.0,"Southern Europe",888770,0,888770,675580,1125967,"ITA",900774
1,547.0,"Central America",452264,0,452264,337353,562256,"MEX",449805
1,547.0,"Southern Asia",817146,0,817146,612234,1020391,"IRN",816313
1,547.0,"Western Asia",1638374,0,1638374,1231761,2052936,"IRQ",1642349
1,547.0,"Eastern Asia",1062070,0,1062070,795954,1326591,"JPN",1061273
1,547.0,"Southern Africa",159874,0,159874,120858,201431,"ZAF",161145
1,547.0,"South-Eastern Asia",1406858,0,1406858,1059633,1766055,"IDN",1412844
1,547.0,"Caribbean",163877,0,163877,122337,203895,"CUB",163116
1,548.0,"Pakistan",2034113,2033075,1038,1525824,2543040,"PAK",2034432
1,548.0,"India",7138911,7138672,239,5354195,8923658,"IND",7138927
1,548.0,"Western Europe",4035756,4031466,4290,3048483,5080806,"NLD",4064645
1,548.0,"China",10610514,10020968,589546,7958510,13264183,"CPR",10611347
1,548.0,"United States of America",3168182,3167403,779,2386698,3977830,"USA",3182264
1,548.0,"Northern Africa",1795312,0,1795312,1353072,2255121,"EGY",1804097
1,548.0,"Russian Federation",2498657,2497560,1097,1885895,3143158,"RUS",2514527
1,548.0,"Western Africa",566474,0,566474,417438,695730,"NGA",556584
1,548.0,"South America",2201038,1484129,716909,1644215,2740358,"BRA",2192287
1,548.0,"Northern Europe",2172546,2004614,167932,1636416,2727361,"GBR",2181889
1,548.0,"Northern America",728712,726932,1780,518751,864586,"CAN",691669
1,548.0,"Oceania",654518,654518,0,491279,818798,"NZL",655039
1,548.0,"Eastern Africa",477687,0,477687,353277,588796,"ETH",471037
1,548.0,"Middle Africa",154261,0,154261,113889,189816,"AGO",151853
1,548.0,"Eastern Europe",3044179,3037656,6523,2298697,3831162,"POL",3064930
1,548.0,"Central Asia",1741863,1740220,1643,1301183,2168638,"UZB",1734911
1,548.0,"Southern Europe",918218,0,918218,675580,1125967,"ITA",900774
1,548.0,"Central America",450546,0,450546,337353,562256,"MEX",449805
1,548.0,"Southern Asia",817436,0,817436,612234,1020391,"IRN",816313
1,548.0,"Western Asia",1636486,0,1636486,1231761,2052936,"IRQ",1642349
1,548.0,"Eastern Asia",1063773,0,1063773,795954,1326591,"JPN",1061273
1,548.0,"Southern Africa",162602,0,162602,120858,201431,"ZAF",161145
1,548.0,"South-Eastern Asia",1418481,0,1418481,1059633,1766055,"IDN",1412844
1,548.0,"Caribbean",163358,0,163358,122337,203895,"CUB",163116
1,549.0,"Pakistan",2034227,2032890,1337,1525824,2543040,"PAK",2034432
1,549.0,"India",7138925,7138463,462,5354195,8923658,"IND",7138927
1,549.0,"Western Europe",4018854,4013529,5325,3048483,5080806,"NLD",4064645
1,549.0,"China",10611849,10018325,593524,7958510,13264183,"CPR",10611347
1,549.0,"United States of America",3209901,3208686,1215,2386698,3977830,"USA",3182264
1,549.0,"Northern Africa",1793970,0,1793970,1353072,2255121,"EGY",1804097
1,549.0,"Russian Federation",2518971,2517296,1675,1885895,3143158,"RUS",2514527
1,549.0,"Western Africa",560272,0,560272,417438,695730,"NGA",556584
1,549.0,"South America",2206820,1490467,716353,1644215,2740358,"BRA",2192287
1,549.0,"Northern Europe",2175602,2004790,170812,1636416,2727361,"GBR",2181889
1,549.0,"Northern America",692391,691185,1206,518751,864586,"CAN",691669
1,549.0,"Oceania",654680,654680,0,491279,818798,"NZL",655039
1,549.0,"Eastern Africa",471267,0,471267,353277,588796,"ETH",471037
1,549.0,"Middle Africa",152906,0,152906,113889,189816,"AGO",151853
1,549.0,"Eastern Europe",3069746,3061749,7997,2298697,3831162,"POL",3064930
1,549.0,"Central Asia",1728836,1726753,2083,1301183,2168638,"UZB",1734911
1,549.0,"Southern Europe",900610,0,900610,675580,1125967,"ITA",900774
1,549.0,"Central America",453446,0,453446,337353,562256,"MEX",449805
1,549.0,"Southern Asia",816633,0,816633,612234,1020391,"IRN",816313
1,549.0,"Western Asia",1645109,0,1645109,1231761,2052936,"IRQ",1642349
1,549.0,"Eastern Asia",1064446,0,1064446,795954,1326591,"JPN",1061273
1,549.0,"Southern Africa",161384,0,161384,120858,201431,"ZAF",161145
1,549.0,"South-Eastern Asia",1413071,0,1413071,1059633,1766055,"IDN",1412844
1,549.0,"Caribbean",164512,0,164512,122337,203895,"CUB",163116
1,550.0,"Pakistan",2034248,2032951,1297,1525824,2543040,"PAK",2034432
1,550.0,"India",7138902,7138605,297,5354195,8923658,"IND",7138927
1,550.0,"Western Europe",4109059,4102672,6387,3048483,5080806,"NLD",4064645
1,550.0,"China",10612398,10015363,597035,7958510,13264183,"CPR",10611347
1,550.0,"United States of America",3182370,3181585,785,2386698,3977830,"USA",3182264
1,550.0,"Northern Africa",1820030,0,1820030,1353072,2255121,"EGY",1804097
1,550.0,"Russian Federation",2517554,2515872,1682,1885895,3143158,"RUS",2514527
1,550.0,"Western Africa",548238,0,548238,417438,695730,"NGA",556584
1,550.0,"South America",2143547,1485552,657995,1644215,2740358,"BRA",2192287
1,550.0,"Northern Europe",2190630,2017392,173238,1636416,2727361,"GBR",2181889
1,550.0,"Northern America",664234,663423,811,518751,864586,"CAN",691669
1,550.0,"Oceania",658772,658772,0,491279,818798,"NZL",655039
1,550.0,"Eastern Africa",465556,0,465556,353277,588796,"ETH",471037
1,550.0,"Middle Africa",149593,0,149593,113889,189816,"AGO",151853
1,550.0,"Eastern Europe",3087667,3079194,8473,2298697,3831162,"POL",3064930
1,550.0,"Central Asia",1774510,1772156,2354,1301183,2168638,"UZB",1734911
1,550.0,"Southern Europe",887731,0,887731,675580,1125967,"ITA",900774
1,550.0,"Central America",448188,0,448188,337353,562256,"MEX",449805
1,550.0,"Southern Asia",817407,0,817407,612234,1020391,"IRN",816313
1,550.0,"Western Asia",1652203,0,1652203,1231761,2052936,"IRQ",1642349
1,550.0,"Eastern Asia",1056480,0,1056480,795954,1326591,"JPN",1061273
1,550.0,"Southern Africa",160638,0,160638,120858,201431,"ZAF",161145
1,550.0,"South-Eastern Asia",1415564,0,1415564,1059633,1766055,"IDN",1412844
1,550.0,"Caribbean",162547,0,162547,122337,203895,"CUB",163116
1,551.0,"Pakistan",2034417,2033007,1410,1525824,2543040,"PAK",2034432
1,551.0,"India",7138920,7138698,222,5354195,8923658,"IND",7138927
1,551.0,"Western Europe",4070340,4064948,5392,3048483,5080806,"NLD",4064645
1,551.0,"China",10610828,10012588,598240,7958510,13264183,"CPR",10611347
1,551.0,"United States of America",3163812,3163231,581,2386698,3977830,"USA",3182264
1,551.0,"Northern Africa",1810375,0,1810375,1353072,2255121,"EGY",1804097
1,551.0,"Russian Federation",2501215,2499969,1246,1885895,3143158,"RUS",2514527
1,551.0,"Western Africa",563489,0,563489,417438,695730,"NGA",556584
1,551.0,"South America",2167064,1490015,677049,1644215,2740358,"BRA",2192287
1,551.0,"Northern Europe",2188542,2013481,175061,1636416,2727361,"GBR",2181889
1,551.0,"Northern America",725279,724120,1159,518751,864586,"CAN",691669
1,551.0,"Oceania",653639,653639,0,491279,818798,"NZL",655039
1,551.0,"Eastern Africa",477017,0,477017,353277,588796,"ETH",471037
1,551.0,"Middle Africa",154126,0,154126,113889,189816,"AGO",151853
1,551.0,"Eastern Europe",3081097,3073596,7501,2298697,3831162,"POL",3064930
1,551.0,"Central Asia",1718959,1717245,1714,1301183,2168638,"UZB",1734911
1,551.0,"Southern Europe",918246,0,918246,675580,1125967,"ITA",900774
1,551.0,"Central America",449297,0,449297,337353,562256,"MEX",449805
1,551.0,"Southern Asia",814700,0,814700,612234,1020391,"IRN",816313
1,551.0,"Western Asia",1653062,0,1653062,1231761,2052936,"IRQ",1642349
1,551.0,"Eastern Asia",1064006,0,1064006,795954,1326591,"JPN",1061273
1,551.0,"Southern Africa",162512,0,162512,120858,201431,"ZAF",161145
1,551.0,"South-Eastern Asia",1416605,0,1416605,1059633,1766055,"IDN",1412844
1,551.0,"Caribbean",163023,0,163023,122337,203895,"CUB",163116
1,552.0,"Pakistan",2034323,2032797,1526,1525824,2543040,"PAK",2034432
1,552.0,"India",7138925,7138491,434,5354195,8923658,"IND",7138927
1,552.0,"Western Europe",4069372,4063249,6123,3048483,5080806,"NLD",4064645
1,552.0,"China",10612195,10009914,602281,7958510,13264183,"CPR",10611347
1,552.0,"United States of America",3225485,3224479,1006,2386698,3977830,"USA",3182264
1,552.0,"Northern Africa",1802942,0,1802942,1353072,2255121,"EGY",1804097
1,552.0,"Russian Federation",2520727,2518941,1786,1885895,3143158,"RUS",2514527
1,552.0,"Western Africa",556444,0,556444,417438,695730,"NGA",556584
1,552.0,"South America",2173629,1489457,684172,1644215,2740358,"BRA",2192287
1,552.0,"Northern Europe",2187476,2009569,177907,1636416,2727361,"GBR",2181889
1,552.0,"Northern America",678226,677437,789,518751,864586,"CAN",691669
1,552.0,"Oceania",658050,658050,0,491279,818798,"NZL",655039
1,552.0,"Eastern Africa",468365,0,468365,353277,588796,"ETH",471037
1,552.0,"Middle Africa",152065,0,152065,113889,189816,"AGO",151853
1,552.0,"Eastern Europe",3056798,3049427,7371,2298697,3831162,"POL",3064930
1,552.0,"Central Asia",1723641,1721406,2235,1301183,2168638,"UZB",1734911
1,552.0,"Southern Europe",895887,0,895887,675580,1125967,"ITA",900774
1,552.0,"Central America",454450,0,454450,337353,562256,"MEX",449805
1,552.0,"Southern Asia",816208,0,816208,612234,1020391,"IRN",816313
1,552.0,"Western Asia",1636887,0,1636887,1231761,2052936,"IRQ",1642349
1,552.0,"Eastern Asia",1063204,0,1063204,795954,1326591,"JPN",1061273
1,552.0,"Southern Africa",161236,0,161236,120858,201431,"ZAF",161145
1,552.0,"South-Eastern Asia",1416849,0,1416849,1059633,1766055,"IDN",1412844
1,552.0,"Caribbean",164749,0,164749,122337,203895,"CUB",163116
1,553.0,"Pakistan",2034328,2033162,1166,1525824,2543040,"PAK",2034432
1,553.0,"India",7138918,7138620,298,5354195,8923658,"IND",7138927
1,553.0,"Western Europe",4093405,4086715,6690,3048483,5080806,"NLD",4064645
1,553.0,"China",10679019,10072979,606040,7958510,13264183,"CPR",10611347
1,553.0,"United States of America",3118827,3118146,681,2386698,3977830,"USA",3182264
1,553.0,"Northern Africa",1812511,0,1812511,1353072,2255121,"EGY",1804097
1,553.0,"Russian Federation",2518814,2517600,1214,1885895,3143158,"RUS",2514527
1,553.0,"Western Africa",547122,0,547122,417438,695730,"NGA",556584
1,553.0,"South America",2169197,1487838,681359,1644215,2740358,"BRA",2192287
1,553.0,"Northern Europe",2183712,2006093,177619,1636416,2727361,"GBR",2181889
1,553.0,"Northern America",682497,681724,773,518751,864586,"CAN",691669
1,553.0,"Oceania",657119,657119,0,491279,818798,"NZL",655039
1,553.0,"Eastern Africa",469471,0,469471,353277,588796,"ETH",471037
1,553.0,"Middle Africa",149284,0,149284,113889,189816,"AGO",151853
1,553.0,"Eastern Europe",3078595,3070146,8449,2298697,3831162,"POL",3064930
1,553.0,"Central Asia",1770811,1768576,2235,1301183,2168638,"UZB",1734911
1,553.0,"Southern Europe",893027,0,893027,675580,1125967,"ITA",900774
1,553.0,"Central America",441049,0,441049,337353,562256,"MEX",449805
1,553.0,"Southern Asia",820146,0,820146,612234,1020391,"IRN",816313
1,553.0,"Western Asia",1649938,0,1649938,1231761,2052936,"IRQ",1642349
1,553.0,"Eastern Asia",1057625,0,1057625,795954,1326591,"JPN",1061273
1,553.0,"Southern Africa",160937,0,160937,120858,201431,"ZAF",161145
1,553.0,"South-Eastern Asia",1415604,0,1415604,1059633,1766055,"IDN",1412844
1,553.0,"Caribbean",160009,0,160009,122337,203895,"CUB",163116
1,554.0,"Pakistan",2034424,2033193,1231,1525824,2543040,"PAK",2034432
1,554.0,"India",7138911,7138712,199,5354195,8923658,"IND",7138927
1,554.0,"Western Europe",4059257,4053507,5750,3048483,5080806,"NLD",4064645
1,554.0,"China",10657465,10054690,602775,7958510,13264183,"CPR",10611347
1,554.0,"United States of America",3194765,3194307,458,2386698,3977830,"USA",3182264
1,554.0,"Northern Africa",1802040,0,1802040,1353072,2255121,"EGY",1804097
1,554.0,"Russian Federation",2501972,2501160,812,1885895,3143158,"RUS",2514527
1,554.0,"Western Africa",552237,0,552237,417438,695730,"NGA",556584
1,554.0,"South America",2179817,1487389,692428,1644215,2740358,"BRA",2192287
1,554.0,"Northern Europe",2197043,2017137,179906,1636416,2727361,"GBR",2181889
1,554.0,"Northern America",673369,672830,539,518751,864586,"CAN",691669
1,554.0,"Oceania",656477,656477,0,491279,818798,"NZL",655039
1,554.0,"Eastern Africa",467214,0,467214,353277,588796,"ETH",471037
1,554.0,"Middle Africa",150689,0,150689,113889,189816,"AGO",151853
1,554.0,"Eastern Europe",3074441,3066583,7858,2298697,3831162,"POL",3064930
1,554.0,"Central Asia",1738100,1736608,1492,1301183,2168638,"UZB",1734911
1,554.0,"Southern Europe",889643,0,889643,675580,1125967,"ITA",900774
1,554.0,"Central America",450574,0,450574,337353,562256,"MEX",449805
1,554.0,"Southern Asia",812927,0,812927,612234,1020391,"IRN",816313
1,554.0,"Western Asia",1645180,0,1645180,1231761,2052936,"IRQ",1642349
1,554.0,"Eastern Asia",1054434,0,1054434,795954,1326591,"JPN",1061273
1,554.0,"Southern Africa",160486,0,160486,120858,201431,"ZAF",161145
1,554.0,"South-Eastern Asia",1412401,0,1412401,1059633,1766055,"IDN",1412844
1,554.0,"Caribbean",163319,0,163319,122337,203895,"CUB",163116
1,555.0,"Pakistan",2047364,2046319,1045,1525824,2543040,"PAK",2034432
1,555.0,"India",7138921,7138777,144,5354195,8923658,"IND",7138927
1,555.0,"Western Europe",4035498,4030572,4926,3048483,5080806,"NLD",4064645
1,555.0,"China",10644347,10042226,602121,7958510,13264183,"CPR",10611347
1,555.0,"United States of America",3172150,3171818,332,2386698,3977830,"USA",3182264
1,555.0,"Northern Africa",1799906,0,1799906,1353072,2255121,"EGY",1804097
1,555.0,"Russian Federation",2505793,2505201,592,1885895,3143158,"RUS",2514527
1,555.0,"Western Africa",563522,0,563522,417438,695730,"NGA",556584
1,555.0,"South America",2190289,1484829,705460,1644215,2740358,"BRA",2192287
1,555.0,"Northern Europe",2192810,2011959,180851,1636416,2727361,"GBR",2181889
1,555.0,"Northern America",719646,718936,710,518751,864586,"CAN",691669
1,555.0,"Oceania",652063,652063,0,491279,818798,"NZL",655039
1,555.0,"Eastern Africa",474988,0,474988,353277,588796,"ETH",471037
1,555.0,"Middle Africa",153879,0,153879,113889,189816,"AGO",151853
1,555.0,"Eastern Europe",3071882,3063768,8114,2298697,3831162,"POL",3064930
1,555.0,"Central Asia",1693594,1692517,1077,1301183,2168638,"UZB",1734911
1,555.0,"Southern Europe",912519,0,912519,675580,1125967,"ITA",900774
1,555.0,"Central America",449786,0,449786,337353,562256,"MEX",449805
1,555.0,"Southern Asia",813308,0,813308,612234,1020391,"IRN",816313
1,555.0,"Western Asia",1645468,0,1645468,1231761,2052936,"IRQ",1642349
1,555.0,"Eastern Asia",1063749,0,1063749,795954,1326591,"JPN",1061273
1,555.0,"Southern Africa",161373,0,161373,120858,201431,"ZAF",161145
1,555.0,"South-Eastern Asia",1412657,0,1412657,1059633,1766055,"IDN",1412844
1,555.0,"Caribbean",163276,0,163276,122337,203895,"CUB",163116
1,556.0,"Pakistan",2017653,2016673,980,1525824,2543040,"PAK",2034432
1,556.0,"India",7138923,7138708,215,5354195,8923658,"IND",7138927
1,556.0,"Western Europe",4044144,4038358,5786,3048483,5080806,"NLD",4064645
1,556.0,"China",10634537,10041037,593500,7958510,13264183,"CPR",10611347
1,556.0,"United States of America",3194007,3193385,622,2386698,3977830,"USA",3182264
1,556.0,"Northern Africa",1802852,0,1802852,1353072,2255121,"EGY",1804097
1,556.0,"Russian Federation",2508441,2507414,1027,1885895,3143158,"RUS",2514527
1,556.0,"Western Africa",556665,0,556665,417438,695730,"NGA",556584
1,556.0,"South America",2198553,1490056,708497,1644215,2740358,"BRA",2192287
1,556.0,"Northern Europe",2189598,2007559,182039,1636416,2727361,"GBR",2181889
1,556.0,"Northern America",686349,685867,482,518751,864586,"CAN",691669
1,556.0,"Oceania",652979,652979,0,491279,818798,"NZL",655039
1,556.0,"Eastern Africa",470102,0,470102,353277,588796,"ETH",471037
1,556.0,"Middle Africa",151832,0,151832,113889,189816,"AGO",151853
1,556.0,"Eastern Europe",3089434,3081044,8390,2298697,3831162,"POL",3064930
1,556.0,"Central Asia",1749726,1747198,2528,1301183,2168638,"UZB",1734911
1,556.0,"Southern Europe",895982,0,895982,675580,1125967,"ITA",900774
1,556.0,"Central America",451094,0,451094,337353,562256,"MEX",449805
1,556.0,"Southern Asia",815413,0,815413,612234,1020391,"IRN",816313
1,556.0,"Western Asia",1653514,0,1653514,1231761,2052936,"IRQ",1642349
1,556.0,"Eastern Asia",1059606,0,1059606,795954,1326591,"JPN",1061273
1,556.0,"Southern Africa",160522,0,160522,120858,201431,"ZAF",161145
1,556.0,"South-Eastern Asia",1407893,0,1407893,1059633,1766055,"IDN",1412844
1,556.0,"Caribbean",163559,0,163559,122337,203895,"CUB",163116
1,557.0,"Pakistan",2035471,2034516,955,1525824,2543040,"PAK",2034432
1,557.0,"India",7138911,7138772,139,5354195,8923658,"IND",7138927
1,557.0,"Western Europe",4101237,4094924,6313,3048483,5080806,"NLD",4064645
1,557.0,"China",10628629,10042245,586384,7958510,13264183,"CPR",10611347
1,557.0,"United States of America",3190225,3189817,408,2386698,3977830,"USA",3182264
1,557.0,"Northern Africa",1809702,0,1809702,1353072,2255121,"EGY",1804097
1,557.0,"Russian Federation",2525801,2524808,993,1885895,3143158,"RUS",2514527
1,557.0,"Western Africa",549457,0,549457,417438,695730,"NGA",556584
1,557.0,"South America",2193457,1484111,709346,1644215,2740358,"BRA",2192287
1,557.0,"Northern Europe",2200375,2017104,183271,1636416,2727361,"GBR",2181889
1,557.0,"Northern America",663972,663645,327,518751,864586,"CAN",691669
1,557.0,"Oceania",653612,653612,0,491279,818798,"NZL",655039
1,557.0,"Eastern Africa",465680,0,465680,353277,588796,"ETH",471037
1,557.0,"Middle Africa",149714,0,149714,113889,189816,"AGO",151853
1,557.0,"Eastern Europe",3062643,3054454,8189,2298697,3831162,"POL",3064930
1,557.0,"Central Asia",1734284,1732589,1695,1301183,2168638,"UZB",1734911
1,557.0,"Southern Europe",886932,0,886932,675580,1125967,"ITA",900774
1,557.0,"Central America",449278,0,449278,337353,562256,"MEX",449805
1,557.0,"Southern Asia",815366,0,815366,612234,1020391,"IRN",816313
1,557.0,"Western Asia",1638290,0,1638290,1231761,2052936,"IRQ",1642349
1,557.0,"Eastern Asia",1059902,0,1059902,795954,1326591,"JPN",1061273
1,557.0,"Southern Africa",159598,0,159598,120858,201431,"ZAF",161145
1,557.0,"South-Eastern Asia",1404876,0,1404876,1059633,1766055,"IDN",1412844
1,557.0,"Caribbean",162882,0,162882,122337,203895,"CUB",163116
1,558.0,"Pakistan",2035175,2034305,870,1525824,2543040,"PAK",2034432
1,558.0,"India",7138922,7138818,104,5354195,8923658,"IND",7138927
1,558.0,"Western Europe",4039418,4034027,5391,3048483,5080806,"NLD",4064645
1,558.0,"China",10622587,10040756,581831,7958510,13264183,"CPR",10611347
1,558.0,"United States of America",3169091,3168785,306,2386698,3977830,"USA",3182264
1,558.0,"Northern Africa",1798695,0,1798695,1353072,2255121,"EGY",1804097
1,558.0,"Russian Federation",2506881,2506145,736,1885895,3143158,"RUS",2514527
1,558.0,"Western Africa",563784,0,563784,417438,695730,"NGA",556584
1,558.0,"South America",2212299,1489415,722884,1644215,2740358,"BRA",2192287
1,558.0,"Northern Europe",2194314,2017146,177168,1636416,2727361,"GBR",2181889
1,558.0,"Northern America",725376,724537,839,518751,864586,"CAN",691669
1,558.0,"Oceania",650072,650072,0,491279,818798,"NZL",655039
1,558.0,"Eastern Africa",476867,0,476867,353277,588796,"ETH",471037
1,558.0,"Middle Africa",154246,0,154246,113889,189816,"AGO",151853
1,558.0,"Eastern Europe",3044237,3037134,7103,2298697,3831162,"POL",3064930
1,558.0,"Central Asia",1734512,1733196,1316,1301183,2168638,"UZB",1734911
1,558.0,"Southern Europe",916940,0,916940,675580,1125967,"ITA",900774
1,558.0,"Central America",450093,0,450093,337353,562256,"MEX",449805
1,558.0,"Southern Asia",816467,0,816467,612234,1020391,"IRN",816313
1,558.0,"Western Asia",1634457,0,1634457,1231761,2052936,"IRQ",1642349
1,558.0,"Eastern Asia",1065228,0,1065228,795954,1326591,"JPN",1061273
1,558.0,"Southern Africa",161263,0,161263,120858,201431,"ZAF",161145
1,558.0,"South-Eastern Asia",1409428,0,1409428,1059633,1766055,"IDN",1412844
1,558.0,"Caribbean",163248,0,163248,122337,203895,"CUB",163116
1,559.0,"Pakistan",2034982,2033925,1057,1525824,2543040,"PAK",2034432
1,559.0,"India",7138929,7138676,253,5354195,8923658,"IND",7138927
1,559.0,"Western Europe",4046918,4040581,6337,3048483,5080806,"NLD",4064645
1,559.0,"China",10619969,10044339,575630,7958510,13264183,"CPR",10611347
1,559.0,"United States of America",3191917,3191241,676,2386698,3977830,"USA",3182264
1,559.0,"Northern Africa",1797529,0,1797529,1353072,2255121,"EGY",1804097
1,559.0,"Russian Federation",2524752,2523507,1245,1885895,3143158,"RUS",2514527
1,559.0,"Western Africa",557190,0,557190,417438,695730,"NGA",556584
1,559.0,"South America",2213812,1491810,722002,1644215,2740358,"BRA",2192287
1,559.0,"Northern Europe",2191944,2013765,178179,1636416,2727361,"GBR",2181889
1,559.0,"Northern America",690130,689562,568,518751,864586,"CAN",691669
1,559.0,"Oceania",655580,655580,0,491279,818798,"NZL",655039
1,559.0,"Eastern Africa",470976,0,470976,353277,588796,"ETH",471037
1,559.0,"Middle Africa",152110,0,152110,113889,189816,"AGO",151853
1,559.0,"Eastern Europe",3050311,3042440,7871,2298697,3831162,"POL",3064930
1,559.0,"Central Asia",1723627,1722044,1583,1301183,2168638,"UZB",1734911
1,559.0,"Southern Europe",898856,0,898856,675580,1125967,"ITA",900774
1,559.0,"Central America",451037,0,451037,337353,562256,"MEX",449805
1,559.0,"Southern Asia",816424,0,816424,612234,1020391,"IRN",816313
1,559.0,"Western Asia",1634551,0,1634551,1231761,2052936,"IRQ",1642349
1,559.0,"Eastern Asia",1065078,0,1065078,795954,1326591,"JPN",1061273
1,559.0,"Southern Africa",161271,0,161271,120858,201431,"ZAF",161145
1,559.0,"South-Eastern Asia",1414097,0,1414097,1059633,1766055,"IDN",1412844
1,559.0,"Caribbean",163570,0,163570,122337,203895,"CUB",163116
1,560.0,"Pakistan",2034791,2033947,844,1525824,2543040,"PAK",2034432
1,560.0,"India",7138917,7138752,165,5354195,8923658,"IND",7138927
1,560.0,"Western Europe",4077677,4070719,6958,3048483,5080806,"NLD",4064645
1,560.0,"China",10617637,10042005,575632,7958510,13264183,"CPR",10611347
1,560.0,"United States of America",3188801,3188357,444,2386698,3977830,"USA",3182264
1,560.0,"Northern Africa",1804276,0,1804276,1353072,2255121,"EGY",1804097
1,560.0,"Russian Federation",2521603,2520395,1208,1885895,3143158,"RUS",2514527
1,560.0,"Western Africa",551363,0,551363,417438,695730,"NGA",556584
1,560.0,"South America",2204111,1484270,719841,1644215,2740358,"BRA",2192287
1,560.0,"Northern Europe",2189908,2011033,178875,1636416,2727361,"GBR",2181889
1,560.0,"Northern America",670596,670213,383,518751,864586,"CAN",691669
1,560.0,"Oceania",655413,655413,0,491279,818798,"NZL",655039
1,560.0,"Eastern Africa",467361,0,467361,353277,588796,"ETH",471037
1,560.0,"Middle Africa",150150,0,150150,113889,189816,"AGO",151853
1,560.0,"Eastern Europe",3054534,3046155,8379,2298697,3831162,"POL",3064930
1,560.0,"Central Asia",1759747,1758041,1706,1301183,2168638,"UZB",1734911
1,560.0,"Southern Europe",890081,0,890081,675580,1125967,"ITA",900774
1,560.0,"Central America",449590,0,449590,337353,562256,"MEX",449805
1,560.0,"Southern Asia",817944,0,817944,612234,1020391,"IRN",816313
1,560.0,"Western Asia",1636396,0,1636396,1231761,2052936,"IRQ",1642349
1,560.0,"Eastern Asia",1059646,0,1059646,795954,1326591,"JPN",1061273
1,560.0,"Southern Africa",160336,0,160336,120858,201431,"ZAF",161145
1,560.0,"South-Eastern Asia",1409624,0,1409624,1059633,1766055,"IDN",1412844
1,560.0,"Caribbean",162947,0,162947,122337,203895,"CUB",163116
1,561.0,"Pakistan",2034694,2033958,736,1525824,2543040,"PAK",2034432
1,561.0,"India",7138927,7138807,120,5354195,8923658,"IND",7138927
1,561.0,"Western Europe",4048357,4042221,6136,3048483,5080806,"NLD",4064645
1,561.0,"China",10613331,10040299,573032,7958510,13264183,"CPR",10611347
1,561.0,"United States of America",3186723,3186401,322,2386698,3977830,"USA",3182264
1,561.0,"Northern Africa",1801165,0,1801165,1353072,2255121,"EGY",1804097
1,561.0,"Russian Federation",2488461,2487583,878,1885895,3143158,"RUS",2514527
1,561.0,"Western Africa",564620,0,564620,417438,695730,"NGA",556584
1,561.0,"South America",2220066,1488625,731441,1644215,2740358,"BRA",2192287
1,561.0,"Northern Europe",2188061,2008152,179909,1636416,2727361,"GBR",2181889
1,561.0,"Northern America",717644,717087,557,518751,864586,"CAN",691669
1,561.0,"Oceania",655298,655298,0,491279,818798,"NZL",655039
1,561.0,"Eastern Africa",475385,0,475385,353277,588796,"ETH",471037
1,561.0,"Middle Africa",154348,0,154348,113889,189816,"AGO",151853
1,561.0,"Eastern Europe",3057948,3048671,9277,2298697,3831162,"POL",3064930
1,561.0,"Central Asia",1730473,1729252,1221,1301183,2168638,"UZB",1734911
1,561.0,"Southern Europe",914533,0,914533,675580,1125967,"ITA",900774
1,561.0,"Central America",451595,0,451595,337353,562256,"MEX",449805
1,561.0,"Southern Asia",813387,0,813387,612234,1020391,"IRN",816313
1,561.0,"Western Asia",1640749,0,1640749,1231761,2052936,"IRQ",1642349
1,561.0,"Eastern Asia",1057298,0,1057298,795954,1326591,"JPN",1061273
1,561.0,"Southern Africa",162365,0,162365,120858,201431,"ZAF",161145
1,561.0,"South-Eastern Asia",1418334,0,1418334,1059633,1766055,"IDN",1412844
1,561.0,"Caribbean",163894,0,163894,122337,203895,"CUB",163116
1,562.0,"Pakistan",2034623,2033735,888,1525824,2543040,"PAK",2034432
1,562.0,"India",7138926,7138736,190,5354195,8923658,"IND",7138927
1,562.0,"Western Europe",4078706,4071594,7112,3048483,5080806,"NLD",4064645
1,562.0,"China",10615062,10039763,575299,7958510,13264183,"CPR",10611347
1,562.0,"United States of America",3185275,3184742,533,2386698,3977830,"USA",3182264
1,562.0,"Northern Africa",1805565,0,1805565,1353072,2255121,"EGY",1804097
1,562.0,"Russian Federation",2527403,2526037,1366,1885895,3143158,"RUS",2514527
1,562.0,"Western Africa",553282,0,553282,417438,695730,"NGA",556584
1,562.0,"South America",2215392,1490861,724531,1644215,2740358,"BRA",2192287
1,562.0,"Northern Europe",2187254,2006472,180782,1636416,2727361,"GBR",2181889
1,562.0,"Northern America",677054,676681,373,518751,864586,"CAN",691669
1,562.0,"Oceania",659204,659204,0,491279,818798,"NZL",655039
1,562.0,"Eastern Africa",468248,0,468248,353277,588796,"ETH",471037
1,562.0,"Middle Africa",150660,0,150660,113889,189816,"AGO",151853
1,562.0,"Eastern Europe",3059840,3049801,10039,2298697,3831162,"POL",3064930
1,562.0,"Central Asia",1720845,1719285,1560,1301183,2168638,"UZB",1734911
1,562.0,"Southern Europe",893936,0,893936,675580,1125967,"ITA",900774
1,562.0,"Central America",449381,0,449381,337353,562256,"MEX",449805
1,562.0,"Southern Asia",816008,0,816008,612234,1020391,"IRN",816313
1,562.0,"Western Asia",1638192,0,1638192,1231761,2052936,"IRQ",1642349
1,562.0,"Eastern Asia",1062890,0,1062890,795954,1326591,"JPN",1061273
1,562.0,"Southern Africa",161352,0,161352,120858,201431,"ZAF",161145
1,562.0,"South-Eastern Asia",1418238,0,1418238,1059633,1766055,"IDN",1412844
1,562.0,"Caribbean",162870,0,162870,122337,203895,"CUB",163116
1,563.0,"Pakistan",2034558,2033849,709,1525824,2543040,"PAK",2034432
1,563.0,"India",7138924,7138792,132,5354195,8923658,"IND",7138927
1,563.0,"Western Europe",4048994,4041646,7348,3048483,5080806,"NLD",4064645
1,563.0,"China",10612925,10038758,574167,7958510,13264183,"CPR",10611347
1,563.0,"United States of America",3165728,3165366,362,2386698,3977830,"USA",3182264
1,563.0,"Northern Africa",1802189,0,1802189,1353072,2255121,"EGY",1804097
1,563.0,"Russian Federation",2507929,2506996,933,1885895,3143158,"RUS",2514527
1,563.0,"Western Africa",553590,0,553590,417438,695730,"NGA",556584
1,563.0,"South America",2206699,1484339,722360,1644215,2740358,"BRA",2192287
1,563.0,"Northern Europe",2197570,2016915,180655,1636416,2727361,"GBR",2181889
1,563.0,"Northern America",685708,685454,254,518751,864586,"CAN",691669
1,563.0,"Oceania",653936,653936,0,491279,818798,"NZL",655039
1,563.0,"Eastern Africa",469352,0,469352,353277,588796,"ETH",471037
1,563.0,"Middle Africa",150918,0,150918,113889,189816,"AGO",151853
1,563.0,"Eastern Europe",3080786,3070003,10783,2298697,3831162,"POL",3064930
1,563.0,"Central Asia",1757838,1756596,1242,1301183,2168638,"UZB",1734911
1,563.0,"Southern Europe",895810,0,895810,675580,1125967,"ITA",900774
1,563.0,"Central America",447367,0,447367,337353,562256,"MEX",449805
1,563.0,"Southern Asia",816797,0,816797,612234,1020391,"IRN",816313
1,563.0,"Western Asia",1649857,0,1649857,1231761,2052936,"IRQ",1642349
1,563.0,"Eastern Asia",1057613,0,1057613,795954,1326591,"JPN",1061273
1,563.0,"Southern Africa",160572,0,160572,120858,201431,"ZAF",161145
1,563.0,"South-Eastern Asia",1409569,0,1409569,1059633,1766055,"IDN",1412844
1,563.0,"Caribbean",162237,0,162237,122337,203895,"CUB",163116
1,564.0,"Pakistan",2034505,2033931,574,1525824,2543040,"PAK",2034432
1,564.0,"India",7138832,7138832,0,5354195,8923658,"IND",7138927
1,564.0,"Western Europe",4079204,4071472,7732,3048483,5080806,"NLD",4064645
1,564.0,"China",10613478,10038329,575149,7958510,13264183,"CPR",10611347
1,564.0,"United States of America",3208232,3207988,244,2386698,3977830,"USA",3182264
1,564.0,"Northern Africa",1806505,0,1806505,1353072,2255121,"EGY",1804097
1,564.0,"Russian Federation",2525452,2524827,625,1885895,3143158,"RUS",2514527
1,564.0,"Western Africa",555520,0,555520,417438,695730,"NGA",556584
1,564.0,"South America",2215329,1491366,723963,1644215,2740358,"BRA",2192287
1,564.0,"Northern Europe",2181235,2019428,161807,1636416,2727361,"GBR",2181889
1,564.0,"Northern America",675508,675331,177,518751,864586,"CAN",691669
1,564.0,"Oceania",654277,654277,0,491279,818798,"NZL",655039
1,564.0,"Eastern Africa",467483,0,467483,353277,588796,"ETH",471037
1,564.0,"Middle Africa",151216,0,151216,113889,189816,"AGO",151853
1,564.0,"Eastern Europe",3076083,3065311,10772,2298697,3831162,"POL",3064930
1,564.0,"Central Asia",1729091,1728255,836,1301183,2168638,"UZB",1734911
1,564.0,"Southern Europe",893590,0,893590,675580,1125967,"ITA",900774
1,564.0,"Central America",452215,0,452215,337353,562256,"MEX",449805
1,564.0,"Southern Asia",817102,0,817102,612234,1020391,"IRN",816313
1,564.0,"Western Asia",1645281,0,1645281,1231761,2052936,"IRQ",1642349
1,564.0,"Eastern Asia",1062960,0,1062960,795954,1326591,"JPN",1061273
1,564.0,"Southern Africa",160102,0,160102,120858,201431,"ZAF",161145
1,564.0,"South-Eastern Asia",1408267,0,1408267,1059633,1766055,"IDN",1412844
1,564.0,"Caribbean",163976,0,163976,122337,203895,"CUB",163116
1,565.0,"Pakistan",2034492,2033987,505,1525824,2543040,"PAK",2034432
1,565.0,"India",7094054,7094054,0,5354195,8923658,"IND",7138927
1,565.0,"Western Europe",4074921,4067864,7057,3048483,5080806,"NLD",4064645
1,565.0,"China",10612182,10037752,574430,7958510,13264183,"CPR",10611347
1,565.0,"United States of America",3144158,3143979,179,2386698,3977830,"USA",3182264
1,565.0,"Northern Africa",1811781,0,1811781,1353072,2255121,"EGY",1804097
1,565.0,"Russian Federation",2522156,2521694,462,1885895,3143158,"RUS",2514527
1,565.0,"Western Africa",562037,0,562037,417438,695730,"NGA",556584
1,565.0,"South America",2215597,1486819,728778,1644215,2740358,"BRA",2192287
1,565.0,"Northern Europe",2180959,2018751,162208,1636416,2727361,"GBR",2181889
1,565.0,"Northern America",729342,728831,511,518751,864586,"CAN",691669
1,565.0,"Oceania",654511,654511,0,491279,818798,"NZL",655039
1,565.0,"Eastern Africa",473705,0,473705,353277,588796,"ETH",471037
1,565.0,"Middle Africa",153790,0,153790,113889,189816,"AGO",151853
1,565.0,"Eastern Europe",3053811,3042673,11138,2298697,3831162,"POL",3064930
1,565.0,"Central Asia",1730837,1730170,667,1301183,2168638,"UZB",1734911
1,565.0,"Southern Europe",921647,0,921647,675580,1125967,"ITA",900774
1,565.0,"Central America",447130,0,447130,337353,562256,"MEX",449805
1,565.0,"Southern Asia",820111,0,820111,612234,1020391,"IRN",816313
1,565.0,"Western Asia",1637404,0,1637404,1231761,2052936,"IRQ",1642349
1,565.0,"Eastern Asia",1067369,0,1067369,795954,1326591,"JPN",1061273
1,565.0,"Southern Africa",162014,0,162014,120858,201431,"ZAF",161145
1,565.0,"South-Eastern Asia",1418920,0,1418920,1059633,1766055,"IDN",1412844
1,565.0,"Caribbean",162177,0,162177,122337,203895,"CUB",163116
1,566.0,"Pakistan",2047419,2046572,847,1525824,2543040,"PAK",2034432
1,566.0,"India",7152370,7151981,389,5354195,8923658,"IND",7138927
1,566.0,"Western Europe",4071729,4065366,6363,3048483,5080806,"NLD",4064645
1,566.0,"China",10612658,10037527,575131,7958510,13264183,"CPR",10611347
1,566.0,"United States of America",3212150,3211455,695,2386698,3977830,"USA",3182264
1,566.0,"Northern Africa",1802522,0,1802522,1353072,2255121,"EGY",1804097
1,566.0,"Russian Federation",2519829,2518873,956,1885895,3143158,"RUS",2514527
1,566.0,"Western Africa",556366,0,556366,417438,695730,"NGA",556584
1,566.0,"South America",2219058,1492016,727042,1644215,2740358,"BRA",2192287
1,566.0,"Northern Europe",2182048,2017784,164264,1636416,2727361,"GBR",2181889
1,566.0,"Northern America",676759,676408,351,518751,864586,"CAN",691669
1,566.0,"Oceania",658656,658656,0,491279,818798,"NZL",655039
1,566.0,"Eastern Africa",468755,0,468755,353277,588796,"ETH",471037
1,566.0,"Middle Africa",151512,0,151512,113889,189816,"AGO",151853
1,566.0,"Eastern Europe",3057930,3045939,11991,2298697,3831162,"POL",3064930
1,566.0,"Central Asia",1710195,1709014,1181,1301183,2168638,"UZB",1734911
1,566.0,"Southern Europe",894568,0,894568,675580,1125967,"ITA",900774
1,566.0,"Central America",452642,0,452642,337353,562256,"MEX",449805
1,566.0,"Southern Asia",813936,0,813936,612234,1020391,"IRN",816313
1,566.0,"Western Asia",1634839,0,1634839,1231761,2052936,"IRQ",1642349
1,566.0,"Eastern Asia",1062462,0,1062462,795954,1326591,"JPN",1061273
1,566.0,"Southern Africa",161405,0,161405,120858,201431,"ZAF",161145
1,566.0,"South-Eastern Asia",1417320,0,1417320,1059633,1766055,"IDN",1412844
1,566.0,"Caribbean",164093,0,164093,122337,203895,"CUB",163116
1,567.0,"Pakistan",2030652,2030064,588,1525824,2543040,"PAK",2034432
1,567.0,"India",7103490,7103222,268,5354195,8923658,"IND",7138927
1,567.0,"Western Europe",4120619,4113865,6754,3048483,5080806,"NLD",4064645
1,567.0,"China",10611012,10041295,569717,7958510,13264183,"CPR",10611347
1,567.0,"United States of America",3146763,3146285,478,2386698,3977830,"USA",3182264
1,567.0,"Northern Africa",1823975,0,1823975,1353072,2255121,"EGY",1804097
1,567.0,"Russian Federation",2518211,2517550,661,1885895,3143158,"RUS",2514527
1,567.0,"Western Africa",552312,0,552312,417438,695730,"NGA",556584
1,567.0,"South America",2165439,1482969,682470,1644215,2740358,"BRA",2192287
1,567.0,"Northern Europe",2181162,2016747,164415,1636416,2727361,"GBR",2181889
1,567.0,"Northern America",689524,689179,345,518751,864586,"CAN",691669
1,567.0,"Oceania",657535,657535,0,491279,818798,"NZL",655039
1,567.0,"Eastern Africa",467866,0,467866,353277,588796,"ETH",471037
1,567.0,"Middle Africa",150675,0,150675,113889,189816,"AGO",151853
1,567.0,"Eastern Europe",3079440,3066526,12914,2298697,3831162,"POL",3064930
1,567.0,"Central Asia",1761418,1760165,1253,1301183,2168638,"UZB",1734911
1,567.0,"Southern Europe",901673,0,901673,675580,1125967,"ITA",900774
1,567.0,"Central America",445092,0,445092,337353,562256,"MEX",449805
1,567.0,"Southern Asia",819089,0,819089,612234,1020391,"IRN",816313
1,567.0,"Western Asia",1649667,0,1649667,1231761,2052936,"IRQ",1642349
1,567.0,"Eastern Asia",1060431,0,1060431,795954,1326591,"JPN",1061273
1,567.0,"Southern Africa",161389,0,161389,120858,201431,"ZAF",161145
1,567.0,"South-Eastern Asia",1417546,0,1417546,1059633,1766055,"IDN",1412844
1,567.0,"Caribbean",161456,0,161456,122337,203895,"CUB",163116
1,568.0,"Pakistan",2031744,2031355,389,1525824,2543040,"PAK",2034432
1,568.0,"India",7158922,7158749,173,5354195,8923658,"IND",7138927
1,568.0,"Western Europe",4103524,4097913,5611,3048483,5080806,"NLD",4064645
1,568.0,"China",10611868,10041387,570481,7958510,13264183,"CPR",10611347
1,568.0,"United States of America",3213960,3213650,310,2386698,3977830,"USA",3182264
1,568.0,"Northern Africa",1809341,0,1809341,1353072,2255121,"EGY",1804097
1,568.0,"Russian Federation",2517061,2516632,429,1885895,3143158,"RUS",2514527
1,568.0,"Western Africa",551057,0,551057,417438,695730,"NGA",556584
1,568.0,"South America",2173122,1484342,688780,1644215,2740358,"BRA",2192287
1,568.0,"Northern Europe",2182309,2015950,166359,1636416,2727361,"GBR",2181889
1,568.0,"Northern America",658002,657762,240,518751,864586,"CAN",691669
1,568.0,"Oceania",656766,656766,0,491279,818798,"NZL",655039
1,568.0,"Eastern Africa",466111,0,466111,353277,588796,"ETH",471037
1,568.0,"Middle Africa",149869,0,149869,113889,189816,"AGO",151853
1,568.0,"Eastern Europe",3074757,3063010,11747,2298697,3831162,"POL",3064930
1,568.0,"Central Asia",1742388,1741649,739,1301183,2168638,"UZB",1734911
1,568.0,"Southern Europe",883574,0,883574,675580,1125967,"ITA",900774
1,568.0,"Central America",452311,0,452311,337353,562256,"MEX",449805
1,568.0,"Southern Asia",814333,0,814333,612234,1020391,"IRN",816313
1,568.0,"Western Asia",1644048,0,1644048,1231761,2052936,"IRQ",1642349
1,568.0,"Eastern Asia",1057362,0,1057362,795954,1326591,"JPN",1061273
1,568.0,"Southern Africa",160345,0,160345,120858,201431,"ZAF",161145
1,568.0,"South-Eastern Asia",1409593,0,1409593,1059633,1766055,"IDN",1412844
1,568.0,"Caribbean",163868,0,163868,122337,203895,"CUB",163116
1,569.0,"Pakistan",2032545,2032228,317,1525824,2543040,"PAK",2034432
1,569.0,"India",7152959,7152828,131,5354195,8923658,"IND",7138927
1,569.0,"Western Europe",4041237,4036487,4750,3048483,5080806,"NLD",4064645
1,569.0,"China",10612117,10043866,568251,7958510,13264183,"CPR",10611347
1,569.0,"United States of America",3185155,3184923,232,2386698,3977830,"USA",3182264
1,569.0,"Northern Africa",1803743,0,1803743,1353072,2255121,"EGY",1804097
1,569.0,"Russian Federation",2516308,2515991,317,1885895,3143158,"RUS",2514527
1,569.0,"Western Africa",562718,0,562718,417438,695730,"NGA",556584
1,569.0,"South America",2187576,1484279,703297,1644215,2740358,"BRA",2192287
1,569.0,"Northern Europe",2181755,2019906,161849,1636416,2727361,"GBR",2181889
1,569.0,"Northern America",717357,716086,1271,518751,864586,"CAN",691669
1,569.0,"Oceania",652261,652261,0,491279,818798,"NZL",655039
1,569.0,"Eastern Africa",474380,0,474380,353277,588796,"ETH",471037
1,569.0,"Middle Africa",154114,0,154114,113889,189816,"AGO",151853
1,569.0,"Eastern Europe",3072144,3061672,10472,2298697,3831162,"POL",3064930
1,569.0,"Central Asia",1729256,1728719,537,1301183,2168638,"UZB",1734911
1,569.0,"Southern Europe",914939,0,914939,675580,1125967,"ITA",900774
1,569.0,"Central America",451453,0,451453,337353,562256,"MEX",449805
1,569.0,"Southern Asia",818708,0,818708,612234,1020391,"IRN",816313
1,569.0,"Western Asia",1648542,0,1648542,1231761,2052936,"IRQ",1642349
1,569.0,"Eastern Asia",1066817,0,1066817,795954,1326591,"JPN",1061273
1,569.0,"Southern Africa",160680,0,160680,120858,201431,"ZAF",161145
1,569.0,"South-Eastern Asia",1412636,0,1412636,1059633,1766055,"IDN",1412844
1,569.0,"Caribbean",163829,0,163829,122337,203895,"CUB",163116
1,570.0,"Pakistan",2045954,2045598,356,1525824,2543040,"PAK",2034432
1,570.0,"India",7148675,7148675,0,5354195,8923658,"IND",7138927
1,570.0,"Western Europe",4048225,4042823,5402,3048483,5080806,"NLD",4064645
1,570.0,"China",10611836,10043658,568178,7958510,13264183,"CPR",10611347
1,570.0,"United States of America",3202801,3202500,301,2386698,3977830,"USA",3182264
1,570.0,"Northern Africa",1800406,0,1800406,1353072,2255121,"EGY",1804097
1,570.0,"Russian Federation",2515769,2515234,535,1885895,3143158,"RUS",2514527
1,570.0,"Western Africa",558046,0,558046,417438,695730,"NGA",556584
1,570.0,"South America",2197002,1491031,705971,1644215,2740358,"BRA",2192287
1,570.0,"Northern Europe",2182094,2018687,163407,1636416,2727361,"GBR",2181889
1,570.0,"Northern America",688743,687885,858,518751,864586,"CAN",691669
1,570.0,"Oceania",653116,653116,0,491279,818798,"NZL",655039
1,570.0,"Eastern Africa",470950,0,470950,353277,588796,"ETH",471037
1,570.0,"Middle Africa",152263,0,152263,113889,189816,"AGO",151853
1,570.0,"Eastern Europe",3069917,3059228,10689,2298697,3831162,"POL",3064930
1,570.0,"Central Asia",1741869,1741098,771,1301183,2168638,"UZB",1734911
1,570.0,"Southern Europe",898796,0,898796,675580,1125967,"ITA",900774
1,570.0,"Central America",452271,0,452271,337353,562256,"MEX",449805
1,570.0,"Southern Asia",817599,0,817599,612234,1020391,"IRN",816313
1,570.0,"Western Asia",1644889,0,1644889,1231761,2052936,"IRQ",1642349
1,570.0,"Eastern Asia",1062729,0,1062729,795954,1326591,"JPN",1061273
1,570.0,"Southern Africa",160591,0,160591,120858,201431,"ZAF",161145
1,570.0,"South-Eastern Asia",1408438,0,1408438,1059633,1766055,"IDN",1412844
1,570.0,"Caribbean",163960,0,163960,122337,203895,"CUB",163116
1,571.0,"Pakistan",2042521,2042283,238,1525824,2543040,"PAK",2034432
1,571.0,"India",7145762,7145762,0,5354195,8923658,"IND",7138927
1,571.0,"Western Europe",4103893,4098068,5825,3048483,5080806,"NLD",4064645
1,571.0,"China",10612861,10043526,569335,7958510,13264183,"CPR",10611347
1,571.0,"United States of America",3177618,3177419,199,2386698,3977830,"USA",3182264
1,571.0,"Northern Africa",1813298,0,1813298,1353072,2255121,"EGY",1804097
1,571.0,"Russian Federation",2530871,2530514,357,1885895,3143158,"RUS",2514527
1,571.0,"Western Africa",552966,0,552966,417438,695730,"NGA",556584
1,571.0,"South America",2191757,1486716,705041,1644215,2740358,"BRA",2192287
1,571.0,"Northern Europe",2181911,2017567,164344,1636416,2727361,"GBR",2181889
1,571.0,"Northern America",677537,676957,580,518751,864586,"CAN",691669
1,571.0,"Oceania",653708,653708,0,491279,818798,"NZL",655039
1,571.0,"Eastern Africa",469129,0,469129,353277,588796,"ETH",471037
1,571.0,"Middle Africa",150650,0,150650,113889,189816,"AGO",151853
1,571.0,"Eastern Europe",3068355,3057516,10839,2298697,3831162,"POL",3064930
1,571.0,"Central Asia",1728765,1728335,430,1301183,2168638,"UZB",1734911
1,571.0,"Southern Europe",894473,0,894473,675580,1125967,"ITA",900774
1,571.0,"Central America",448372,0,448372,337353,562256,"MEX",449805
1,571.0,"Southern Asia",817872,0,817872,612234,1020391,"IRN",816313
1,571.0,"Western Asia",1642350,0,1642350,1231761,2052936,"IRQ",1642349
1,571.0,"Eastern Asia",1063414,0,1063414,795954,1326591,"JPN",1061273
1,571.0,"Southern Africa",160549,0,160549,120858,201431,"ZAF",161145
1,571.0,"South-Eastern Asia",1407463,0,1407463,1059633,1766055,"IDN",1412844
1,571.0,"Caribbean",162619,0,162619,122337,203895,"CUB",163116
1,572.0,"Pakistan",2040129,2039956,173,1525824,2543040,"PAK",2034432
1,572.0,"India",7143723,7143723,0,5354195,8923658,"IND",7138927
1,572.0,"Western Europe",4041395,4037294,4101,3048483,5080806,"NLD",4064645
1,572.0,"China",10610297,10043114,567183,7958510,13264183,"CPR",10611347
1,572.0,"United States of America",3160565,3160420,145,2386698,3977830,"USA",3182264
1,572.0,"Northern Africa",1804228,0,1804228,1353072,2255121,"EGY",1804097
1,572.0,"Russian Federation",2494954,2494693,261,1885895,3143158,"RUS",2514527
1,572.0,"Western Africa",561803,0,561803,417438,695730,"NGA",556584
1,572.0,"South America",2200887,1483399,717488,1644215,2740358,"BRA",2192287
1,572.0,"Northern Europe",2181721,2016532,165189,1636416,2727361,"GBR",2181889
1,572.0,"Northern America",730812,730064,748,518751,864586,"CAN",691669
1,572.0,"Oceania",654118,654118,0,491279,818798,"NZL",655039
1,572.0,"Eastern Africa",475537,0,475537,353277,588796,"ETH",471037
1,572.0,"Middle Africa",153880,0,153880,113889,189816,"AGO",151853
1,572.0,"Eastern Europe",3067694,3056504,11190,2298697,3831162,"POL",3064930
1,572.0,"Central Asia",1741618,1741095,523,1301183,2168638,"UZB",1734911
1,572.0,"Southern Europe",921973,0,921973,675580,1125967,"ITA",900774
1,572.0,"Central America",449349,0,449349,337353,562256,"MEX",449805
1,572.0,"Southern Asia",815699,0,815699,612234,1020391,"IRN",816313
1,572.0,"Western Asia",1648302,0,1648302,1231761,2052936,"IRQ",1642349
1,572.0,"Eastern Asia",1061099,0,1061099,795954,1326591,"JPN",1061273
1,572.0,"Southern Africa",161618,0,161618,120858,201431,"ZAF",161145
1,572.0,"South-Eastern Asia",1418473,0,1418473,1059633,1766055,"IDN",1412844
1,572.0,"Caribbean",162981,0,162981,122337,203895,"CUB",163116
1,573.0,"Pakistan",2025593,2025046,547,1525824,2543040,"PAK",2034432
1,573.0,"India",7142392,7142078,314,5354195,8923658,"IND",7138927
1,573.0,"Western Europe",4048290,4044030,4260,3048483,5080806,"NLD",4064645
1,573.0,"China",10611435,10043397,568038,7958510,13264183,"CPR",10611347
1,573.0,"United States of America",3204679,3204082,597,2386698,3977830,"USA",3182264
1,573.0,"Northern Africa",1799991,0,1799991,1353072,2255121,"EGY",1804097
1,573.0,"Russian Federation",2516401,2515538,863,1885895,3143158,"RUS",2514527
1,573.0,"Western Africa",558193,0,558193,417438,695730,"NGA",556584
1,573.0,"South America",2206770,1487837,718933,1644215,2740358,"BRA",2192287
1,573.0,"Northern Europe",2182499,2015202,167297,1636416,2727361,"GBR",2181889
1,573.0,"Northern America",689693,689185,508,518751,864586,"CAN",691669
1,573.0,"Oceania",658381,658381,0,491279,818798,"NZL",655039
1,573.0,"Eastern Africa",470837,0,470837,353277,588796,"ETH",471037
1,573.0,"Middle Africa",152382,0,152382,113889,189816,"AGO",151853
1,573.0,"Eastern Europe",3066715,3055685,11030,2298697,3831162,"POL",3064930
1,573.0,"Central Asia",1728733,1727751,982,1301183,2168638,"UZB",1734911
1,573.0,"Southern Europe",899582,0,899582,675580,1125967,"ITA",900774
1,573.0,"Central America",452570,0,452570,337353,562256,"MEX",449805
1,573.0,"Southern Asia",815465,0,815465,612234,1020391,"IRN",816313
1,573.0,"Western Asia",1643157,0,1643157,1231761,2052936,"IRQ",1642349
1,573.0,"Eastern Asia",1062927,0,1062927,795954,1326591,"JPN",1061273
1,573.0,"Southern Africa",161985,0,161985,120858,201431,"ZAF",161145
1,573.0,"South-Eastern Asia",1419365,0,1419365,1059633,1766055,"IDN",1412844
1,573.0,"Caribbean",164129,0,164129,122337,203895,"CUB",163116
1,574.0,"Pakistan",2041058,2040702,356,1525824,2543040,"PAK",2034432
1,574.0,"India",7141343,7141138,205,5354195,8923658,"IND",7138927
1,574.0,"Western Europe",4078520,4073724,4796,3048483,5080806,"NLD",4064645
1,574.0,"China",10612706,10043375,569331,7958510,13264183,"CPR",10611347
1,574.0,"United States of America",3197423,3197034,389,2386698,3977830,"USA",3182264
1,574.0,"Northern Africa",1804369,0,1804369,1353072,2255121,"EGY",1804097
1,574.0,"Russian Federation",2531294,2530461,833,1885895,3143158,"RUS",2514527
1,574.0,"Western Africa",552443,0,552443,417438,695730,"NGA",556584
1,574.0,"South America",2207248,1491533,715715,1644215,2740358,"BRA",2192287
1,574.0,"Northern Europe",2182205,2013835,168370,1636416,2727361,"GBR",2181889
1,574.0,"Northern America",666306,665963,343,518751,864586,"CAN",691669
1,574.0,"Oceania",657348,657348,0,491279,818798,"NZL",655039
1,574.0,"Eastern Africa",467733,0,467733,353277,588796,"ETH",471037
1,574.0,"Middle Africa",150283,0,150283,113889,189816,"AGO",151853
1,574.0,"Eastern Europe",3066000,3054705,11295,2298697,3831162,"POL",3064930
1,574.0,"Central Asia",1730539,1729558,981,1301183,2168638,"UZB",1734911
1,574.0,"Southern Europe",886158,0,886158,675580,1125967,"ITA",900774
1,574.0,"Central America",450472,0,450472,337353,562256,"MEX",449805
1,574.0,"Southern Asia",816993,0,816993,612234,1020391,"IRN",816313
1,574.0,"Western Asia",1639957,0,1639957,1231761,2052936,"IRQ",1642349
1,574.0,"Eastern Asia",1062374,0,1062374,795954,1326591,"JPN",1061273
1,574.0,"Southern Africa",161080,0,161080,120858,201431,"ZAF",161145
1,574.0,"South-Eastern Asia",1412379,0,1412379,1059633,1766055,"IDN",1412844
1,574.0,"Caribbean",163271,0,163271,122337,203895,"CUB",163116
1,575.0,"Pakistan",2039106,2038842,264,1525824,2543040,"PAK",2034432
1,575.0,"India",7140627,7140477,150,5354195,8923658,"IND",7138927
1,575.0,"Western Europe",4049077,4044954,4123,3048483,5080806,"NLD",4064645
1,575.0,"China",10611467,10043008,568459,7958510,13264183,"CPR",10611347
1,575.0,"United States of America",3155505,3155215,290,2386698,3977830,"USA",3182264
1,575.0,"Northern Africa",1803753,0,1803753,1353072,2255121,"EGY",1804097
1,575.0,"Russian Federation",2510731,2510121,610,1885895,3143158,"RUS",2514527
1,575.0,"Western Africa",560393,0,560393,417438,695730,"NGA",556584
1,575.0,"South America",2209881,1485835,724046,1644215,2740358,"BRA",2192287
1,575.0,"Northern Europe",2181603,2013750,167853,1636416,2727361,"GBR",2181889
1,575.0,"Northern America",722796,721942,854,518751,864586,"CAN",691669
1,575.0,"Oceania",652660,652660,0,491279,818798,"NZL",655039
1,575.0,"Eastern Africa",474642,0,474642,353277,588796,"ETH",471037
1,575.0,"Middle Africa",153360,0,153360,113889,189816,"AGO",151853
1,575.0,"Eastern Europe",3065888,3055924,9964,2298697,3831162,"POL",3064930
1,575.0,"Central Asia",1731870,1730998,872,1301183,2168638,"UZB",1734911
1,575.0,"Southern Europe",918361,0,918361,675580,1125967,"ITA",900774
1,575.0,"Central America",447834,0,447834,337353,562256,"MEX",449805
1,575.0,"Southern Asia",817071,0,817071,612234,1020391,"IRN",816313
1,575.0,"Western Asia",1647510,0,1647510,1231761,2052936,"IRQ",1642349
1,575.0,"Eastern Asia",1064302,0,1064302,795954,1326591,"JPN",1061273
1,575.0,"Southern Africa",161071,0,161071,120858,201431,"ZAF",161145
1,575.0,"South-Eastern Asia",1414177,0,1414177,1059633,1766055,"IDN",1412844
1,575.0,"Caribbean",162561,0,162561,122337,203895,"CUB",163116
1,576.0,"Pakistan",2037728,2037175,553,1525824,2543040,"PAK",2034432
1,576.0,"India",7140124,7139829,295,5354195,8923658,"IND",7138927
1,576.0,"Western Europe",4053653,4049439,4214,3048483,5080806,"NLD",4064645
1,576.0,"China",10611040,10042975,568065,7958510,13264183,"CPR",10611347
1,576.0,"United States of America",3219750,3219098,652,2386698,3977830,"USA",3182264
1,576.0,"Northern Africa",1799562,0,1799562,1353072,2255121,"EGY",1804097
1,576.0,"Russian Federation",2511882,2510845,1037,1885895,3143158,"RUS",2514527
1,576.0,"Western Africa",558705,0,558705,417438,695730,"NGA",556584
1,576.0,"South America",2217374,1492152,725222,1644215,2740358,"BRA",2192287
1,576.0,"Northern Europe",2182923,2012521,170402,1636416,2727361,"GBR",2181889
1,576.0,"Northern America",680490,679907,583,518751,864586,"CAN",691669
1,576.0,"Oceania",657370,657370,0,491279,818798,"NZL",655039
1,576.0,"Eastern Africa",469674,0,469674,353277,588796,"ETH",471037
1,576.0,"Middle Africa",152213,0,152213,113889,189816,"AGO",151853
1,576.0,"Eastern Europe",3065461,3055641,9820,2298697,3831162,"POL",3064930
1,576.0,"Central Asia",1743716,1742414,1302,1301183,2168638,"UZB",1734911
1,576.0,"Southern Europe",893896,0,893896,675580,1125967,"ITA",900774
1,576.0,"Central America",453984,0,453984,337353,562256,"MEX",449805
1,576.0,"Southern Asia",816333,0,816333,612234,1020391,"IRN",816313
1,576.0,"Western Asia",1641966,0,1641966,1231761,2052936,"IRQ",1642349
1,576.0,"Eastern Asia",1061425,0,1061425,795954,1326591,"JPN",1061273
1,576.0,"Southern Africa",161508,0,161508,120858,201431,"ZAF",161145
1,576.0,"South-Eastern Asia",1415245,0,1415245,1059633,1766055,"IDN",1412844
1,576.0,"Caribbean",164528,0,164528,122337,203895,"CUB",163116
1,577.0,"Pakistan",2036742,2036362,380,1525824,2543040,"PAK",2034432
1,577.0,"India",7184570,7184369,201,5354195,8923658,"IND",7138927
1,577.0,"Western Europe",4107826,4102968,4858,3048483,5080806,"NLD",4064645
1,577.0,"China",10614380,10040760,573620,7958510,13264183,"CPR",10611347
1,577.0,"United States of America",3133567,3133123,444,2386698,3977830,"USA",3182264
1,577.0,"Northern Africa",1815160,0,1815160,1353072,2255121,"EGY",1804097
1,577.0,"Russian Federation",2528147,2527439,708,1885895,3143158,"RUS",2514527
1,577.0,"Western Africa",550551,0,550551,417438,695730,"NGA",556584
1,577.0,"South America",2180704,1492508,688196,1644215,2740358,"BRA",2192287
1,577.0,"Northern Europe",2181020,2011018,170002,1636416,2727361,"GBR",2181889
1,577.0,"Northern America",688054,687483,571,518751,864586,"CAN",691669
1,577.0,"Oceania",656646,656646,0,491279,818798,"NZL",655039
1,577.0,"Eastern Africa",472993,0,472993,353277,588796,"ETH",471037
1,577.0,"Middle Africa",150249,0,150249,113889,189816,"AGO",151853
1,577.0,"Eastern Europe",3065303,3054944,10359,2298697,3831162,"POL",3064930
1,577.0,"Central Asia",1730142,1729252,890,1301183,2168638,"UZB",1734911
1,577.0,"Southern Europe",899804,0,899804,675580,1125967,"ITA",900774
1,577.0,"Central America",443392,0,443392,337353,562256,"MEX",449805
1,577.0,"Southern Asia",818892,0,818892,612234,1020391,"IRN",816313
1,577.0,"Western Asia",1643205,0,1643205,1231761,2052936,"IRQ",1642349
1,577.0,"Eastern Asia",1062034,0,1062034,795954,1326591,"JPN",1061273
1,577.0,"Southern Africa",161366,0,161366,120858,201431,"ZAF",161145
1,577.0,"South-Eastern Asia",1415288,0,1415288,1059633,1766055,"IDN",1412844
1,577.0,"Caribbean",160811,0,160811,122337,203895,"CUB",163116
1,578.0,"Pakistan",2036034,2035788,246,1525824,2543040,"PAK",2034432
1,578.0,"India",7170841,7170709,132,5354195,8923658,"IND",7138927
1,578.0,"Western Europe",4094640,4090375,4265,3048483,5080806,"NLD",4064645
1,578.0,"China",10613251,10038829,574422,7958510,13264183,"CPR",10611347
1,578.0,"United States of America",3204795,3204503,292,2386698,3977830,"USA",3182264
1,578.0,"Northern Africa",1807073,0,1807073,1353072,2255121,"EGY",1804097
1,578.0,"Russian Federation",2523948,2523488,460,1885895,3143158,"RUS",2514527
1,578.0,"Western Africa",552481,0,552481,417438,695730,"NGA",556584
1,578.0,"South America",2184959,1491630,693329,1644215,2740358,"BRA",2192287
1,578.0,"Northern Europe",2182510,2010257,172253,1636416,2727361,"GBR",2181889
1,578.0,"Northern America",661080,660682,398,518751,864586,"CAN",691669
1,578.0,"Oceania",656150,656150,0,491279,818798,"NZL",655039
1,578.0,"Eastern Africa",468300,0,468300,353277,588796,"ETH",471037
1,578.0,"Middle Africa",150154,0,150154,113889,189816,"AGO",151853
1,578.0,"Eastern Europe",3064932,3055459,9473,2298697,3831162,"POL",3064930
1,578.0,"Central Asia",1753386,1752528,858,1301183,2168638,"UZB",1734911
1,578.0,"Southern Europe",882109,0,882109,675580,1125967,"ITA",900774
1,578.0,"Central America",450849,0,450849,337353,562256,"MEX",449805
1,578.0,"Southern Asia",818169,0,818169,612234,1020391,"IRN",816313
1,578.0,"Western Asia",1639373,0,1639373,1231761,2052936,"IRQ",1642349
1,578.0,"Eastern Asia",1059250,0,1059250,795954,1326591,"JPN",1061273
1,578.0,"Southern Africa",160817,0,160817,120858,201431,"ZAF",161145
1,578.0,"South-Eastern Asia",1409051,0,1409051,1059633,1766055,"IDN",1412844
1,578.0,"Caribbean",163509,0,163509,122337,203895,"CUB",163116
1,579.0,"Pakistan",2035565,2035385,180,1525824,2543040,"PAK",2034432
1,579.0,"India",7161158,7161158,0,5354195,8923658,"IND",7138927
1,579.0,"Western Europe",4035061,4031630,3431,3048483,5080806,"NLD",4064645
1,579.0,"China",10611440,10039663,571777,7958510,13264183,"CPR",10611347
1,579.0,"United States of America",3178979,3178765,214,2386698,3977830,"USA",3182264
1,579.0,"Northern Africa",1797951,0,1797951,1353072,2255121,"EGY",1804097
1,579.0,"Russian Federation",2505650,2505311,339,1885895,3143158,"RUS",2514527
1,579.0,"Western Africa",559574,0,559574,417438,695730,"NGA",556584
1,579.0,"South America",2194542,1489929,704613,1644215,2740358,"BRA",2192287
1,579.0,"Northern Europe",2181577,2013452,168125,1636416,2727361,"GBR",2181889
1,579.0,"Northern America",711255,709996,1259,518751,864586,"CAN",691669
1,579.0,"Oceania",655806,655806,0,491279,818798,"NZL",655039
1,579.0,"Eastern Africa",473694,0,473694,353277,588796,"ETH",471037
1,579.0,"Middle Africa",153340,0,153340,113889,189816,"AGO",151853
1,579.0,"Eastern Europe",3065120,3056568,8552,2298697,3831162,"POL",3064930
1,579.0,"Central Asia",1737056,1736337,719,1301183,2168638,"UZB",1734911
1,579.0,"Southern Europe",911506,0,911506,675580,1125967,"ITA",900774
1,579.0,"Central America",450594,0,450594,337353,562256,"MEX",449805
1,579.0,"Southern Asia",817184,0,817184,612234,1020391,"IRN",816313
1,579.0,"Western Asia",1645921,0,1645921,1231761,2052936,"IRQ",1642349
1,579.0,"Eastern Asia",1062929,0,1062929,795954,1326591,"JPN",1061273
1,579.0,"Southern Africa",161509,0,161509,120858,201431,"ZAF",161145
1,579.0,"South-Eastern Asia",1418058,0,1418058,1059633,1766055,"IDN",1412844
1,579.0,"Caribbean",163406,0,163406,122337,203895,"CUB",163116
1,580.0,"Pakistan",2035228,2035052,176,1525824,2543040,"PAK",2034432
1,580.0,"India",7154473,7154473,0,5354195,8923658,"IND",7138927
1,580.0,"Western Europe",4043899,4039881,4018,3048483,5080806,"NLD",4064645
1,580.0,"China",10612862,10037148,575714,7958510,13264183,"CPR",10611347
1,580.0,"United States of America",3198590,3198381,209,2386698,3977830,"USA",3182264
1,580.0,"Northern Africa",1797334,0,1797334,1353072,2255121,"EGY",1804097
1,580.0,"Russian Federation",2523798,2523318,480,1885895,3143158,"RUS",2514527
1,580.0,"Western Africa",557834,0,557834,417438,695730,"NGA",556584
1,580.0,"South America",2192762,1486122,706640,1644215,2740358,"BRA",2192287
1,580.0,"Northern Europe",2182119,2012354,169765,1636416,2727361,"GBR",2181889
1,580.0,"Northern America",688718,687867,851,518751,864586,"CAN",691669
1,580.0,"Oceania",655570,655570,0,491279,818798,"NZL",655039
1,580.0,"Eastern Africa",471308,0,471308,353277,588796,"ETH",471037
1,580.0,"Middle Africa",152216,0,152216,113889,189816,"AGO",151853
1,580.0,"Eastern Europe",3065034,3056163,8871,2298697,3831162,"POL",3064930
1,580.0,"Central Asia",1725455,1724742,713,1301183,2168638,"UZB",1734911
1,580.0,"Southern Europe",897588,0,897588,675580,1125967,"ITA",900774
1,580.0,"Central America",451739,0,451739,337353,562256,"MEX",449805
1,580.0,"Southern Asia",817269,0,817269,612234,1020391,"IRN",816313
1,580.0,"Western Asia",1642072,0,1642072,1231761,2052936,"IRQ",1642349
1,580.0,"Eastern Asia",1064855,0,1064855,795954,1326591,"JPN",1061273
1,580.0,"Southern Africa",161251,0,161251,120858,201431,"ZAF",161145
1,580.0,"South-Eastern Asia",1413305,0,1413305,1059633,1766055,"IDN",1412844
1,580.0,"Caribbean",163823,0,163823,122337,203895,"CUB",163116
1,581.0,"Pakistan",2034987,2034868,119,1525824,2543040,"PAK",2034432
1,581.0,"India",7149802,7149802,0,5354195,8923658,"IND",7138927
1,581.0,"Western Europe",4100868,4096395,4473,3048483,5080806,"NLD",4064645
1,581.0,"China",10611120,10034312,576808,7958510,13264183,"CPR",10611347
1,581.0,"United States of America",3174786,3174646,140,2386698,3977830,"USA",3182264
1,581.0,"Northern Africa",1812820,0,1812820,1353072,2255121,"EGY",1804097
1,581.0,"Russian Federation",2505518,2505196,322,1885895,3143158,"RUS",2514527
1,581.0,"Western Africa",554300,0,554300,417438,695730,"NGA",556584
1,581.0,"South America",2199027,1492650,706377,1644215,2740358,"BRA",2192287
1,581.0,"Northern Europe",2182035,2011227,170808,1636416,2727361,"GBR",2181889
1,581.0,"Northern America",681564,680988,576,518751,864586,"CAN",691669
1,581.0,"Oceania",655405,655405,0,491279,818798,"NZL",655039
1,581.0,"Eastern Africa",469667,0,469667,353277,588796,"ETH",471037
1,581.0,"Middle Africa",151004,0,151004,113889,189816,"AGO",151853
1,581.0,"Eastern Europe",3064971,3055818,9153,2298697,3831162,"POL",3064930
1,581.0,"Central Asia",1750064,1749431,633,1301183,2168638,"UZB",1734911
1,581.0,"Southern Europe",896345,0,896345,675580,1125967,"ITA",900774
1,581.0,"Central America",448251,0,448251,337353,562256,"MEX",449805
1,581.0,"Southern Asia",815615,0,815615,612234,1020391,"IRN",816313
1,581.0,"Western Asia",1641519,0,1641519,1231761,2052936,"IRQ",1642349
1,581.0,"Eastern Asia",1056521,0,1056521,795954,1326591,"JPN",1061273
1,581.0,"Southern Africa",161014,0,161014,120858,201431,"ZAF",161145
1,581.0,"South-Eastern Asia",1411596,0,1411596,1059633,1766055,"IDN",1412844
1,581.0,"Caribbean",162554,0,162554,122337,203895,"CUB",163116
1,582.0,"Pakistan",2034737,2034737,0,1525824,2543040,"PAK",2034432
1,582.0,"India",7101961,7101961,0,5354195,8923658,"IND",7138927
1,582.0,"Western Europe",4039306,4036141,3165,3048483,5080806,"NLD",4064645
1,582.0,"China",10608526,10032231,576295,7958510,13264183,"CPR",10611347
1,582.0,"United States of America",3177193,3177092,101,2386698,3977830,"USA",3182264
1,582.0,"Northern Africa",1804025,0,1804025,1353072,2255121,"EGY",1804097
1,582.0,"Russian Federation",2492821,2492584,237,1885895,3143158,"RUS",2514527
1,582.0,"Western Africa",562153,0,562153,417438,695730,"NGA",556584
1,582.0,"South America",2208264,1488378,719886,1644215,2740358,"BRA",2192287
1,582.0,"Northern Europe",2182162,2010086,172076,1636416,2727361,"GBR",2181889
1,582.0,"Northern America",729456,728879,577,518751,864586,"CAN",691669
1,582.0,"Oceania",655290,655290,0,491279,818798,"NZL",655039
1,582.0,"Eastern Africa",471101,0,471101,353277,588796,"ETH",471037
1,582.0,"Middle Africa",154031,0,154031,113889,189816,"AGO",151853
1,582.0,"Eastern Europe",3065297,3055248,10049,2298697,3831162,"POL",3064930
1,582.0,"Central Asia",1723752,1723298,454,1301183,2168638,"UZB",1734911
1,582.0,"Southern Europe",924525,0,924525,675580,1125967,"ITA",900774
1,582.0,"Central America",451448,0,451448,337353,562256,"MEX",449805
1,582.0,"Southern Asia",812299,0,812299,612234,1020391,"IRN",816313
1,582.0,"Western Asia",1647596,0,1647596,1231761,2052936,"IRQ",1642349
1,582.0,"Eastern Asia",1059728,0,1059728,795954,1326591,"JPN",1061273
1,582.0,"Southern Africa",161653,0,161653,120858,201431,"ZAF",161145
1,582.0,"South-Eastern Asia",1420587,0,1420587,1059633,1766055,"IDN",1412844
1,582.0,"Caribbean",163711,0,163711,122337,203895,"CUB",163116
1,583.0,"Pakistan",2034765,2034299,466,1525824,2543040,"PAK",2034432
1,583.0,"India",7113116,7112791,325,5354195,8923658,"IND",7138927
1,583.0,"Western Europe",4046893,4042772,4121,3048483,5080806,"NLD",4064645
1,583.0,"China",10612250,10030567,581683,7958510,13264183,"CPR",10611347
1,583.0,"United States of America",3197374,3196892,482,2386698,3977830,"USA",3182264
1,583.0,"Northern Africa",1799695,0,1799695,1353072,2255121,"EGY",1804097
1,583.0,"Russian Federation",2530391,2529550,841,1885895,3143158,"RUS",2514527
1,583.0,"Western Africa",558766,0,558766,417438,695730,"NGA",556584
1,583.0,"South America",2203625,1485204,718421,1644215,2740358,"BRA",2192287
1,583.0,"Northern Europe",2195187,2021247,173940,1636416,2727361,"GBR",2181889
1,583.0,"Northern America",692805,692418,387,518751,864586,"CAN",691669
1,583.0,"Oceania",655213,655213,0,491279,818798,"NZL",655039
1,583.0,"Eastern Africa",469359,0,469359,353277,588796,"ETH",471037
1,583.0,"Middle Africa",152419,0,152419,113889,189816,"AGO",151853
1,583.0,"Eastern Europe",3065123,3054390,10733,2298697,3831162,"POL",3064930
1,583.0,"Central Asia",1716206,1715197,1009,1301183,2168638,"UZB",1734911
1,583.0,"Southern Europe",900779,0,900779,675580,1125967,"ITA",900774
1,583.0,"Central America",451870,0,451870,337353,562256,"MEX",449805
1,583.0,"Southern Asia",816822,0,816822,612234,1020391,"IRN",816313
1,583.0,"Western Asia",1642151,0,1642151,1231761,2052936,"IRQ",1642349
1,583.0,"Eastern Asia",1067859,0,1067859,795954,1326591,"JPN",1061273
1,583.0,"Southern Africa",161328,0,161328,120858,201431,"ZAF",161145
1,583.0,"South-Eastern Asia",1413486,0,1413486,1059633,1766055,"IDN",1412844
1,583.0,"Caribbean",163882,0,163882,122337,203895,"CUB",163116
1,584.0,"Pakistan",2034642,2034339,303,1525824,2543040,"PAK",2034432
1,584.0,"India",7120809,7120597,212,5354195,8923658,"IND",7138927
1,584.0,"Western Europe",4102947,4098206,4741,3048483,5080806,"NLD",4064645
1,584.0,"China",10610313,10030324,579989,7958510,13264183,"CPR",10611347
1,584.0,"United States of America",3192480,3192168,312,2386698,3977830,"USA",3182264
1,584.0,"Northern Africa",1811104,0,1811104,1353072,2255121,"EGY",1804097
1,584.0,"Russian Federation",2510051,2509239,812,1885895,3143158,"RUS",2514527
1,584.0,"Western Africa",553904,0,553904,417438,695730,"NGA",556584
1,584.0,"South America",2198225,1482953,715272,1644215,2740358,"BRA",2192287
1,584.0,"Northern Europe",2192383,2017598,174785,1636416,2727361,"GBR",2181889
1,584.0,"Northern America",668478,668215,263,518751,864586,"CAN",691669
1,584.0,"Oceania",655161,655161,0,491279,818798,"NZL",655039
1,584.0,"Eastern Africa",467659,0,467659,353277,588796,"ETH",471037
1,584.0,"Middle Africa",150411,0,150411,113889,189816,"AGO",151853
1,584.0,"Eastern Europe",3064915,3053775,11140,2298697,3831162,"POL",3064930
1,584.0,"Central Asia",1743580,1742133,1447,1301183,2168638,"UZB",1734911
1,584.0,"Southern Europe",887765,0,887765,675580,1125967,"ITA",900774
1,584.0,"Central America",449884,0,449884,337353,562256,"MEX",449805
1,584.0,"Southern Asia",814613,0,814613,612234,1020391,"IRN",816313
1,584.0,"Western Asia",1639303,0,1639303,1231761,2052936,"IRQ",1642349
1,584.0,"Eastern Asia",1056665,0,1056665,795954,1326591,"JPN",1061273
1,584.0,"Southern Africa",160742,0,160742,120858,201431,"ZAF",161145
1,584.0,"South-Eastern Asia",1408596,0,1408596,1059633,1766055,"IDN",1412844
1,584.0,"Caribbean",163074,0,163074,122337,203895,"CUB",163116
1,585.0,"Pakistan",2034588,2034366,222,1525824,2543040,"PAK",2034432
1,585.0,"India",7126229,7126073,156,5354195,8923658,"IND",7138927
1,585.0,"Western Europe",4015448,4011553,3895,3048483,5080806,"NLD",4064645
1,585.0,"China",10611374,10028654,582720,7958510,13264183,"CPR",10611347
1,585.0,"United States of America",3170694,3170464,230,2386698,3977830,"USA",3182264
1,585.0,"Northern Africa",1794406,0,1794406,1353072,2255121,"EGY",1804097
1,585.0,"Russian Federation",2511440,2510848,592,1885895,3143158,"RUS",2514527
1,585.0,"Western Africa",559232,0,559232,417438,695730,"NGA",556584
1,585.0,"South America",2214475,1488540,725935,1644215,2740358,"BRA",2192287
1,585.0,"Northern Europe",2188433,2014719,173714,1636416,2727361,"GBR",2181889
1,585.0,"Northern America",720135,719530,605,518751,864586,"CAN",691669
1,585.0,"Oceania",655121,655121,0,491279,818798,"NZL",655039
1,585.0,"Eastern Africa",472131,0,472131,353277,588796,"ETH",471037
1,585.0,"Middle Africa",153721,0,153721,113889,189816,"AGO",151853
1,585.0,"Eastern Europe",3065244,3053778,11466,2298697,3831162,"POL",3064930
1,585.0,"Central Asia",1730097,1729057,1040,1301183,2168638,"UZB",1734911
1,585.0,"Southern Europe",916325,0,916325,675580,1125967,"ITA",900774
1,585.0,"Central America",449708,0,449708,337353,562256,"MEX",449805
1,585.0,"Southern Asia",816868,0,816868,612234,1020391,"IRN",816313
1,585.0,"Western Asia",1647844,0,1647844,1231761,2052936,"IRQ",1642349
1,585.0,"Eastern Asia",1064661,0,1064661,795954,1326591,"JPN",1061273
1,585.0,"Southern Africa",161821,0,161821,120858,201431,"ZAF",161145
1,585.0,"South-Eastern Asia",1418509,0,1418509,1059633,1766055,"IDN",1412844
1,585.0,"Caribbean",163198,0,163198,122337,203895,"CUB",163116
1,586.0,"Pakistan",2034553,2034039,514,1525824,2543040,"PAK",2034432
1,586.0,"India",7130025,7129726,299,5354195,8923658,"IND",7138927
1,586.0,"Western Europe",4106330,4101324,5006,3048483,5080806,"NLD",4064645
1,586.0,"China",10611214,10026174,585040,7958510,13264183,"CPR",10611347
1,586.0,"United States of America",3192923,3192401,522,2386698,3977830,"USA",3182264
1,586.0,"Northern Africa",1810796,0,1810796,1353072,2255121,"EGY",1804097
1,586.0,"Russian Federation",2512378,2511356,1022,1885895,3143158,"RUS",2514527
1,586.0,"Western Africa",556650,0,556650,417438,695730,"NGA",556584
1,586.0,"South America",2193744,1491181,702563,1644215,2740358,"BRA",2192287
1,586.0,"Northern Europe",2174586,2014712,159874,1636416,2727361,"GBR",2181889
1,586.0,"Northern America",682761,682351,410,518751,864586,"CAN",691669
1,586.0,"Oceania",655099,655099,0,491279,818798,"NZL",655039
1,586.0,"Eastern Africa",469849,0,469849,353277,588796,"ETH",471037
1,586.0,"Middle Africa",151645,0,151645,113889,189816,"AGO",151853
1,586.0,"Eastern Europe",3045749,3033700,12049,2298697,3831162,"POL",3064930
1,586.0,"Central Asia",1742463,1740998,1465,1301183,2168638,"UZB",1734911
1,586.0,"Southern Europe",898762,0,898762,675580,1125967,"ITA",900774
1,586.0,"Central America",450667,0,450667,337353,562256,"MEX",449805
1,586.0,"Southern Asia",816543,0,816543,612234,1020391,"IRN",816313
1,586.0,"Western Asia",1632764,0,1632764,1231761,2052936,"IRQ",1642349
1,586.0,"Eastern Asia",1060500,0,1060500,795954,1326591,"JPN",1061273
1,586.0,"Southern Africa",161126,0,161126,120858,201431,"ZAF",161145
1,586.0,"South-Eastern Asia",1411281,0,1411281,1059633,1766055,"IDN",1412844
1,586.0,"Caribbean",163386,0,163386,122337,203895,"CUB",163116
1,587.0,"Pakistan",2034499,2034159,340,1525824,2543040,"PAK",2034432
1,587.0,"India",7132669,7132473,196,5354195,8923658,"IND",7138927
1,587.0,"Western Europe",4043021,4038043,4978,3048483,5080806,"NLD",4064645
1,587.0,"China",10614038,10023993,590045,7958510,13264183,"CPR",10611347
1,587.0,"United States of America",3189470,3189127,343,2386698,3977830,"USA",3182264
1,587.0,"Northern Africa",1799480,0,1799480,1353072,2255121,"EGY",1804097
1,587.0,"Russian Federation",2543948,2543273,675,1885895,3143158,"RUS",2514527
1,587.0,"Western Africa",552397,0,552397,417438,695730,"NGA",556584
1,587.0,"South America",2187670,1487614,700056,1644215,2740358,"BRA",2192287
1,587.0,"Northern Europe",2175979,2015253,160726,1636416,2727361,"GBR",2181889
1,587.0,"Northern America",665619,665342,277,518751,864586,"CAN",691669
1,587.0,"Oceania",655081,655081,0,491279,818798,"NZL",655039
1,587.0,"Eastern Africa",468191,0,468191,353277,588796,"ETH",471037
1,587.0,"Middle Africa",150236,0,150236,113889,189816,"AGO",151853
1,587.0,"Eastern Europe",3109206,3095953,13253,2298697,3831162,"POL",3064930
1,587.0,"Central Asia",1718323,1717348,975,1301183,2168638,"UZB",1734911
1,587.0,"Southern Europe",880431,0,880431,675580,1125967,"ITA",900774
1,587.0,"Central America",449144,0,449144,337353,562256,"MEX",449805
1,587.0,"Southern Asia",818254,0,818254,612234,1020391,"IRN",816313
1,587.0,"Western Asia",1658188,0,1658188,1231761,2052936,"IRQ",1642349
1,587.0,"Eastern Asia",1065887,0,1065887,795954,1326591,"JPN",1061273
1,587.0,"Southern Africa",160480,0,160480,120858,201431,"ZAF",161145
1,587.0,"South-Eastern Asia",1407859,0,1407859,1059633,1766055,"IDN",1412844
1,587.0,"Caribbean",162887,0,162887,122337,203895,"CUB",163116
1,588.0,"Pakistan",2034493,2034238,255,1525824,2543040,"PAK",2034432
1,588.0,"India",7134549,7134401,148,5354195,8923658,"IND",7138927
1,588.0,"Western Europe",4049596,4045068,4528,3048483,5080806,"NLD",4064645
1,588.0,"China",10610821,10023265,587556,7958510,13264183,"CPR",10611347
1,588.0,"United States of America",3131691,3131432,259,2386698,3977830,"USA",3182264
1,588.0,"Northern Africa",1802429,0,1802429,1353072,2255121,"EGY",1804097
1,588.0,"Russian Federation",2504076,2503576,500,1885895,3143158,"RUS",2514527
1,588.0,"Western Africa",556579,0,556579,417438,695730,"NGA",556584
1,588.0,"South America",2199073,1488535,710538,1644215,2740358,"BRA",2192287
1,588.0,"Northern Europe",2176883,2016874,160009,1636416,2727361,"GBR",2181889
1,588.0,"Northern America",730377,729595,782,518751,864586,"CAN",691669
1,588.0,"Oceania",655065,655065,0,491279,818798,"NZL",655039
1,588.0,"Eastern Africa",473894,0,473894,353277,588796,"ETH",471037
1,588.0,"Middle Africa",152997,0,152997,113889,189816,"AGO",151853
1,588.0,"Eastern Europe",3057637,3046553,11084,2298697,3831162,"POL",3064930
1,588.0,"Central Asia",1723257,1722137,1120,1301183,2168638,"UZB",1734911
1,588.0,"Southern Europe",927173,0,927173,675580,1125967,"ITA",900774
1,588.0,"Central America",445746,0,445746,337353,562256,"MEX",449805
1,588.0,"Southern Asia",815295,0,815295,612234,1020391,"IRN",816313
1,588.0,"Western Asia",1643367,0,1643367,1231761,2052936,"IRQ",1642349
1,588.0,"Eastern Asia",1060976,0,1060976,795954,1326591,"JPN",1061273
1,588.0,"Southern Africa",161976,0,161976,120858,201431,"ZAF",161145
1,588.0,"South-Eastern Asia",1420350,0,1420350,1059633,1766055,"IDN",1412844
1,588.0,"Caribbean",161614,0,161614,122337,203895,"CUB",163116
1,589.0,"Pakistan",2021651,2020957,694,1525824,2543040,"PAK",2034432
1,589.0,"India",7135873,7135429,444,5354195,8923658,"IND",7138927
1,589.0,"Western Europe",4054031,4049411,4620,3048483,5080806,"NLD",4064645
1,589.0,"China",10610528,10023409,587119,7958510,13264183,"CPR",10611347
1,589.0,"United States of America",3203489,3202635,854,2386698,3977830,"USA",3182264
1,589.0,"Northern Africa",1797877,0,1797877,1353072,2255121,"EGY",1804097
1,589.0,"Russian Federation",2507261,2506180,1081,1885895,3143158,"RUS",2514527
1,589.0,"Western Africa",557626,0,557626,417438,695730,"NGA",556584
1,589.0,"South America",2198991,1487184,711807,1644215,2740358,"BRA",2192287
1,589.0,"Northern Europe",2179706,2016959,162747,1636416,2727361,"GBR",2181889
1,589.0,"Northern America",681558,681022,536,518751,864586,"CAN",691669
1,589.0,"Oceania",659021,659021,0,491279,818798,"NZL",655039
1,589.0,"Eastern Africa",470068,0,470068,353277,588796,"ETH",471037
1,589.0,"Middle Africa",151912,0,151912,113889,189816,"AGO",151853
1,589.0,"Eastern Europe",3059582,3049392,10190,2298697,3831162,"POL",3064930
1,589.0,"Central Asia",1748655,1746687,1968,1301183,2168638,"UZB",1734911
1,589.0,"Southern Europe",894233,0,894233,675580,1125967,"ITA",900774
1,589.0,"Central America",451868,0,451868,337353,562256,"MEX",449805
1,589.0,"Southern Asia",815408,0,815408,612234,1020391,"IRN",816313
1,589.0,"Western Asia",1639298,0,1639298,1231761,2052936,"IRQ",1642349
1,589.0,"Eastern Asia",1060021,0,1060021,795954,1326591,"JPN",1061273
1,589.0,"Southern Africa",161906,0,161906,120858,201431,"ZAF",161145
1,589.0,"South-Eastern Asia",1418930,0,1418930,1059633,1766055,"IDN",1412844
1,589.0,"Caribbean",163854,0,163854,122337,203895,"CUB",163116
1,590.0,"Pakistan",2025394,2024930,464,1525824,2543040,"PAK",2034432
1,590.0,"India",7136767,7136472,295,5354195,8923658,"IND",7138927
1,590.0,"Western Europe",4108035,4102912,5123,3048483,5080806,"NLD",4064645
1,590.0,"China",10612164,10023631,588533,7958510,13264183,"CPR",10611347
1,590.0,"United States of America",3178077,3177511,566,2386698,3977830,"USA",3182264
1,590.0,"Northern Africa",1812599,0,1812599,1353072,2255121,"EGY",1804097
1,590.0,"Russian Federation",2524894,2524174,720,1885895,3143158,"RUS",2514527
1,590.0,"Western Africa",553015,0,553015,417438,695730,"NGA",556584
1,590.0,"South America",2194933,1485851,709082,1644215,2740358,"BRA",2192287
1,590.0,"Northern Europe",2180036,2016428,163608,1636416,2727361,"GBR",2181889
1,590.0,"Northern America",672814,672454,360,518751,864586,"CAN",691669
1,590.0,"Oceania",645919,645919,0,491279,818798,"NZL",655039
1,590.0,"Eastern Africa",469545,0,469545,353277,588796,"ETH",471037
1,590.0,"Middle Africa",150523,0,150523,113889,189816,"AGO",151853
1,590.0,"Eastern Europe",3061095,3050594,10501,2298697,3831162,"POL",3064930
1,590.0,"Central Asia",1744502,1743174,1328,1301183,2168638,"UZB",1734911
1,590.0,"Southern Europe",890421,0,890421,675580,1125967,"ITA",900774
1,590.0,"Central America",448249,0,448249,337353,562256,"MEX",449805
1,590.0,"Southern Asia",818773,0,818773,612234,1020391,"IRN",816313
1,590.0,"Western Asia",1638974,0,1638974,1231761,2052936,"IRQ",1642349
1,590.0,"Eastern Asia",1061430,0,1061430,795954,1326591,"JPN",1061273
1,590.0,"Southern Africa",158626,0,158626,120858,201431,"ZAF",161145
1,590.0,"South-Eastern Asia",1390627,0,1390627,1059633,1766055,"IDN",1412844
1,590.0,"Caribbean",162522,0,162522,122337,203895,"CUB",163116
1,591.0,"Pakistan",2028068,2027730,338,1525824,2543040,"PAK",2034432
1,591.0,"India",7137419,7137206,213,5354195,8923658,"IND",7138927
1,591.0,"Western Europe",4044243,4040630,3613,3048483,5080806,"NLD",4064645
1,591.0,"China",10610968,10023410,587558,7958510,13264183,"CPR",10611347
1,591.0,"United States of America",3179446,3179036,410,2386698,3977830,"USA",3182264
1,591.0,"Northern Africa",1802726,0,1802726,1353072,2255121,"EGY",1804097
1,591.0,"Russian Federation",2506312,2505787,525,1885895,3143158,"RUS",2514527
1,591.0,"Western Africa",559597,0,559597,417438,695730,"NGA",556584
1,591.0,"South America",2214746,1492187,722559,1644215,2740358,"BRA",2192287
1,591.0,"Northern Europe",2181006,2015833,165173,1636416,2727361,"GBR",2181889
1,591.0,"Northern America",719061,718695,366,518751,864586,"CAN",691669
1,591.0,"Oceania",648707,648707,0,491279,818798,"NZL",655039
1,591.0,"Eastern Africa",473037,0,473037,353277,588796,"ETH",471037
1,591.0,"Middle Africa",153189,0,153189,113889,189816,"AGO",151853
1,591.0,"Eastern Europe",3062599,3051170,11429,2298697,3831162,"POL",3064930
1,591.0,"Central Asia",1730735,1729660,1075,1301183,2168638,"UZB",1734911
1,591.0,"Southern Europe",920301,0,920301,675580,1125967,"ITA",900774
1,591.0,"Central America",450846,0,450846,337353,562256,"MEX",449805
1,591.0,"Southern Asia",815812,0,815812,612234,1020391,"IRN",816313
1,591.0,"Western Asia",1645775,0,1645775,1231761,2052936,"IRQ",1642349
1,591.0,"Eastern Asia",1063728,0,1063728,795954,1326591,"JPN",1061273
1,591.0,"Southern Africa",159837,0,159837,120858,201431,"ZAF",161145
1,591.0,"South-Eastern Asia",1403867,0,1403867,1059633,1766055,"IDN",1412844
1,591.0,"Caribbean",163594,0,163594,122337,203895,"CUB",163116
1,592.0,"Pakistan",2042863,2042156,707,1525824,2543040,"PAK",2034432
1,592.0,"India",7137875,7137516,359,5354195,8923658,"IND",7138927
1,592.0,"Western Europe",4075730,4071251,4479,3048483,5080806,"NLD",4064645
1,592.0,"China",10610862,10023513,587349,7958510,13264183,"CPR",10611347
1,592.0,"United States of America",3198901,3198199,702,2386698,3977830,"USA",3182264
1,592.0,"Northern Africa",1805942,0,1805942,1353072,2255121,"EGY",1804097
1,592.0,"Russian Federation",2508818,2507854,964,1885895,3143158,"RUS",2514527
1,592.0,"Western Africa",557700,0,557700,417438,695730,"NGA",556584
1,592.0,"South America",2194356,1489057,705299,1644215,2740358,"BRA",2192287
1,592.0,"Northern Europe",2181778,2014614,167164,1636416,2727361,"GBR",2181889
1,592.0,"Northern America",686039,685794,245,518751,864586,"CAN",691669
1,592.0,"Oceania",650643,650643,0,491279,818798,"NZL",655039
1,592.0,"Eastern Africa",470752,0,470752,353277,588796,"ETH",471037
1,592.0,"Middle Africa",152016,0,152016,113889,189816,"AGO",151853
1,592.0,"Eastern Europe",3063186,3051181,12005,2298697,3831162,"POL",3064930
1,592.0,"Central Asia",1731993,1730532,1461,1301183,2168638,"UZB",1734911
1,592.0,"Southern Europe",897764,0,897764,675580,1125967,"ITA",900774
1,592.0,"Central America",451663,0,451663,337353,562256,"MEX",449805
1,592.0,"Southern Asia",814857,0,814857,612234,1020391,"IRN",816313
1,592.0,"Western Asia",1641454,0,1641454,1231761,2052936,"IRQ",1642349
1,592.0,"Eastern Asia",1060064,0,1060064,795954,1326591,"JPN",1061273
1,592.0,"Southern Africa",160188,0,160188,120858,201431,"ZAF",161145
1,592.0,"South-Eastern Asia",1403174,0,1403174,1059633,1766055,"IDN",1412844
1,592.0,"Caribbean",163774,0,163774,122337,203895,"CUB",163116
1,593.0,"Pakistan",2040326,2039867,459,1525824,2543040,"PAK",2034432
1,593.0,"India",7138169,7137935,234,5354195,8923658,"IND",7138927
1,593.0,"Western Europe",4046946,4042184,4762,3048483,5080806,"NLD",4064645
1,593.0,"China",10612278,10022065,590213,7958510,13264183,"CPR",10611347
1,593.0,"United States of America",3193508,3193050,458,2386698,3977830,"USA",3182264
1,593.0,"Northern Africa",1799144,0,1799144,1353072,2255121,"EGY",1804097
1,593.0,"Russian Federation",2525982,2525053,929,1885895,3143158,"RUS",2514527
1,593.0,"Western Africa",553110,0,553110,417438,695730,"NGA",556584
1,593.0,"South America",2187255,1485458,701797,1644215,2740358,"BRA",2192287
1,593.0,"Northern Europe",2181113,2013276,167837,1636416,2727361,"GBR",2181889
1,593.0,"Northern America",663916,663748,168,518751,864586,"CAN",691669
1,593.0,"Oceania",651988,651988,0,491279,818798,"NZL",655039
1,593.0,"Eastern Africa",468516,0,468516,353277,588796,"ETH",471037
1,593.0,"Middle Africa",150263,0,150263,113889,189816,"AGO",151853
1,593.0,"Eastern Europe",3102041,3089408,12633,2298697,3831162,"POL",3064930
1,593.0,"Central Asia",1732896,1731399,1497,1301183,2168638,"UZB",1734911
1,593.0,"Southern Europe",878091,0,878091,675580,1125967,"ITA",900774
1,593.0,"Central America",449544,0,449544,337353,562256,"MEX",449805
1,593.0,"Southern Asia",816721,0,816721,612234,1020391,"IRN",816313
1,593.0,"Western Asia",1655491,0,1655491,1231761,2052936,"IRQ",1642349
1,593.0,"Eastern Asia",1060334,0,1060334,795954,1326591,"JPN",1061273
1,593.0,"Southern Africa",159983,0,159983,120858,201431,"ZAF",161145
1,593.0,"South-Eastern Asia",1402011,0,1402011,1059633,1766055,"IDN",1412844
1,593.0,"Caribbean",163032,0,163032,122337,203895,"CUB",163116
1,594.0,"Pakistan",2038599,2038254,345,1525824,2543040,"PAK",2034432
1,594.0,"India",7138405,7138230,175,5354195,8923658,"IND",7138927
1,594.0,"Western Europe",4052377,4048078,4299,3048483,5080806,"NLD",4064645
1,594.0,"China",10609648,10021813,587835,7958510,13264183,"CPR",10611347
1,594.0,"United States of America",3152894,3152553,341,2386698,3977830,"USA",3182264
1,594.0,"Northern Africa",1799758,0,1799758,1353072,2255121,"EGY",1804097
1,594.0,"Russian Federation",2491645,2490951,694,1885895,3143158,"RUS",2514527
1,594.0,"Western Africa",559243,0,559243,417438,695730,"NGA",556584
1,594.0,"South America",2201763,1486461,715302,1644215,2740358,"BRA",2192287
1,594.0,"Northern Europe",2181262,2013488,167774,1636416,2727361,"GBR",2181889
1,594.0,"Northern America",729120,728444,676,518751,864586,"CAN",691669
1,594.0,"Oceania",652922,652922,0,491279,818798,"NZL",655039
1,594.0,"Eastern Africa",473879,0,473879,353277,588796,"ETH",471037
1,594.0,"Middle Africa",153236,0,153236,113889,189816,"AGO",151853
1,594.0,"Eastern Europe",3033520,3023021,10499,2298697,3831162,"POL",3064930
1,594.0,"Central Asia",1733536,1732233,1303,1301183,2168638,"UZB",1734911
1,594.0,"Southern Europe",927033,0,927033,675580,1125967,"ITA",900774
1,594.0,"Central America",448447,0,448447,337353,562256,"MEX",449805
1,594.0,"Southern Asia",813334,0,813334,612234,1020391,"IRN",816313
1,594.0,"Western Asia",1630317,0,1630317,1231761,2052936,"IRQ",1642349
1,594.0,"Eastern Asia",1059311,0,1059311,795954,1326591,"JPN",1061273
1,594.0,"Southern Africa",161777,0,161777,120858,201431,"ZAF",161145
1,594.0,"South-Eastern Asia",1414999,0,1414999,1059633,1766055,"IDN",1412844
1,594.0,"Caribbean",162577,0,162577,122337,203895,"CUB",163116
1,595.0,"Pakistan",2037383,2036599,784,1525824,2543040,"PAK",2034432
1,595.0,"India",7138579,7138106,473,5354195,8923658,"IND",7138927
1,595.0,"Western Europe",4055988,4051489,4499,3048483,5080806,"NLD",4064645
1,595.0,"China",10609548,10021687,587861,7958510,13264183,"CPR",10611347
1,595.0,"United States of America",3217939,3217079,860,2386698,3977830,"USA",3182264
1,595.0,"Northern Africa",1800015,0,1800015,1353072,2255121,"EGY",1804097
1,595.0,"Russian Federation",2498572,2497225,1347,1885895,3143158,"RUS",2514527
1,595.0,"Western Africa",560300,0,560300,417438,695730,"NGA",556584
1,595.0,"South America",2202151,1484575,717576,1644215,2740358,"BRA",2192287
1,595.0,"Northern Europe",2182849,2012218,170631,1636416,2727361,"GBR",2181889
1,595.0,"Northern America",684733,684270,463,518751,864586,"CAN",691669
1,595.0,"Oceania",657637,657496,141,491279,818798,"NZL",655039
1,595.0,"Eastern Africa",470605,0,470605,353277,588796,"ETH",471037
1,595.0,"Middle Africa",152684,0,152684,113889,189816,"AGO",151853
1,595.0,"Eastern Europe",3062004,3050227,11777,2298697,3831162,"POL",3064930
1,595.0,"Central Asia",1723016,1721193,1823,1301183,2168638,"UZB",1734911
1,595.0,"Southern Europe",896585,0,896585,675580,1125967,"ITA",900774
1,595.0,"Central America",453908,0,453908,337353,562256,"MEX",449805
1,595.0,"Southern Asia",810969,0,810969,612234,1020391,"IRN",816313
1,595.0,"Western Asia",1638740,0,1638740,1231761,2052936,"IRQ",1642349
1,595.0,"Eastern Asia",1058294,0,1058294,795954,1326591,"JPN",1061273
1,595.0,"Southern Africa",161931,0,161931,120858,201431,"ZAF",161145
1,595.0,"South-Eastern Asia",1417065,0,1417065,1059633,1766055,"IDN",1412844
1,595.0,"Caribbean",164594,0,164594,122337,203895,"CUB",163116
1,596.0,"Pakistan",2010748,2010239,509,1525824,2543040,"PAK",2034432
1,596.0,"India",7138654,7138350,304,5354195,8923658,"IND",7138927
1,596.0,"Western Europe",4109364,4104198,5166,3048483,5080806,"NLD",4064645
1,596.0,"China",10614360,10022176,592184,7958510,13264183,"CPR",10611347
1,596.0,"United States of America",3187830,3187275,555,2386698,3977830,"USA",3182264
1,596.0,"Northern Africa",1810598,0,1810598,1353072,2255121,"EGY",1804097
1,596.0,"Russian Federation",2549874,2548504,1370,1885895,3143158,"RUS",2514527
1,596.0,"Western Africa",552234,0,552234,417438,695730,"NGA",556584
1,596.0,"South America",2202364,1492411,709953,1644215,2740358,"BRA",2192287
1,596.0,"Northern Europe",2181853,2010599,171254,1636416,2727361,"GBR",2181889
1,596.0,"Northern America",659073,658763,310,518751,864586,"CAN",691669
1,596.0,"Oceania",656741,656741,0,491279,818798,"NZL",655039
1,596.0,"Eastern Africa",467940,0,467940,353277,588796,"ETH",471037
1,596.0,"Middle Africa",150136,0,150136,113889,189816,"AGO",151853
1,596.0,"Eastern Europe",3062655,3050481,12174,2298697,3831162,"POL",3064930
1,596.0,"Central Asia",1737433,1735606,1827,1301183,2168638,"UZB",1734911
1,596.0,"Southern Europe",879002,0,879002,675580,1125967,"ITA",900774
1,596.0,"Central America",448773,0,448773,337353,562256,"MEX",449805
1,596.0,"Southern Asia",819394,0,819394,612234,1020391,"IRN",816313
1,596.0,"Western Asia",1637604,0,1637604,1231761,2052936,"IRQ",1642349
1,596.0,"Eastern Asia",1064906,0,1064906,795954,1326591,"JPN",1061273
1,596.0,"Southern Africa",161076,0,161076,120858,201431,"ZAF",161145
1,596.0,"South-Eastern Asia",1410624,0,1410624,1059633,1766055,"IDN",1412844
1,596.0,"Caribbean",162668,0,162668,122337,203895,"CUB",163116
1,597.0,"Pakistan",2030780,2029765,1015,1525824,2543040,"PAK",2034432
1,597.0,"India",7138751,7138522,229,5354195,8923658,"IND",7138927
1,597.0,"Western Europe",4019922,4015595,4327,3048483,5080806,"NLD",4064645
1,597.0,"China",10610778,10028110,582668,7958510,13264183,"CPR",10611347
1,597.0,"United States of America",3167593,3167172,421,2386698,3977830,"USA",3182264
1,597.0,"Northern Africa",1793929,0,1793929,1353072,2255121,"EGY",1804097
1,597.0,"Russian Federation",2508179,2507153,1026,1885895,3143158,"RUS",2514527
1,597.0,"Western Africa",558903,0,558903,417438,695730,"NGA",556584
1,597.0,"South America",2213149,1487877,725272,1644215,2740358,"BRA",2192287
1,597.0,"Northern Europe",2181256,2014191,167065,1636416,2727361,"GBR",2181889
1,597.0,"Northern America",729811,728812,999,518751,864586,"CAN",691669
1,597.0,"Oceania",656219,656219,0,491279,818798,"NZL",655039
1,597.0,"Eastern Africa",473975,0,473975,353277,588796,"ETH",471037
1,597.0,"Middle Africa",153607,0,153607,113889,189816,"AGO",151853
1,597.0,"Eastern Europe",3044350,3033092,11258,2298697,3831162,"POL",3064930
1,597.0,"Central Asia",1736771,1735105,1666,1301183,2168638,"UZB",1734911
1,597.0,"Southern Europe",926850,0,926850,675580,1125967,"ITA",900774
1,597.0,"Central America",449899,0,449899,337353,562256,"MEX",449805
1,597.0,"Southern Asia",816371,0,816371,612234,1020391,"IRN",816313
1,597.0,"Western Asia",1635469,0,1635469,1231761,2052936,"IRQ",1642349
1,597.0,"Eastern Asia",1065878,0,1065878,795954,1326591,"JPN",1061273
1,597.0,"Southern Africa",162612,0,162612,120858,201431,"ZAF",161145
1,597.0,"South-Eastern Asia",1422321,0,1422321,1059633,1766055,"IDN",1412844
1,597.0,"Caribbean",163275,0,163275,122337,203895,"CUB",163116
1,598.0,"Pakistan",2031880,2030543,1337,1525824,2543040,"PAK",2034432
1,598.0,"India",7138820,7138295,525,5354195,8923658,"IND",7138927
1,598.0,"Western Europe",4084086,4078514,5572,3048483,5080806,"NLD",4064645
1,598.0,"China",10610661,10028264,582397,7958510,13264183,"CPR",10611347
1,598.0,"United States of America",3190794,3189938,856,2386698,3977830,"USA",3182264
1,598.0,"Northern Africa",1807703,0,1807703,1353072,2255121,"EGY",1804097
1,598.0,"Russian Federation",2510099,2508509,1590,1885895,3143158,"RUS",2514527
1,598.0,"Western Africa",556867,0,556867,417438,695730,"NGA",556584
1,598.0,"South America",2201100,1490482,710618,1644215,2740358,"BRA",2192287
1,598.0,"Northern Europe",2183663,2014364,169299,1636416,2727361,"GBR",2181889
1,598.0,"Northern America",685178,684505,673,518751,864586,"CAN",691669
1,598.0,"Oceania",659847,659847,0,491279,818798,"NZL",655039
1,598.0,"Eastern Africa",470746,0,470746,353277,588796,"ETH",471037
1,598.0,"Middle Africa",151938,0,151938,113889,189816,"AGO",151853
1,598.0,"Eastern Europe",3050371,3038103,12268,2298697,3831162,"POL",3064930
1,598.0,"Central Asia",1736220,1734060,2160,1301183,2168638,"UZB",1734911
1,598.0,"Southern Europe",898939,0,898939,675580,1125967,"ITA",900774
1,598.0,"Central America",450567,0,450567,337353,562256,"MEX",449805
1,598.0,"Southern Asia",814821,0,814821,612234,1020391,"IRN",816313
1,598.0,"Western Asia",1634606,0,1634606,1231761,2052936,"IRQ",1642349
1,598.0,"Eastern Asia",1060094,0,1060094,795954,1326591,"JPN",1061273
1,598.0,"Southern Africa",162329,0,162329,120858,201431,"ZAF",161145
1,598.0,"South-Eastern Asia",1421655,0,1421655,1059633,1766055,"IDN",1412844
1,598.0,"Caribbean",163375,0,163375,122337,203895,"CUB",163116
1,599.0,"Pakistan",2032590,2031626,964,1525824,2543040,"PAK",2034432
1,599.0,"India",7138825,7138484,341,5354195,8923658,"IND",7138927
1,599.0,"Western Europe",4052745,4046906,5839,3048483,5080806,"NLD",4064645
1,599.0,"China",10613877,10028449,585428,7958510,13264183,"CPR",10611347
1,599.0,"United States of America",3188020,3187460,560,2386698,3977830,"USA",3182264
1,599.0,"Northern Africa",1799774,0,1799774,1353072,2255121,"EGY",1804097
1,599.0,"Russian Federation",2542316,2540780,1536,1885895,3143158,"RUS",2514527
1,599.0,"Western Africa",552994,0,552994,417438,695730,"NGA",556584
1,599.0,"South America",2194700,1488712,705988,1644215,2740358,"BRA",2192287
1,599.0,"Northern Europe",2182533,2012510,170023,1636416,2727361,"GBR",2181889
1,599.0,"Northern America",663359,662904,455,518751,864586,"CAN",691669
1,599.0,"Oceania",658358,658358,0,491279,818798,"NZL",655039
1,599.0,"Eastern Africa",468560,0,468560,353277,588796,"ETH",471037
1,599.0,"Middle Africa",150372,0,150372,113889,189816,"AGO",151853
1,599.0,"Eastern Europe",3093199,3079824,13375,2298697,3831162,"POL",3064930
1,599.0,"Central Asia",1735841,1733669,2172,1301183,2168638,"UZB",1734911
1,599.0,"Southern Europe",878189,0,878189,675580,1125967,"ITA",900774
1,599.0,"Central America",448778,0,448778,337353,562256,"MEX",449805
1,599.0,"Southern Asia",819881,0,819881,612234,1020391,"IRN",816313
1,599.0,"Western Asia",1652905,0,1652905,1231761,2052936,"IRQ",1642349
1,599.0,"Eastern Asia",1064259,0,1064259,795954,1326591,"JPN",1061273
1,599.0,"Southern Africa",161213,0,161213,120858,201431,"ZAF",161145
1,599.0,"South-Eastern Asia",1414268,0,1414268,1059633,1766055,"IDN",1412844
1,599.0,"Caribbean",162766,0,162766,122337,203895,"CUB",163116
1,600.0,"Pakistan",2033153,2032169,984,1525824,2543040,"PAK",2034432
1,600.0,"India",7138869,7138616,253,5354195,8923658,"IND",7138927
1,600.0,"Western Europe",4056418,4051174,5244,3048483,5080806,"NLD",4064645
1,600.0,"China",10610380,10027766,582614,7958510,13264183,"CPR",10611347
1,600.0,"United States of America",3130740,3130324,416,2386698,3977830,"USA",3182264
1,600.0,"Northern Africa",1803479,0,1803479,1353072,2255121,"EGY",1804097
1,600.0,"Russian Federation",2503006,2501870,1136,1885895,3143158,"RUS",2514527
1,600.0,"Western Africa",554923,0,554923,417438,695730,"NGA",556584
1,600.0,"South America",2190396,1483047,707349,1644215,2740358,"BRA",2192287
1,600.0,"Northern Europe",2181230,2012336,168894,1636416,2727361,"GBR",2181889
1,600.0,"Northern America",724637,723677,960,518751,864586,"CAN",691669
1,600.0,"Oceania",657329,657329,0,491279,818798,"NZL",655039
1,600.0,"Eastern Africa",473521,0,473521,353277,588796,"ETH",471037
1,600.0,"Middle Africa",152014,0,152014,113889,189816,"AGO",151853
1,600.0,"Eastern Europe",3046312,3034693,11619,2298697,3831162,"POL",3064930
1,600.0,"Central Asia",1735639,1733710,1929,1301183,2168638,"UZB",1734911
1,600.0,"Southern Europe",925211,0,925211,675580,1125967,"ITA",900774
1,600.0,"Central America",445381,0,445381,337353,562256,"MEX",449805
1,600.0,"Southern Asia",816130,0,816130,612234,1020391,"IRN",816313
1,600.0,"Western Asia",1635998,0,1635998,1231761,2052936,"IRQ",1642349
1,600.0,"Eastern Asia",1060402,0,1060402,795954,1326591,"JPN",1061273
1,600.0,"Southern Africa",162210,0,162210,120858,201431,"ZAF",161145
1,600.0,"South-Eastern Asia",1423899,0,1423899,1059633,1766055,"IDN",1412844
1,600.0,"Caribbean",161449,0,161449,122337,203895,"CUB",163116
